Utilisateur_id;Utilisateur_name;Profile_bio;Tweets;Following;Followers;Likes;Score
PaysagesIroise;Sauvegarde Paysages d'Iroise;Association Sauvegarde Paysages d'Iroise (Finistère Nord) née en réaction aux attaques sur le patrimoine naturel et culturel d'une côte sauvage exceptionnelle.;23200;159;479;22382;46220
InfosEducation;Education & Formation;Veille éducation - #Formation Professionnel - #Enseignement - #Méthodologie - #Education #DIF;26018;9145;8520;16;43699
VIENSflashmober;Etat d'urgence;Insurrection permanente, alternative à Punishment Park.;1010;126;19;111;1266
LIBERTE1311;eddy;;90329;114;244;19706;110393
PACOLLOT;Pierre-Alain Collot;Enseignant-chercheur - Institut Champollion - Institut  Maurice Hauriou/ Université Toulouse Capitole;1195;293;243;897;2628
verolive83;Olive83;à tous ceux qui ne m'aiment pas sachez que je ne ferai rien pour changer ça !  😉🙏🇨🇵🇪🇦🇮🇹;20771;1285;259;16640;38955
Hergastul;Hergastul;"Entrepreneur, trader, consultant ou branleur selon les saisons.
Site web : vivredutrading.com";12432;80;4194;4912;21618
PatrickGlesener;Patrick Glesener;Ambulancier Urgentiste retraité. Actuellement Chef d'Unité Départementale dans une Association Agréée de Sécurité Civile. Entraîneur en Auto Défense.;6776;2230;972;4056;14034
giOrdanoB6946;giOrdanO B;"""Il est plus facile de tromper les gens que de leur faire admettre qu'ils ont été trompés""  M. T.
""La meilleure façon de prédire l'avenir , est de le créer"" D.P";22387;340;289;15262;38278
randomie7i;Prophète Issud Sekour 🕋🏳️‍🌈🇩🇿;Nabiun.e déconstruit.e🔻• Prière éco sociale ♻️ Pour une Islam progressiste : que les voies d’Allah soient pénétrées ☪️ • Elie/they ⚧️ • 5 vaccins par jour 💉;1280;101;48;1633;3062
Marie08979035;El*a*e Carrier;"La vérité toute la vérité rien que la vérité 
Je déteste les mensonges

Je ne réponds jamais aux messages en mp
passez votre chemin";49432;17785;22828;6009;96054
JeannotMbaya;Jeannot Mbaya đšđ© MD;"Congolais debout/ Docteur en mĂ©decine humaine.
Patriote engagĂ© pour un Congo nouveau. Membre effectif 
de la Copop/ ĂvangĂ©liste NCD đšđ©";6145;508;248;3582;10483
latulipenoire31;đŠP.F.Ađšđ”âïž;"souverainistes. 

đšđ”đšđ”đšđ”đšđ”
Ă©crit l'histoire...l'honneur est dans la vĂ©ritĂ©.#NUISIBLES INFO . #justicepourlola.";27079;4027;3965;144927;179998
Olivancalderone;Olivier Antoine Cald;Politique, Laïcité, Polémique, Géopolitique, Cinéma, Société, Diplomatie, triompher mais par des voies étroites. 2RM et humaniste:.tutoiement de rigueur. RHIS;47486;2278;1003;94802;145569
MySweetimmo;MySweet'Immo;"đź¦‹ MĂ©dia dâ€™actualitĂ© avec vue Ă  360Â° sur lâ€™immobilier.
đź—ť Interviews, news, conseils, podcasts, dossiers...
đź‘‰ by @ArianeArtinian";6251;557;2919;247;9974
LaurencePalais;Laurence Palais;"Les mots ne soignent pas les maux, mais ils font ma vie, pour eux je vis...
Sinon j'aime bien Keen'V, David Hallyday, Renaud Hantson...";1818;259;75;286;2438
PMonoxyle;ð«ð·Piroguier Monoxyle;"Je suis un artiste perfectionniste et Ã©pris de justice.
Je ne veux pas que l'on m'emmerde et ne crains personne.
Ã mon Ã¢ge je me fous du jugement des autres.";4854;664;598;2328;8444
MendiniNassim;Nassim Mendini;"Curiosité intellectuelle/Science/Art/Réflexion/Intuition.

""La réalité est simplement une illusion, quoique très persistante"".
 Albert Einstein";21645;554;417;22081;44697
DavidBorie4;David Borie;;4356;12;18;28;4414
BARLANicolas1;Nicolas Barla;"Défenseur du Climat et des générations actuelles et futures
Conseiller Métropole de Lyon
Ingénieur réseaux électriques
Fan du GIEC et RTE
tinyurl.com/2p8rpwd5";2427;528;892;8102;11949
Ortofon76;Ortofon;;8839;149;46;4833;13867
Prefet49;Préfet de Maine-et-Loire 🇫🇷🇪🇺;Compte officiel de la préfecture et des services de l'État en Maine-et-Loire.;8448;360;12208;2170;23186
sophie_bussiere;Sophie Bussiere đ»;Porte parole @eelv. ConseillĂšre rĂ©gionale Nouvelle Aquitaine EELV. Membre du CA de la FEVE.Avocate au Barreau de Bayonne.;26778;4103;4746;193924;229551
lemainelibre;Le Maine Libre.fr;Bienvenue sur la page Twitter du site lemainelibre.fr ! Suivez ici toute l'actualité sarthoise, en 280 caractères...;56954;653;13197;406;71210
Actuenviro;Actu Environnement;"Le quotidien indépendant de référence sur les thématiques de l'environnement et du développement durable, depuis 2003. 
Les offres d'emploi : @emploienviro";36783;492;69873;4416;111564
AudreyHenocque;Audrey Hénocque;1ère Adjointe au Maire de Lyon @gregorydoucet, en charge des finances, de la commande publique et des grands évènements - Ecologiste;2049;469;3818;3562;9898
eco_actu;Actualité économique;L'actualité #économique en continu.;35840;229;2905;6;38980
SartheInfos;Sarthe Infos;Compte qui publie toutes les informations concernant la Sarthe.;154349;422;2427;119;157317
groum_groum;🚂Gaaab🚂;il faut sachez qu’il s’est pris des râteaux phénoménales par nabilla, bien sûr que ouiiiiii;3709;347;427;13237;17720
Babapolitique;Baptiste Spalonyđ«đ·đȘđș;;702;501;137;620;1960
Q_deBremond;Quentin de Bremond d'Ars;"Directeur territorial Maine-et-Loire, Sarthe et Mayenne @GRDF
Président @GLEAMPimms
#ESS #Energie #GazVert #biogaz #bioGNV #méthanisation #mediationsociale";194;511;211;939;1855
RomainLaveau;Romain Laveau đȘđșđ»;Conseiller fĂ©dĂ©ral @eelv, rĂ©fĂ©rent communication du groupe local #Angers agglo;4295;1275;1536;16546;23652
FrexitOtanExit;AlainBnđšđ”đ·đș;;12209;15;45;5387;17656
Cesarmand;César Armand 💉💉💉;"Journaliste
📰 @LaTribune #CollTerr #GrandParis #Ville pôle #TransitionEcolo 
Co-Auteur
📚#DansLOmbreDesPresidents
#Pompidou-#PourLAmourDeLArt";12198;8000;7418;11497;39113
o_environnement;đ Orientation Environnement;"Orientation, formations et recrutements dans les mĂ©tiers de l'#environnement et du dĂ©veloppement durable
âą emploi, stage, alternance
âą guide des formations";13733;110;4163;526;18532
LaTribune;La Tribune;"Journal économique et financier - Economie, Entreprises & Finance, Tech, Idées : latribune.fr
Découvrez notre nouveau quotidien numérique: kiosque.latribune.fr";141398;908;260153;2206;404665
LCI;LCI;Bienvenue sur LCI, #La26 sur la TNT. Le meilleur de l'info, de l'analyse, du décryptage et tous les grands événements en direct #RespectZone;165987;1021;619069;2289;788366
imperma1914;AngeRouge;Passé un peu partout pour en arriver là... Il y a 2 genres de gens, ceux qui pensent qu’il y a 2 genres de gens, et les autres ...;23685;445;486;26660;51276
ChristopheBechu;Christophe Béchu;Ministre de la Transition écologique et de la Cohésion des territoires 🇫🇷 - Elu d’@Angers - Secrétaire général de @Horizonsleparti;6858;5395;37024;5953;55230
FredBesnard;Frederic Besnard;« La société construite sur l'argent détruit les bêtes, détruit les hommes, détruit la joie » - Jean Giono;1165;348;68;9046;10627
Trunkhanwow;Trunkhan;"Mangeons les riches
twitch.tv/trunkhanfr
piped.video/TrunkhanVideos
piped.video/TrunkhanLive";112078;562;364;23453;136457
UnivDroit_EDD;Droit de l'Environnement et de l'urbanisme;Droit de l'environnement et de l'urbanisme. Un compte @univ_droit;612;1;1322;1;1936
TLConseil;Thomas Legrain, Directeur général;Directeur général Compétences et Développement, réseau d'#écoles 🇫🇷 🌎 #sport #pédagogie #encouragement #valeurs #accompagnement - Fondateur Club de l'Audace;7837;1715;1683;3263;14498
favier_florent;Florent Favier;Comment sensibiliser aux défis qui nous attendent si nous voulons continuer à vivre demain aussi bien qu’aujourd’hui ? #nature #oceans #communication #influence;380;204;222;74;880
deslnfor;➡️ Desinf rmateur 🗞🐾🔭🖥️ #NoFakeMed;Tout savoir pour rien comprendre;86134;519;980;132206;219839
Benjam1Lucas;Benjamin LUCAS;Député • Groupe écologiste - #NUPES • Membre de Génération.s • 8ème circonscription des Yvelines • Mon actualité 📲 linktr.ee/benjaminlucasdeput…;20459;8438;30647;15556;75100
shilderi;Association Collaborative d'Adoration de Bridget;"je ne suis rien j'ai juste des idées.

 vous connaissez l'élephant qui fait comme l'oiseau ?

dm si vous voulez join un discord de g@m€rz de gauche";158376;1709;5096;90832;256013
Vivien_PI;Vivien P;social worker;970;805;159;1062;2996
DorianBianco07;Dorian Bianco;Director of @G_am_volontaire | PhD student in architectural and planning history at @Sorbonne_Univ_ & @centrechastel | Supporter of welfare planning | ð«ð· ð©ð°;844;866;493;1753;3956
LouisLghni;L;Ingénieur dans l'énergie, spécialisé dans l'hydrogène  - Energy account - LC;70;179;1;33;283
Lejeune_paris;Lejeune Christophe;;366;45;19;1155;1585
communiquaction;Frédéric Lohbrunner;Apprenant permanent.;124837;3245;2552;724;131358
FrancoisBulloc1;Francois Bullock (Patriote XV);Fais ce que dois, advienne que pourra ❗️                 Vive INTERNET NON CENSURÉ 👍 «LA PEUR TUE LA RAISON» ANTI PASS SANITAIRE-Je suis 10%;46265;926;7097;182485;236773
jeremyerline;Jeremy erline;Livreur de nouvelles amateur et professionnel #DroiteSocialeEcolo #FCB #teamSRFC #spurs #TeamRedbull #F1 #PKMN;222940;3868;2901;55760;285469
EadgGdea;Eadg Gdea;Eadg;5759;39;15;927;6740
FabriceRivet;Fabrice de Rivet;Vélotaf + Biodiversité + Prosilva (gestion forestière respectueuse des équlibres) + baisse des émissions de GES + réindustrialisation;7043;249;152;3623;11067
SachaMaunier;Sacha Maunier;"Independent climate data scientist.
Founding director of Caelyi.";2545;213;62;1591;4411
JuliaCerisi;Julia Cerisi;"#Liberté
#NonAuVaccinObligatoire
#AntiPassSanitaire
#NonAuPassDeLaHonte
Messagerie privée : je n'arrive pas  à répondre à tous. Veuillez m'en excuser.";144239;5680;9446;186262;345627
melggo;Mélanie Goffi;#projet #transition #management #FPT - formatrice #CNFPT - garante #concertation #démocratie #CNDP, Militante & Féministe , Docteur en sciences économiques;6410;1489;801;5017;13717
iwona46;­čîč­čîč­čÉ│iwona ­čç║­čçŽÔś«´ŞĆÔťî­čĆ╗;You are not gone because you are always in my heart ÔÇ╣Ragnar;128265;4125;1023;41314;174727
ChaBahuon;Charlotte Bahuon;Journaliste Desk56 @ouestfrance Ă  #Vannes Passion vieilles pierres, festivals et pizzas đ @EpjTours ASJ 2010 đ#Bretagne #Morbihan #SR;36310;532;1182;24997;63021
antoinecaplan;Antoine Caplan;"Candidat aux élections sénatoriales 2023
conseiller départemental • adjoint aux finances et aux commerces @Laval_la_Ville • rapporteur du budget @LavalAgglo";1586;954;1321;4165;8026
HachaniNaima;Cours Gestion PDF;;1900;0;16;1;1917
m_Romagnani;Matteo ð«ð·ðªðºð®ð¹;#Nice ð´â«ï¸ / 17 years / @HorizonsLeParti / @Territoiresdab / @NiceEnsemble06;3371;2091;324;16741;22527
LibertyLoveFr;Liberty Love;#Studio #photo et #vidéo #artistique #pro à votre #service 24h sur 24 et 7 jours sur 7, uniquement sur rendez-vous. #StudioPhoto #Photographe #book #shooting;19472;4812;360;1283;25927
reix_toine;Antoine Reix;CPE à @acmontpellier, Lycée Pierre Mendes France | 🎓M2 Meef CPE à @FacEducMtp | STAPS à #UT3 | #Rugby 🏉 | 🗺️🇫🇷🏴󠁧󠁢󠁥󠁮󠁧󠁿🇪🇸🇩🇪🇮🇹🇬🇵🇺🇸🇲🇶🇨🇭;117;127;42;396;682
JeunesseNupes;ð´Prolo Mag;"Les Vrais News. ð°
Pas dictÃ©es par les Ãlites. â
Seulement le vrai. â¬ï¸";1961;679;3397;181;6218
Antoine0667Best;TonyTruand;Apolitique Bloqué par @RokhayaDiallo @edwyplenel @T_Bouhafs @davduf 🤗 Protestant athée Massive Attack @MassiveAttackUK addiction;112103;331;352;44982;157768
Arr_Verdun;Arrondissement de Verdun;Compte Twitter officiel de l'arrondissement de Verdun.;1472;170;2197;294;4133
DarkPhoenix9666;Dark;;51285;397;451;75605;127738
LP641;Tuco el gaucho đșđŠ;"Gauchiasse. Ni Macron Ni Lepen.
Influenceur cancel culture du Wokistan.
Soutiens Ă  nos manifestants.";7215;263;147;43033;50658
jnbarrot;Jean-Noël Barrot;"Ministre délégué chargé de la Transition numérique et des Télécommunications -
Conseiller régional d'@iledefrance -
Vice-président du @modem";4305;707;26208;16952;48172
RDelinfo;Robot De l'Info;"Nono est un robot de l'info en temps réel.
C'est le compagnon idéal de l'actualité en continue";557850;13;549;9;558421
NoamLeandri;Noam Leandri ♻️;#inegalites #transitionjuste #ecologie Mes tweets n’engagent que moi;1123;359;865;4529;6876
benoitbonte;Benoît;cofounder & ceo @humanroads;272;157;183;456;1068
VeloBucVGP;VeloBuc 🕊️🚲🇺🇦🇪🇺 @VeloBuc at masto.bike;Association loi de 1901, créée en 2004, d'intérêt général depuis 2010. Mobilités actives. Membre de la FUB. Initiation à la réparation entretien vélo.;14857;369;637;3795;19658
VonbraunWerner;Werner Vonbraun;Gilet jaune amateur. Si t’as cinquante ans et que tu n’as pas de Jaguar, alors tu n’est pas un vrai gilet jaune.;18867;19;63;1724;20673
Firenault;Marie-Cécile Renault;Rédactrice en chef adjointe au service Économie @Le_Figaro - #Santé #Retraites #ProtectionSociale;28849;2333;7378;5467;44027
claran55;SoBeau 🇪🇺🇺🇦🇫🇷;"Humaniste, athée, pro-UE.
#niFNniFI car ce serait la FIN.";49211;754;1593;313681;365239
Goulran_;Goulranðððâ¢ï¸;"L1 Administration Publique a l'UJM ; epicurieux qui a la flemme de tout mais qui veut changer le monde 
â¤ï¸AnimÃ©, aerospacial, F1, Science, GÃ©opolitic, politic";5520;250;33;11483;17286
baceau;Mister baceau;l’actualité financière et crypto c’est ici !;70558;2852;620;2307;76337
ademe;ADEME;Compte officiel de l'Agence de la Transition Écologique !;25912;9167;136736;7154;178969
ChristVdbPro;M Vandenbroucke CPE;Compte Pro;439;230;87;204;960
Madininair972;Madininair;"Madininair est l'observatoire de la qualité de l’#air en #Martinique.
#QualitéAir";3849;288;1075;1071;6283
systemcruyff;Cruyff System;#GénérationX #Parisien #libéral #universaliste Pour le retour d'une Droite et d'une Gauche avec un cerveau, un cœur et des couilles.;17475;1024;290;10019;28808
escaledenuit;@escaledenuit;Le site des voyages insolites et secrets #travelblogger #bzh #voyage #photographe;15732;26644;63037;41555;146968
Jean_LucFUGIT;Jean-Luc FUGIT;Député du Rhône/Président Conseil Supérieur Énergie /VP OPECST/ Rapp.Loi Mobilité/Qualité de l’Air/Biogaz/Spatial/ Hydrogène/Agriculture/ Ruralité /Fan de Rugby;9724;3880;6462;5135;25201
24matins;24matins.fr;Actu et info en direct. Nos autres comptes à suivre : @24matins_sport, @24matins_tech et @24matins_eco;178750;4;6107;24;184885
Pour_Gagner_35;Gagner ! en Ille-et-Vilaine;"Pour suivre l'actualité d'Olivier Faure et des signataires du texte d'orientation Gagner ! #CongrèsPS #PourGagner
@Pour_Gagner @FaureOlivier";5247;597;408;5375;11627
jacquesantoine;mathiou JA;"Citoyen Marseillais Nul en orthographe
#amish
#islamo-gauchiste #juedo-bolchevik
#khmer-vert
#pasteque
#EcoloDuDimanche";27745;688;1084;74355;103872
X345__;Corti l'abruti;Petit informaticien. Je dis beaucoup de bêtises sur les marchés, l'informatique, les neurotransmetteurs et l'immobilier.;46171;1119;4143;36707;88140
ElisabethLavill;Elisabeth Laville;Founder & Chief Entrepreneur @Utopies_Paris @Utopies_Bdx @Utopies_Brasil @MesCourses_PLP @CampusResp Proud to be the 1st @BCorp_fr;7535;4545;7570;8274;27924
lemonde_campus;Le Monde Campus;Etudiants, jeunes diplômés : comment la jeunesse se forme, travaille et change la société. Enquêtes, reportages et témoignages @lemondefr;15674;635;49087;923;66319
AirMilarsky;⭐⭐Milarsky👸🌌;J'ai sûrement été une Princesse intergalactique dans une vie antérieure^^;85874;4718;312;18145;109049
JeanPierreDESHA;Jean-Pierre Deshayes;"Programmes européens 2021-2027. Fonds européen de défense. ""Alliance Clean Hydrogen"". Export et Accords internationaux. Financements des Collectivités locales.";2986;289;771;2;4048
MetropoliticBot;Metropolitic Nantes đ Robot de retweet;Notre đ€ partage la com des politiques, militants et citoyens engagĂ©s de #Nantes (compte principal @Metropolitic_44);129444;669;661;15;130789
MyriamVillert;Myriam Villert đ«đ·đȘđșđșđŠ;Responsable de mission (pro.) l Community manager (assoc.)  instagram.com/MyriamVillert | AdhĂ©rente @Renaissance #Renaissance;6200;525;551;19547;26823
luccarvounas;Luc Carvounas;Maire #Alfortville - VP #MGP - Pdt @unccas- SG #Amif - Comité directeur #AMF #Porte Parole du PS - Ancien Sénateur - Ancien Député;12115;7932;17529;11100;48676
Renaud_83990;Reno;Contre la colonisation, même de la #France. Le #Wokisme étant un nihilisme tu finiras toi aussi excommunié par le dernier Torquemada #RadioLondres #Reconquête;8456;2825;1190;8343;20814
auvergne_infos;Aimable Auvergnat;Je retweete tout ce qui parle d'#Auvergne préparant la domination du monde par les bougnats;97454;418;5837;102;103811
HenryM_63;Henry Marc;Aujourd'hui retraité, mais toujours passionné par les sciences, la connaissance de l'univers, les mathématiques, la physique, et la paléontologie.;6933;63;65;5750;12811
a_leboeuf;Alain LEBOEUF;"Président du Conseil départemental de la #Vendée, du @VendeeGlobe et de @VendeeEnergie 
Président du groupe de travail #Énergiesrenouvelables de @ADepartementsF";6047;2400;6669;4580;19696
DavidLegros33;David LEgRoS;"Electromobiliste

#5Echanges et on acte le désaccord en se quittant bons amis.

Vous pouvez aussi me retrouver sur @kenny@framapiaf.org Pweteur depuis 2017 TM";4363;441;461;924;6189
andreaxlubeck;Andrea Lubeck;Journaliste et cheffe de la section Urgence climat @24heuresca ✉️ andrea.lubeck@quebecormedia.com she/her/elle;4403;3310;997;3260;11970
Vincent48557733;Vincent;“Les médias donnent à voir, pas à réfléchir, encore moins à comprendre. L'image ment lorsqu'elle isole.”;4790;36;73;12712;17611
Valiryus;Linconnu;Presque connu.;10157;1245;756;20038;32196
villedemougins;Mougins;Compte officiel de la Ville de Mougins facebook.com/villedemougins/ instagram.com/villedemougins…;15202;316;4312;6070;25900
vinougradus;vinougradus;"Professeur de Lettres en Lycée 
#EducMediasInfos #EspritCritique
#Exégèse #Littérature";2156;971;254;1216;4597
FoncelJerome;Jérôme Foncel;;272;406;127;478;1283
IPSL_outreach;IPSL đ;8 laboratoires + 2 Ă©q. associĂ©es/1500 personnes/10 sites #Climat #ModĂ©lisation #Observation #Instrumentation #DonnĂ©es #SystĂšmesSolaires;8158;739;3249;2217;14363
NicolNogent;DUBOIS Nicole;Pas parfaite peut être mais pour la discussion dans le respect. Je bloque ceux qui insulte, sans aucun état d'âme.;34140;186;232;94330;128888
BELLATFoot;BELLAT Jean Michel;79 ans, avocat retraité, joueur/dirigeant Stade RennaisFC,international universitaire (10 sélections), président LBF 2004/2008, doyen actuel du foot amateur Fr;6510;296;231;4444;11481
baffeur77;GRINCHEUX;Élargir son point de vue. L’ouverture d’esprit n’est pas une fracture du crâne!;378;90;24;216;708
BoudPrototype;Galette parfaitement lucide;he/his, 90’s;32399;582;1606;187841;222428
MasterCEDDETE;Master CEDDETE - URCA;Master Economie Appliquée - parcours Chargé d'étude en Environnement, Développement durable et Transition Ecologique - UFR Sciences Eco. et de Gestion - URCA;229;129;109;289;756
mpatrick21;Patrick Tennom;"Laïque Républicain Curieux Indiscipliné.

Le vieux monde se meurt, le nouveau tarde à apparaître et dans ce clair-obscur surgissent les monstres. 
A Gramsci.";28467;839;307;21797;51410
F3PaysdelaLoire;France 3 Pays de la Loire;Le compte officiel de France 3 Pays de la Loire ūüďļ Orange/Sosh 320 | Free 321 | SFR/Red et Num√©ricable 450 | Fransat 314 | Canal Sat 369 | Bouygues/ Bbox;48878;1053;29592;2378;81901
adsaum;Adrien Saumier;đŒ CĂŽtĂ© pro : formateur et consultant @IReseaux, associĂ© @GestionsLoc_ | đ Podcast politique : shows.acast.com/adrien-parleâŠâŠ | @eelv6_8;111342;1477;5946;28346;147111
Noelherve5;Noel herve;;4079;1995;1404;6129;13607
CabinetAgcr;Cabinet AGCR;"Suivez l'actualité du cabinet d'expertise-comptable AGCR !
Nous accompagnons les entreprises réunionnaises en quête d'efficacité depuis plus de 30 ans.";1070;36;10;79;1195
MargauxVIDAL1;Margaux VIDAL;CF @PSRhone, ex-suppléante de @julien_giraudo (législative 2017), ,Ex-SF @PSRhone, #handiféministe #Intersectionnelle;37520;800;956;33394;72670
XhiphiasG;XhiphiasGladius;Est une espèce de poisson pélagiques des mers tropicales et tempérées, famille des Xiphiidés, peut dépasser les 2m et 100kg. #Horizons 🇨🇵🇪🇺🇺🇦🇹🇼;6147;406;91;6100;12744
ville_chaville;Ville de Chaville;Compte officiel de la Ville de #Chaville;8686;265;1073;2609;12633
RicolotContact;Ricolot#DarmaninEnPrison;"@Ricolot@mamot.fr
#6èmeRépublique";25528;999;337;56185;83049
Befalimpertinen;Befa Limpertinent;;200;194;6;956;1356
Cdanslair;C dans l'air;Compte officiel de l'émission présentée par @Caroline_Roux et @AxeldeTarle du lundi au samedi à 17.30 sur @France5tv ➡️Pour réagir : #cdanslair;30426;867;101327;1111;133731
MarcoMonigaAtos;marco moniga;@Unify Expert on: Unified Communication 4.0 - Social Enterprise Communications - Single Sign On.;11702;145;143;544;12534
FlorenceBlatrix;Florence Blatrix;Sénatrice de l’#Ain /Commission des affaires économiques et des affaires européennes /Conseil supérieur de l'ESS;15892;2391;2754;15188;36225
TPoulinier;Thierry Poulinier;Soif de justice;3085;16;6;31;3138
JouveauM;Marie Jouveau;Architecte et urbaniste du patrimoine « L’efficacité, ça ne se présume pas, ça s’évalue » #teamarchi mes tweets n’engagent que moi;22482;1398;2547;54765;81192
AxThV;Celax;Compte personnel, pas de ligne Ă©ditoriale fixe : SHS, tweets d'humeur et sujets au hasard.đšđŸâđM2 Education (M.A.Ed.);1977;955;131;1438;4501
jchapuis;Jérôme Chapuis;La Croix, directeur de la rédaction;2986;1266;19697;1639;25588
FNAIM_Picardie;FNAIM Picardie;Votre projet immobilier mérite l'expertise d'un professionnel.;681;0;16;0;697
Infos_Dijon;Infos Dijon;"infos-dijon.com - L'information à #Dijon - Mail : redaction.infosdijon@gmail.com
Facebook : facebook.com/infosdijoncom/";13516;1647;9256;274;24693
ze_flower;ThierryTexierLafleur⭐️⭐️🇫🇷;Thierry Texier Lafleur. #RSE - La Journée #solidaire, les collectes #solidaires & référent #Handicap #Bienveillance #Respect #GroupeBPCE #Inclusion #womenintech;31390;760;1283;70508;103941
michelsalion;Michel Salion ð«ð·ðªðºð¬ð·;"Communicant, #politique #ecologie #ville #agriculture #europe et la #GrÃ¨ce. 
Venu au monde Ã  321 ppm de CO2. Binational.
corfiote-cosmopolite-poulpophile";40844;2867;1186;52745;97642
Pasunmouton2;Pasunmouton;;1332;82;5;2;1421
stanley_kub;Stanley_kub✌️;wokiste, pro cancel culture, je suis le pire cauchemar de LREM/LR/RN - Mes tweet n'engagent que moi. @JLMelenchon 2027;20455;846;489;100661;122451
Mr_Zakka;Terence Zakka;Conseiller en communication de @ThierryBreton đȘđș Communications adviser;3965;347;4968;8034;17314
BSR_Associes;BSR & Associés;Cabinet d'expertise comptable à CHATEAUROUX dans l'INDRE.;2882;1416;504;73;4875
Boiscom;Bois.com;"Bois.com est le site de référence du bois.
Découvrez le bois sous un nouveau jour à la fois innovant, étonnant, durable et design.";762;192;1636;159;2749
MarieCasan;casan;;5739;70;36;5819;11664
sterdyniak;Sterdyniak Henri;économiste citoyen, co-fondateur des Economistes Atterres. Mes tweets ne reflètent que mon point de vue;3124;455;5407;803;9789
ColineSomek;CS;Bureau des courriers non transmis. Demander le bon de retrait de formulaire.;22629;375;597;39585;63186
JulienGossa;Julien Gossa;"Veille et recherche sur l'ESR.

Ne me faites pas confiance, vérifiez par vous-même.

#VeilleESR #HelpESR #DataESR
@juliengossa@social.sciences.re";68183;3483;10932;31713;114311
Pandalatesta;Dr. Panzou - Reviewer #2;"Lillois en exil đșđMCF en Ă©conomie. Too absurd to be dangerous. đł&đ„&Proudđ #ButtChicđâš. 
đ@pachanarchiste@piaille.fr
MaleToken @LesTroisPoints_ đ§đđŽ";26390;281;665;41847;69183
RomannKer;Romann Kermanac'h đ±;Conseiller RĂ©gional des @paysdelaloire || President des Jeunes UDI de Loire-Atlantique;2211;1252;602;4371;8436
franceEcoMag;france-eco.;ch.clés économie, prélèvements, budget état, sécurité sociale, collectivités territoriales, Europe;49978;2670;844;32;53524
Hemail_79;Michel Lachartre;"Citoyen libre et vigilant - Européen et Méditerranéen / 
Warning: je bloque les geeks qui veulent me suivre uniquement pour alimenter leurs CRM et autres bases.";60898;1005;697;32772;95372
LaurentAlfonso;Laurent ALFONSO;"European Affairs Officer, Civil Protection
 🇪🇺🇫🇷@SecCivileFrance 
&
Union for the Mediterranean 🌿
Civil Protection Expert 
@UFMSecretariat";27158;5952;7286;337851;378247
ArnCollignon;arnaud collignon;"#Energie #Climat #Logement #Territoire #Economie Ã  @Canopea_be
Mais c'est mon compte personnel. ð";1853;372;653;457;3335
lesradicaux_;Les Radicaux;Les Radicaux : mouvement citoyen indépendant pour une République laïque et solidaire.  Combat tous les extrêmes.;2784;4704;821;266;8575
365jeuxenfamil1;365jeuxenfamille;Bientôt sur mon blog 365-jeux-en-famille.com vous trouverez des jeux et ressources pour retrouver joie et sérénité en famille. Vers une Education positive !;4371;2;62;1;4436
rlarvent;larvent rodrigue;la France est un paradis peuplé de gens qui se croient en enfer. S Tesson.;20679;387;110;6507;27683
rococo321;rococo;aha;1256;1030;108;12139;14533
dlbrgn;Damien;littérature, internet et politique. work @paris, ex @spintank.;30836;948;2070;28148;62002
cci_ardennes;CCI Ardennes;La CCI 08 accompagne le #développement des #entreprises et des #commerces qui souhaitent créer, transmettre, exporter ainsi que les porteurs de projets.;3077;728;1113;2962;7880
dominique_meda;Méda Dominique @dominiquemeda@piaille.fr;"@Paris_Dauphine ; lemonde.fr/signataires/domin… radiofrance.fr/personnes/dom… @VeblenInstitute @FViesmobiles";8185;922;15926;21270;46303
SophieBellon;Sophie Bellon;Chairwoman of the Board of Directors and CEO of @Sodexogroup, an independent French company that brings #QualityofLife services to the world;557;524;1941;589;3611
frlinget;Frédéric Linget;"Redirection écologique 
Mobilité durable, vélo, vélotaf";11464;356;518;13637;25975
jedy00075;jedy75;mère insoumise;53036;2944;725;11296;68001
fdecoster;François DECOSTER;Maire @VilleSaintOmer / VP @hautsdefrance #Culture #Patrimoine #Langues régionales #Relations #internationales / Président @RenewEuropeCoR / Président @onlille;4762;3674;5268;8169;21873
gyrovaguerie;revan;;20849;370;183;258024;279426
PierreCazeneuve;Pierre Cazeneuve;@DeputesRE des Hauts-de-Seine #Rueil #Garches #SaintCloud ð²ð«ðªðº EngagÃ© pour le climat Ã  la commission du dÃ©veloppement durable ð;1024;1103;6370;2645;11142
EricSartori3;Eric Sartori;;13194;174;934;25082;39384
jmvittori;Jean-Marc Vittori;Editorialiste, Les Echos. Comprendre et faire comprendre,  l'économie et au-delà. Débattre, aussi. Curious forever. Think & laugh, if possible.;13209;957;113369;2267;129802
RE_RueilMalmais;Renaissance Rueil-Malmaison;Rejoignez-nous parti-renaissance.fr Compte officiel Renaissance Rueil-Malmaison Citoyens Européens Libres-penseurs Progressistes Audacieux Écologistes;1915;646;941;4831;8333
geholf;Gehol;;7198;541;142;9968;17849
atterres;Économistes Atterrés;De quoi avons-nous vraiment besoin ? - notre dernier ouvrage paru en octobre 2021 aux @editionsLLL : urlr.me/KhYPX;18897;994;142454;1853;164198
PhilippeBUERCH;Philippe Buerch;Fondateur de @ClarelisGroupe | Clarelis Notaires & Clarelis Avocats;24531;5141;5029;27878;62579
GIRcontact;RSO92;Jean-Gabriel Giraud, Consultant #évaluation #RSE #RSO #caractérisation contenus #communicationresponsable #612rencontres #i4Emploi;37326;806;593;11676;50401
BusinessBourse;BusinessBourse;Développez votre esprit critique et cultivez la manière dont vous devez comprendre et vous servir de l'information. Telegram: t.me/BusinessBourse_BB;124882;1406;11759;10966;149013
AnneMarieJean1;Anne-Marie Jean;Déléguée générale @Fond_LaPoste et élue @Strasbourg @PortStrasbourg @MDE_Strasbourg #territoires #économie #culture #TransitionEcologique #RSE Tweets perso;7511;2830;2537;23723;36601
JaneOfArc6;Jane of Arc;"#JusticePourLesSuspendus
#LaissonsLesPrescrire
#DissolutionOrdreMedecins #ProtegeonsNosEnfants
#StopEscrologie #EtatCorrompu
#MacronDestitution";14170;1756;746;18211;34883
eelvParis10;EELV PARIS 10;Groupe local #EELV du 10eme arrondissement || Co-secrétaires : @leaChataigne et @jmhupel;2822;1151;1519;773;6265
jamy_william;JamyWilliams;"En recherche d'un réseau permettant la liberté d'expression. 
Ciao Meta, Welcome Tweeter.";739;32;3;92;866
7Milx1;Mila 🖤 SPEAK NOW TV (Taylor's Version);the sun 🌞 ~ STAYTINY 🫰🏻  Dragons 🖤 ciel's wife;107626;456;399;34439;142920
JCEV15;JCEV;;35760;1409;222;80786;118177
LaurePressac;Laure Pressac 💙💛;"Dir. ingénierie culturelle Beaux Arts & Cie @beauxarts_consl - Ex stratnum @leCMN, @CapgeminiInvent #art #musees #digital #graffiti /
@lpressac@mastodon.world";23347;5438;5150;19284;53219
LDinclaux;Laurent Dinclaux;"Développeur web et webApps , administrateur serveurs et réseaux. Spécialiste PHP, Javascript et Linux.
🐘 @lox@gaiac.io";5171;317;170;5016;10674
RL_Patriote;Roland;Homme Politique. Génération Consciente du Congo Kinshasa. Devise: Valeurs, Constance et Convictions.;74217;17371;20394;49455;161437
ArnaudAbel;Arnaud ABEL;Président @FiertesC 🏳️‍🌈 • Fonctionnaire @justice_gouv 🇫🇷🇪🇺• @UCEOfficiel 🌎;12470;461;966;33748;47645
GregIenco;Greg Ienco;"đ» Journaliste @BelgaNewsAgency đ§đȘ 
đČ @CyclismeRevue  
đ @Blueprint_PM  
đź twitch.tv/Greg_Ienco
đ§ La TĂȘte dans le Guidon";66413;1477;2498;2289;72677
PatDucratin;Patrick Ducratin OFFICIEL;Maire de Crougnières | Fier de ses convictions | A l'écoute des Français #EnAvantCrougnieres #Crougnieres2020  🇫🇷;7871;249;65;13;8198
greenvincent;Vincent Laurent;Consultant stratĂ©gie digitale đź“± RP đź“° / Enseignant @ESG_Mtp @espublicite/ Intervenant #EspritCritik @clubdelapresse/đźŚ»/ #ruralitĂ©s #tierslieux #Occitanie;79240;3621;5522;151437;239820
RobyAgathe;Agathe Roby;Conseillère municipale #LFI #Toulouse /Coprésidente @GroupeAMC / #NUPES #circo3103 Pour l'Histoire c'est là @AgatheRoby;2310;1026;2949;3600;9885
Nikki_Sane;ð¯ Nikki Star ð«ð;On vit dans une bulle d'information tellement Ã©tanche qu'il est trÃ¨s rare qu'on nous expose l'autre cÃ´tÃ© de la mÃ©dailleâ¦;25972;513;602;12258;39345
Solange__C;Solange đź‡«đź‡·đź‡Şđź‡ş;membre bureau local Renaissance;37150;4921;3541;9514;55126
Departement_971;Departement_971;Conseil Départemental de la #Guadeloupe #cd971 / Président : M. Guy LOSBAR;956;246;7660;315;9177
presseocean;Presse Océan;"▶Suivez l'actualité de la Loire-Atlantique avec @PresseOcean, journal quotidien.

Le compte associé @PresseOceanLive permet de suivre des événements en direct";142409;1096;75381;2154;221040
YoussefDoghmane;Youssef Doghmane;"Enseignant 

#Paris20
.
""L'éducation est l'arme la plus puissante que vous pouvez utiliser pour changer le monde"" (Nelson Mandela)
.";47774;677;2026;54372;104849
JadoreMontreal;J'adore Montréal;Bienvenue! Il s'agit d'un compte non gouvernemental de la ville de Montréal, Québec. Nous re-tweetons uniquement les principaux comptes d'intérêt pour la ville,;242504;1292;1120;96;245012
PiNetworkFrance;Pi Network France đź‡«đź‡·;"CommunautĂ© officielle de #PiNetwork en France đź‡«đź‡·
Minez les crypto-monnaies directement Ă  partir de votre smartphone.";569992;1;24101;1;594095
clesdusocial;Clés du social;Être utile aux acteurs du #dialogue #social, dans l’entreprise et dans la société et apporter des éléments de culture sociale aux non spécialistes.;2092;113;335;998;3538
amandine_ynwa;amandine7514_ynwa;LFC supporter ⚽️❤🔥 #OLSC France;81;79;12;296;468
Maxime92160;maxime92160;;568;231;44;586;1429
EcoloParis19;EELV Paris 19e ð»ð³ð;Le compte des Ã©colos de #Paris19. changeons nos villes, changeons Paris, changeons nos vies ð» Rejoignez-nous, DM ouverts âª;3924;1936;2129;3385;11374
lailatov;Maryse Donarier;Je ne veux pas changer la règle du jeu, je veux changer de jeu;1576;725;259;7086;9646
MHAmiable;Marie-Hélène Amiable;Maire de Bagneux;17246;2351;2923;21367;43887
JohnMitchell4x8;John MITCHELL;"Informaticien retraité. Inventeur RTT, 32hrs en 4 jrs (mouv4x8)+la ""taxe"" sur les Robots(cotisation ROSE). Pour la  6e République tirée au sort+RIC+Décroissance";5894;103;67;2642;8706
Mikaa_H2;Mikaa Mered;Analyse + enseigne l’hydrogène (marchés, diplomatie & géopolitique) @SciencesPo & @UM6P_officiel | Tuteur Environnement @EcoleDeGuerre | @Editions_PUF @IAHE_GH2;11791;187;10914;59521;82413
FuriousKoen;Diogène 🇾🇪 🇵🇸;Mais je n'ai pas de tonneau.;22851;277;243;20404;43775
rosemarie4710;jakeline chartier;;1327;75;74;23242;24718
ulyssedorioz;Ulysse Dorioz;Mes tweets n'engagent QUE MOI;1462;804;383;4703;7352
IamEntry;Entry ð«ð·ðªðº;Conseiller technique presse dâ@Elisabeth_Borne | Ex conseiller com et presse de @StanGuerini & cab @FranckRiester | Ex @francediplo & @economie_gouv & @ausambfr;2547;1070;847;12471;16935
JM_Verchere;Jean-Marc Verchère;Maire d'@Angers et Président d'@AngersMetropole;236;327;1365;396;2324
laurentdejoie;Laurent DEJOIE;Vice Pdt #ConseilRégional @PaysdelaLoire Pdt du #Notariat Francophone  Pdt Mission Europe International CSN Maire Honoraire #VERTOU #ComitéEuropéenRegions;1970;722;1685;2295;6672
EyquemLeonard;Leonard_Eyquem;Géologue / Curiosité sens critique lucidité mise en perspective / Il importe peu de descendre du singe , l'essentiel est de ne pas y remonter.;3185;454;166;8421;12226
StanGuerini;Stanislas Guerini;Ministre de la Transformation et de la Fonction Publiques. đź‡«đź‡· Ă‰lu de Paris.;7377;1517;80749;15577;105220
Mobrooo;đź‡«đź‡· Romain;RĂ©intĂ©grĂ© | EmmerdĂ© 595 jours par macron | 2+2=5 | Pragmatique | #JusticePourLesSuspendus;6978;699;384;86337;94398
ManciniIsabelle;Isabelle Mancini;;561;44;15;1739;2359
marcgrosman75;MG75;Enseignant en Master Energie et Systèmes Embarqués, Pilote avions-drones, Liberté, Egalité, Fraternité, Vive la République , Centriste;4498;9;41;995;5543
FindinLanguedoc;Finding Languedoc;"Ted & Jemima in #Aude #Languedoc #Occitanie #France:
#news #agenda #podcast #video #photo in FR & EN
#Carcassonne #Narbonne #Lezignan #Castelnaudary #Trebes";223366;585;647;19541;244139
S_Revages;Rêvages;Rêves et rivages : des bribes de monde;8458;322;92;27789;36661
SebStanBono;Sebastien MATHERON;DÉLÉGUÉ TERRITORIAL Alpes du Sud chez @enedis_prov_alp ex : @lessupelec @centralesupelec;711;153;265;556;1685
LeDL737401;Le Dauphiné Libéré Savoie, Haute-Savoie et Ain;Toute l'info locale en Savoie, Haute-Savoie et dans l'Ain.;95865;11;11349;27;107252
ademe_bretagne;AdemeBretagne;Compte officiel de l'Agence de la Transition Ecologique en Bretagne;256;74;274;139;743
NicolasKlatka;Nicolas Klatka;Chargé de mission mobilisation citoyenne au Groupe Mammalogique Normand.;411;240;121;338;1110
flyCSI;Clément;#geek #tech #digital #travel #avgeek ex-#airline. Tweets are my own.;17703;504;1505;12874;32586
pabouger;LaForceG;Mahatma Gandhi - A sign of a good leader is not how many followers you have but how many leaders you create.;79630;470;1196;31217;112513
Spike2577;Spike;;2819;78;6;1880;4783
JeremieLandreau;Jérémie Landreau 🌏🌳;"2TCO2eq/personne.
Préservation de la biodiversité. 🚴‍♂️
Éloge d'une ville plus lente.
Adjoint au Maire de #Pessac ☘️
Réinventons le #radicalisme";14152;1700;2654;11868;30374
RaynaldBernier;Raynald Bernier;"B.Sc.Pol.
LL.L.
Avocat/Magistrat/Procureur au DPCP/Terminé!
Aujd'h: ""VIVRE ET LAISSER VIVRE""
    Tjrs :    Justice pour Tous!";37420;3204;2122;23460;66206
CabinetGsell;Cabinet Christian GSELL;Votre cabinet d’expertise comptable à Haguenau est à votre service pour vous accompagner dans votre gestion comptable.;2515;52;128;1;2696
FdeRugy;François de Rugy;Ancien ministre de l’écologie - Ancien Président de l’Assemblée nationale - Pdt groupe amitié France-Taiwan 2020-2022 - Conseiller régional;28522;1671;79206;14067;123466
FairPlay4Planet;Fair Play For Planet;♻️ ➡️ Le label éco-responsable pour les clubs, les sites et les évènements sportifs. #FPFP #FairPlayForPlanet;1677;733;960;1485;4855
MartinFierro769;Claudina MICHAL-TEITELBAUM;Claudina MICHAL-TEITELBAUM ,MD , #MedicalConservative no COI w pharma  industry. Site medcritic.fr, @Medcritic1. nitter.net/MartinFierro76…gijn.org/inv;37730;470;10139;6610;54949
Ecoyako_;EcoYako;"Média écolo indépendant et engagé 🌍
Pour plus de climat dans les médias ➡️ bit.ly/371tOZw";1168;501;233;986;2888
phenixfr;Phenix;Phenix, lâ#antigaspi qui fait du bien ! đ„Š Des solutions #tech et humaines pour envoyer le #gaspillage Ă  la poubelle #EconomieCirculaire #BCorp #TechForGood;23433;5114;13780;24408;66735
SimpleF12656939;Simple Facts;On Twitter to document thesis on Brexit and Russian convergences in trolling.  « if you have the choice of being right or being kind, be factual. »;3740;288;32;2116;6176
ATokenInvestor;CryptoFun;"#Crypto-curious #Crypto-addict
Nobody can literaly follow me

Que ce soit dans la rue ou sur Twitter je déteste qu'on me suive 😎

100% sans parti politique";2149;531;31;3305;6016
nave_va;Elanaveva;FESTINA LENTE ! (Hâte-toi lentement !) Tacite;26147;1197;531;77813;105688
BenjaminTeoule;Benjamin Téoule;;4882;1363;1892;2589;10726
AdriendeVlt;Adrien Vlt;Journaliste à @LCP, chargé de développement numérique. Newsletter, podcasts. Ancien programmateur. Énergie, économie, Ovalie 🏉;3543;3625;815;4684;12667
ch_lemercier;Charles Lemercier;Journaliste. Sillonne nos régions pour @infofrance3 🍼 @OuestFrance. Option ruralité et courses hippiques 👨‍🌾🌾;8271;669;929;1533;11402
MoukouB;moukou BERNARD;;6911;130;15;1445;8501
Melenchon4Ever;φ FALLAIT VOTER CHONCHON φ #JLM2022;"Si vous vous definissez par:

Il,elle,he,she,they,lgbtq,feministe etc.. Soit 𝗔𝗨𝗧𝗥𝗘 qu'être 𝗛𝗨𝗠𝗔𝗜𝗡 𝗔𝗩𝗔𝗡𝗧 𝗧𝗢𝗨𝗧 ?

Dégagez de mon profil !";2681;198;188;2478;5545
CecileVignesM;CecileVignesMösch;"🌾Pte fondatrice #NosQuartiersDemain☘️🌱🌳 #MarseilleEnTransition
#NouvelleDémocratieLocale Conseillère D'arrondissements #Degrowth";2995;1992;715;2856;8558
Lacjoe1;Lac joe;;495;91;3;318;907
ecoleiet;IET;L'IET, l'Institut des métiers de l'Environnement, propose des formations de Bac à Bac+5 répondant aux enjeux du développement durable et de l’économie verte;1307;85;935;388;2715
vincent_monot;Vincent Monot;Ãcologiste ð± Vice-PrÃ©sident @SYTRALmobilites, Conseiller Municipal de Lyon, Conseiller de la MÃ©tropole de Lyon, Conseiller #Lyon7 Voirie/MobilitÃ©s/TranquilitÃ©;3612;640;2213;11266;17731
PHD442;Ph.D;anti FN, libéral dans l'âme. Classe moyenne basse , soutien E.Macron. fan des Furets, passion pour l’écriture, mauvais en orthographe, amoureux de l’atlantique;33184;676;1079;17253;52192
GHClamart;Guy Hoquet Clamart;;289;48;3;3;343
FabienneGrebert;Fabienne Grebert;Conseillère régionale et  Présidente des Ecologistes à  la Région Auvergne-Rhône-Alpes 🌱 @EcologieAuRA;5519;2108;4862;7324;19813
leparisien2024;Le Parisien | JO ð¥;Le compte pour suivre l'actualitÃ© des Jeux olympiques avec @le_Parisien #Paris2024 â½ï¸ðð¥ðï¸ââï¸ðð¤¸ââï¸â¹ð½ââï¸ð¤ºð¤¾ð¼ââï¸ð¥;2184;19;2703;2;4908
lp_materre;Le Parisien | Ma Terre;L'actualité de l'environnement et de la consommation responsable avec @le_Parisien;13725;84;4290;4;18103
DeremeAvocat;Cabinet Derême Avocat;;119;39;1;0;159
KimKimuntu;Paulette Kimuntu Kim;;87910;19235;85308;8660;201113
pascal_mulegwa;Pascal Mulegwa;Journaliste, Correspondant @RFI et @FRANCE24 en RDCđšđ©| ancien  @jeune_afrique @TV5MONDE @Medi1radio ... passĂ© par @ESJLILLE |Ăpoux et PĂšre|;30631;998;157937;11650;201216
acprdc_Officiel;acpcongo.com;L'Agence congolaise de presse est une agence de presse officielle de la République démocratique du Congo;11911;158;25902;6815;44786
Linossier7;Benyoub - Linossier chérifa;Cheffe d’entreprise - Océanie influence & stratégies - #ESS #RSE #RSA Femme avec une opinion 😱 🇫🇷🇩🇿🇪🇺🇳🇨 #liberté #équité #sororité;9044;1695;1591;13863;26193
meteo60;Meteo60;"Aussi sur t.me/meteo60
Compte de meteo60.fr, même ligne éditoriale que le site. 
Ce compte n'est pas un forum, un tchat ou un formulaire de contact.";12770;69;9493;1514;23846
Lamasticot__;FlashMcQueen;;3193;734;45;14307;18279
haricotsbleus;Noa c:;"🌴80'𝐬 𝐃𝐈𝐒𝐂𝐎 𝐓𝐎𝐓𝐀𝐋𝐈𝐓𝐀𝐑𝐈𝐀𝐍🍹

Insta : noa_sli";2725;135;120;5067;8047
RaymondBykouko;Raymond Bykoukous;Conseil aux entreprises agricoles en matière de santé et sécurité au travail , prévention des risques professionnels. « placer l’humain est au centre de tout »;42;195;16;29;282
aeros_wing;C.A.W;;2537;28;6;804;3375
franckcourchamp;Franck Courchamp;CNRS researcher interested in biodiversity dynamics;2177;391;2727;3491;8786
Victor_obrt;Victor;"""un Homme c'est une bouche mais c'est aussi deux bras""";3526;675;65;25330;29596
laulecoeur;Laurence Lecoeur;Conseil #RSE #UrgenceEcologique & Projets citoyens  Co-référente Génération Écologie 92 Co-fondatrice de l'émission Le Monde à côté;8566;538;559;4456;14119
anne_sicard;Anne Aubin-Sicard;Vice-présidente du Conseil départemental de la #Vendée, 1ère adjointe #LaRocheSurYon, Docteur #droit public #Europe #TransitionÉcologique;8735;1087;1876;4910;16608
lau68951920;lau;đąđââđ·đđ;673227;4994;3417;626163;1307801
Stonks_Corp;Stonks Corp;Juste un passionné d’économie et plus particulièrement des crypto;1387;100;11;121;1619
TabouleAAAAAAAH;TabouléAAAAAAAAAAAAAH;He/him;254;89;6;1666;2015
matgautier;Mathieu GAUTIER;"Associate professor in @insadelyon Research in @labodeep 
Urban geochemistry. Environmental chemistry. Nature Based Solution. Wastes. Circularity. Anthropocene.";205;265;139;425;1034
LucasPetit92;Lucas Petit;;222;94;5;2135;2456
homocommuniste;Pablo ð¦;"Bureaucrate Ã  @SolidairesEtu
                                   
Anciennement @syndinosaure";2096;158;221;8396;10871
voxjaen;Voxjaen;La vie, ce  n'est pas d'attendre que l'orage passe, c'est d'apprendre à danser sous la  pluie. - Sénèque;96784;1890;1943;78143;178760
LEPETITSteph;stephane LEPETIT;Adjoint au Maire de Lille,  chargé du Quartier de #VaubanEsquermes.;4380;650;826;4620;10476
ChMerchadou;MERCHADOU Chantal;Ancienne élue d'Aquitaine et de Paris - Inspectrice Générale du Développement Durable - Épouse #HenriLegrandX75 #Macron @TenorKaufmann #Giscard;27076;1789;2309;33921;65095
LoucasPinto1;PINTO Loucas;;10890;1632;1617;11243;25382
vinzradio;Vinz Kanté;"-  🔎🎬 : @limitofficiel 🌍💭 Limites planétaires
- Fondateur SCHOOL'UP! 🎓
- Shifter🇧🇪♻️⛽⛔
- Born at 350ppm
- ✉️ vinz@limit.media
#Degrowth
🇧🇪🇸🇳🇫🇷🇲🇱";32030;1649;24350;13473;71502
kevCi3;kevCi;;12;61;2;8;83
fnadac;FNADAC;Compte officiel de la Fédération nationale des associations de Directeurs des Affaires Culturelles des collectivités territoriales. #FNADAC 🌈#AssisesDAC🌈;763;302;300;221;1586
PatrickMonin71;Patrick Monin ✌️;Candidat aux élections législatives des 12 et 19 juin 2022 sur la 1ère circonscription de Saône-et-Loire avec @catherine_amaro | #NUPES | Maire d'Azé (EELV);683;871;2172;231;3957
ABPtwit;Bretagne Presse;Toutes les infos qui comptent pour la Bretagne.;42092;165;8742;121;51120
Eleazar_jd;Éléazar;\\\;33758;300;441;60790;95289
ThomasL18174027;Citylights;;1;3;0;0;4
Cmo351;Cmo35;Je suis un troll j'ai qu'un seul abonné 😜 (famille) tu me suis je te bloque tu me retweet et tu n'aime pas mon tweet même sanction;1999;22;1;1386;3408
fred_mrs;frederique richard;"#STOPDUBLIN  
Plus on applique le règlement Dublin,
moins on respecte le droit d'asile
piped.video/f4mCR1N5HCQ
#RefugeesWelcome";47777;1378;1362;139115;189632
chateau_gontier;Château-Gontier;Bienvenue sur le compte officiel de la Ville et du Pays de #ChâteauGontier. Suivez l'actualité en tweets et sur facebook.com/chateaugontier | #CollTerr;2230;315;1703;914;5162
matzenox;AEG MatZenox 💛🤍;Lead IOS marmelade-app: Organisme de formation a distance (HabElec / AIPR / CACES) Fondateur Aegis 083/100 💛🤍 Fan Inconditionnel de Sanji;1499;534;31;5275;7339
DudesertFred;Fred Dudesert;;807;61;8;527;1403
CRECQ;CRECQ;Le CRECQ est un OBNL qui travaille en concertation pour la protection de l'environnement dans une optique de développement durable au Centre-du-Québec.;208;113;250;117;688
GregRoquett;Grégoire Roquette ن 🇫🇷🇪🇺🇦🇲;"Adhérent : @apfhandicap, @L214, @printempsrepub, @theShiftPR0JECT.

#JeSuisCharlie
#JeSuisMila
#JeSuisSamuelPaty
#JeSuisSalmanRushdie
#StandWithUkraine";5468;2348;380;12466;20662
AlexisJanicot;Alexis Janicot;Entrepreneur engagé dans l’écosystème d’innovation #ODD. Ancien directeur French Tech, #Toulouse #digital #greentech #fablab;3047;1299;1328;6251;11925
dm_petit;Damien-Morvan PETIT;Startuper @BYB_Team đ / @nu_solide | engagĂ© @clubensemble1.;1217;178;142;1412;2949
Canope_40;Atelier Canopé 40;Atelier Canopé des Landes. Réseau de #formation des #enseignants :  #education #numérique #innovation #médiation #proximité #pédagogie #edd #emc #emi;3420;907;1793;1645;7765
VRwatchingU;VRwatchingU;Insoumis.;115329;1361;2218;52594;171502
TanShanLiMTL;Tan Shan Li;李丹珊 / Conseillère d'arrondissement de @projetmontreal dans le @SO_MTL – District de Saint-Henri-Est – Petite-Bourgogne – Pointe-Saint-Charles – Griffintown;120;269;61;4411;4861
chanezherbanne;đ«đ· Chanez Herbanne;"ConseillĂšre RĂ©gionale des @hautsdefrance -
2Ăšme VP en charge des lycĂ©es et de l'enseignement supĂ©rieur -
Cofondatrice du PĂŽle MobilitĂ© du Beauvaisis đđ”đ±";6052;3653;2799;11399;23903
sophiepiard;Sophie Piard;Journaliste cellule Planète @France2 @France3 @FranceInfo. S'intéresse à la 🌍 et ses habitants en essayant de rester zen. Née en 326 ppm.;1111;309;1199;278;2897
HugCharbonneau;hugues charbonneau;Autrefois je produisais des films (120 battements par minute, Eastern Boys, L’armée du salut, J’aime regarder les filles…), aujourd’hui j’écolo-évangelise.;15523;3166;7882;91065;117636
Burlesque_32;ð«ð· Abracadabrante;"#JambonBeurre #TeamPatriotes #Reconquete #JeSuisLÃ PourVa
Pas de MP s'il vous plaÃ®t.";4987;2717;2363;21985;32052
EmmanFernandes;Emmanuel Fernandes;đź”´DĂ©putĂ© FI-NUPES de la deuxiĂ¨me circonscription du Bas-Rhin (Strasbourg-sud et Illkirch-Graffenstaden). đź‘‰ Mes propres tweets sont signĂ©s.;1416;1012;6857;2662;11947
didjule;ʝʋ;"Quelqu'un sait à quelle heure c'est la prochaine révolution ? 🤔

Instit, militant cgt, musicien, à spondy pour la vie #autoimmunesaloperie #dépressionforever";14533;571;238;16607;31949
VilledeChenove;Chenôve;Compte officiel de la ville de Chenôve #chenove #dijonmetropole ville-chenove.fr;429;301;375;445;1550
ChloeClair_namR;Chloé Clair;namR CEO | The power of data for ecological transition 🌱;35;120;64;95;314
Izidra_;Izidra đđ;Esprit curieux et critique. RĂ©voltĂ©e par les injustices et les mensonges. No đș #FreeAssangeNOW #FreePalestine;12561;100;102;19748;32511
danlert;Dan Lert;Maire adjoint @Paris en charge de la transition écologique, du Plan Climat, de l'eau et de l'énergie. Président @EaudeParis. Élu écolo du 19e arrondissement.;8029;2720;5966;10482;27197
VicGranier;Victor Granier;Urbaniste OUQ - Montréal - Francoquébécois 🇨🇦🇫🇷🏳️‍🌈 - Au service de la résilience urbaine et du GeniusLoci #transitionécologique #patrimoine #mobilité;454;1249;232;880;2815
Ccesoir;C ce soir;"#CCeSoir, présenté par @KRissouli et @CamilleDiao 
du lundi au jeudi vers 22h30 sur @France5tv";8742;114;40806;2333;51995
tcoiffeurjustes;thierry gras;Président de l’association COIFFEURS JUSTES et créateur de la licence de marque Hairdresser Fair For Family.;1413;373;159;92;2037
ChrisLavaquerie;CHRIS LAVAQUERIE-KLEIN;Autrice d’essais et d'ouvrages documentaires, Conseil en médiation culturelle, Patrimoine, Histoire de l’art, enseignante - @ICOM_france @SGDLauteurs @icom_ceca;1953;2785;792;8617;14147
AnneTallineau;Anne Tallineau;Secrétaire Générale de @ofaj_dfjw;1011;298;940;853;3102
SoniaBEKO;CEO Patricia Sonia B ­čç¬­čç║;"Fran├žaise ┬Ž #Terrain ┬Ž Entrepreneur ­čŤŹ 
Coordinatrice de la Grande Marche 2016 ┬Ž @Renaissance ┬Ž Soci├ęt├ę Civile ┬Ž M├Ęre ┬Ž Humaniste ┬Ž­čç║­čçŽ ­čĺ╗­čô▓­čÄą­čĆÇÔťő­čî▒­čîŹ";8946;3998;5817;35550;54311
HMassenet;Hubert Massenet;;2728;19;21;224;2992
corsenetinfos;Corse Net Infos;Primu media pure player di Corsica Per voi, incù voi in ogni locu. Premier média pure player corse.  instagram.com/corsenetinfo/;62139;1333;36737;165;100374
EricKrezel;krezel Eric;Maire de Ceffonds (52) Vice-Président des maires ruraux de France, Président Haute-Marne, VP « innovation rurale » agglo saint-Dizier Der et Blaise;1519;344;387;2550;4800
GreenpeaceTours;Greenpeace Groupe local de Tours;;702;207;261;1224;2394
RANCHEREP;Philippe Ranchère;Passionné par les questions d'habitat et de logement, j'ai collaboré en ADIL (Roubaix, Loire-Atlantique et Finistère). Ce compte est personnel.;5414;1198;391;816;7819
lepenenchon;Jean-Marine LepenenchonZ (parodique);Compte PARODIQUE - Mi-blonde, mi-ronchon et mi-Z : 100% #RNupes #ZFI #TeamDeglingos #JamesMarine #Les4Fantastics #MajoritéSilencieuseRépublicaine #NousSommesLa;22268;1145;1751;50560;75724
SalifKO31547825;Salif KONE;"Activist about Climate and Social Justice.
#Agroécologie #Semences 
Genre et Développement. 
My CV us.docworkspace.com/d/sIEKL-…";137;711;184;168;1200
WelterDelphine;DELPHINE WELTER;"Journaliste TV
Reporter d'investigation
Auteure
#pressejudiciaire
Cover Films 
Les Experts du Crime / Podcasts exclu M6 diff 2023";49;153;61;224;487
lowtechs;Actualité sur les low-techs;"Toute l'actualité sur les low-techs en temps réel.
Un media @influence_sol.
#lowtech #low-tech";691;1;579;2;1273
TransitionsEco;Transition écologique du droit économique (TEDE);"Projet de recherche pluridisciplinaire visant à identifier les leviers de la transition écologique en droit économique

♺ et ♡ ne valent pas approbation.";287;81;121;206;695
netguide;Netguide;Nourrir ses centres d'intérêt, cultiver sa curiosité, contrôler son infos. Découvrez notre plateforme sur Netguide.com;607632;1;3085;0;610718
FP_Champagne;François-Philippe Champagne (FPC) 🇨🇦;Député fédéral de Saint-Maurice—Champlain. Ministre de l’Innovation, des Sciences et de l’Industrie l Minister of Innovation, Science and Industry 🇨🇦;25833;3502;61741;21219;112295
RV_Joly;Hervé Joly;Chercheur CNRS, historien beaucoup, sociologue un peu,des élites, des entreprises, etc. et autres études ou avis n'engageant pas le CNRS!;10673;219;1968;3399;16259
MajidZiraoui;Majid Ziraoui;#Nord #servicepublic #transitionenergetique #smartgrids #bigdata #IOT #hautsdefrance | Alumni @SciencesPo;419;570;150;1257;2396
B_SMART_TV;B SMART;Le media des audacieux;12260;512;16651;1847;31270
nutriac;Anne-Claire Durand;"Ingénieur agro #nutrition, #food, #RSE
Membre d' @ellessontfood, Actionnaire et évaluatrice @TFTP_France
Mes tweets n'engagent que moi";18520;1158;4318;10921;34917
aure79lien;Aurelien Lallemant #RSE ð #blockchain #tech4all;Humain passionnÃ© de #digital , #web3 #blockchain #IA #metaverse #tech #startup et aussi #environnement #transition #RSE #decroissance;22275;2420;2483;19817;46995
francoisastorg;François Astorg;🇫🇷🇺🇦 Maire d'Annecy #UrgenceÉcologiqueClimatique #RenouveauDémocratique #JusticeSociale #ÉconomieLocale Vice-Président Grand Annecy;1004;485;2480;479;4448
GCHAlliance;Global Climate and Health Alliance;Global coalition of #health organisations tackling #climatechange to protect and promote public health.;15548;4539;10213;7534;37834
lemondefr;Le Monde;"L'actualité de référence par la rédaction du Monde | Piloté par @hpagesy @gregorbrandy & @PBerhouet
Nos comptes Twitter associés : lemde.fr/3ApwJXb";445093;671;10645948;1701;11093413
abr_yann;AbrYann;#servicespublics #eau #assainissement #environnement #collterr #ssd93;1122;398;101;2543;4164
LiberteWatts;Guillaume Faure;⚡️⚡️ L’app qui te récompense si tu baisses ta consommation aux heures de pointe ⚡️⚡️;232;399;53;257;941
AMDucroux1;Anne-Marie Ducroux;"Enjeux du XXIème siècle, état du monde... 
Expertise #DeveloppementDurable #Environnement #RSE #ESG #Dialogues 
Bonus #Beauté #Saisons #Nature #Culture #Paris";23817;4372;1411;3058;32658
sergemartin4;serge martin;;586;439;276;1375;2676
AlphalexInform1;Alphalex-Information;;4701;3;15;0;4719
Calnos1;Calnos ๐บ๐ฆ -๐๐๐๐+๐ - ๐๐๐๐;Dit de la merde, spรฉcialiste en la matiรจre. --  Fan de chat - #Acouphรจne (3 ans) - #Athรฉe - #Antithรฉiste - L'amour est une purge - Misanthropie : 53.;72986;358;463;163391;237198
lapin47;Angry_Bisounours #FreeAssange #64ansCestNon;Liberté Égalité Fraternité Laïcité Féminisme Écologie Altermondialisme Solidarité Justice République Démocratie Pacifisme;592068;13051;15283;457733;1078135
frededlens;Frédéric LAURENT;@eConsultingRH & #recrutementstartup - Agent de #Talents ! - Fan irrationnel du #RCLens Compte personnel 😉;5866;574;649;3461;10550
LouisdeRedon;ð³ Louis de Redon;IngÃ©nieur agro et MaÃ®tre de confÃ©rences HDR en droit de lâenvironnement @AgroParisTech & @SorbonneParis1 // #biodiversitÃ© // #agroÃ©cologie;1454;1431;1179;505;4569
dracobis;Draquoicoubeh đ;"22 yo | Turbogauchiste passionnĂ© de trains et d'informatique qui dĂ©teste la rĂ©ussite | FI hate account | PrivĂ© @minidracobis
@Draco'#2798";75311;718;2554;95136;173719
Karl_Chretien;Chretien Karl;;1989;57;48;1322;3416
C3RD4;C3RD;Centre de Recherche sur les Relations entre les Risques et le Droit créé en 2006 au sein de la @fld_lille_issy de @UnivCatholille @FacultesUCLille;2496;894;515;1238;5143
clemrenard_;Clément Renard;#DroitsHumains #LutteSociale #DémocratieDirecte #PeuplesAutochtones #Écologie #Climat #AbyaYala;10539;2442;6535;11617;31133
BaudJeana;BAUD JeanÀ;;1177;13;0;34;1224
Loic_Ferrieu;Loïc Ferrieu;Conseiller municipal à #Ramonville • #CollCab à @Bruguieres31150 • Adhérent @HorizonsLeParti • #Aveyron  • Européen convaincu 🇪🇺;7811;1633;2035;81;11560
KTPLeGallois;Quicampoix;Ils me détestent car je suis sigma;11304;168;1146;25815;38433
Prefet38;Préfet de l'Isère 🇨🇵🇪🇺;Compte officiel de la préfecture et des services de l'Etat en Isère.;5252;319;16318;753;22642
harmonie_okg;Yoba;You will be left speechless 🤌🏿;33078;285;325;6516;40204
VMatillon;Véronique Matillon;Maire de @Rambouillet_78. Vice-présidente de @Agglo_RT78 en charge de l'Action sociale et de la Santé. Infirmière coordinatrice.;1075;267;859;43;2244
falfaled;falfaled;“Le bateau s’échoue et on l’encadre..”;28441;3743;1126;26807;60117
LPhilosophique;ð«ð·La Chaine Philosophique;ð«ð·NICOLAS GUGLIOTTA, Essayiste Philosophie, Coach Sportif/Bien-Ãªtre @LibreCollectif des Bdr Ce qui ne tue pas rend plus fort. Nietzsche #SoutienSuspendus;6103;2207;1517;5330;15157
MUSICBIZ_media;MUSICBIZ;"Business, économie, musique. 

#musicbusiness #musicindustry";1676;22;1003;4;2705
NadegeG64;Nadège - Macron DEGAGE !;;10480;633;447;26832;38392
cathy09792112;cathy;"un jour je suis née et depuis ....j improvise .
Pire que le bruit des bottes, le silence des pantoufles.";954;52;17;2330;3353
nertenliceoff;Nicolas Ertenlice ❁ 🏫;Élu au C.A, CVL, CESC au lycée, délégué de classe #SciencesPolitiques #journalisme✍️ #sport & #jeunesse – Président de #MDL.Référent thématique @JCentristeEcolo;1493;99;92;2247;3931
VincentDrezet;Vincent Drezet;Porte-parole d'@Attac_fr, fiscaliste, contributeur @justice_fiscale, co-auteur d'Impôts : idées fausses et vraies injustices (2021). Ex-SG @SolidairesFiP.;1148;359;1534;6182;9223
Panda31808732;Maître Pandaï;« Entre le champagne pour quelques-uns et l'eau potable pour tous, il faut choisir. » — Thomas Sankara;35875;109;24562;24434;84980
dstesjules;Jules 🕸;plus many que tony 🤌;5059;953;199;985;7196
LaVieEnWeb;Manuel Pardo;;3825;381;69;10163;14438
Challenges;Challenges;Toute l'actualité de l'économie, de la finance et de l'entreprise 💰 Chaque jeudi en kiosque 🗞 Facebook - Linkedin - Instagram: @Challenges;116996;610;244686;2106;364398
AutoPlusMag;AutoPlus;"Twitter officiel du magazine Auto Plus, le 1er journal qui se met à la place du conducteur !
Notre chaîne TV : autoplus.fr/tv 🎥";74097;156;47635;1924;123812
mariongaudin;Marion Gaudin;Journaliste @France24, ex-correspondante à Madrid @TF1, @LeParisien, @itélé;417;494;2733;302;3946
WhitecastleD;Whitecastle Dicky;Vivre à Mazargues, mourir à Sormiou;821;42;4;141;1008
belou03;Pasclair 2 . Compte secours de @Pasclair bloqué;"NON à la censure: 3 500 à moins de 1000 abonnés 
Ils veulent nous faire taire.
t.me/Tpasclair";71342;596;1052;58501;131491
DavidVo74820499;David Vogel;Will never comply with all the absurdities thrown at us by abusive governments. No face underwear, no jab, no ausweis of shame,no physical distancing;2628;51;151;2177;5007
Laforet_Lyon4;LaforetLyon4;Une agence #immobilière forte de près de 20 ans d'expérience sur le secteur de la #CroixRousse dans le domaine de #Transaction, #Location, #Gestion. #Lyon;2385;102;80;0;2567
timeoutparis;Time Out Paris;Avec Time Out Paris, retrouvez l’essentiel des arts, de la culture et des sorties parisiennes.;18198;1037;58716;850;78801
tomlaigle;Thomas Laigle;"Ingénieur pédagogique à @EnsaTlse. 
#Innovation, #Pedagogie, #Formation... et depuis peu #Architecture !
Trésorier du prix Écrire la ville.";4920;547;1813;3314;10594
Cardienec;Cardien Diemil;Actualités, Sciences, Culture;12860;338;111;8657;21966
Axel_Darut;Axel DARUT;Circular Economy activist @No_PlasticWaste initiative -@minderoo♻️🌍🇪🇺 Co-author plaidoyer-lobbying.fr with @MichelGermond 📣🌿 between 🇳🇱🇧🇪🇨🇵;4097;4998;1823;10679;21597
B2Bolo;Barthelemy Bolo;Compte personnel. Conseiller presse et communication de la Maire de Paris @Anne_Hidalgo.;12260;3472;4493;10086;30311
EFFICYCLE_fr;EFFICYCLE;#EFFINEWS : retrouvez chaque lundi le meilleur de l’actualité du développement durable ! #MOTIVACTION : découvrez des portraits d'initiatives pleines de sens !;13170;23056;50082;3586;89894
laureldenantes;Laurel Denantes;Inscription récente afin d'avoir des informations diversifiées sur la situation actuelle.;4997;475;42;1958;7472
LaPiraterieBack;Théorème relation entre continuité-dérivabilité 📉;;1631;167;10;10583;12391
ThomasChappuis;Thomas Chappuis;;744;1017;540;5295;7596
fabio35590;Fabio ð¨ðµ;Empathy & Justice âï¸, Against Conspirators & Profiteers ðµ, Science without Consciousness is but the Ruin of the Soul (Rabelais) ð;24898;1194;1143;35082;62317
LaSamaritaine12;Séraphina;"Bienheureux celui qui a appris à Rire de lui-même : il n'a pas fini de s'Am-user !

Psaume 22 : Le Seigneur est mon Berger,

La Vérité est mon Épée";10027;131;109;12850;23117
benjvanpet;Benjamin van Peteghem;Pour une société plus juste et plus humaine;903;407;79;1424;2813
bernard_volk;bernard.volk;"Alpipro B2B  stations ski -
Digital Montagne B2B solutions digitales marketing touristique 
#DIGI2018 #innovation #digital #montagne #digitalmountainawards";2229;338;493;440;3500
Bdelor1054;Bernard Delor;Biologiste créateur de la biosophie (Fusion de la biologie avec la philosophie);13415;123;217;182;13937
StanMendy;Stanislas Mendy;Écolo / Scénariste / Footeux (@AS_Monaco mon amour) / Passionné par l'humain, l'histoire et la vie / Ni Bolchevisme, Ni Consumérisme / #Friconoclaste;85772;4997;2990;71860;165619
stephrider;Stephrider;Amusé désabusé, motardo-geeko-sportif, prêt à rire de tout et à pleurer du pire....;2729;234;33;597;3593
Elysee__2022;Politique;Actualité politique en France;242925;117;5652;34;248728
neilmakaroff;Neil Makaroff;"Directeur de Strategic Perspectives @StrategicEU
Militant pour une Europe du climat ☀️ 

Membre du Board de @transenv. Views are my own.";3337;1436;2891;5313;12977
sretailleau;Sylvie Retailleau;đź‡«đź‡· Ministre de l'Enseignement supĂ©rieur et de la Recherche | đź§‘đźŹĽâ€ŤđźŽ“ Enseignante-chercheuse en physique & en Ă©lectronique, ancienne prĂ©sidente d'universitĂ©;1022;637;16849;1476;19984
AndreMARTIN126;André MARTIN;"Vice-président Conseil Régional #PaysdelaLoire en charge de #jeunesse #emploi #formations #apprentissage #lycées #orientation #insertion 
Maire de #Oreed'Anjou";2973;1432;2626;4808;11839
Gaston85105542;Bulot Gaston;"Non à l'endoctrinement médiatique sur le réchauffement climatique anthropique .
Non à l'éolien qui défigure la France et fait exploser notre facture EDF
#climat";20119;231;169;15105;35624
MonLhuillier;Monique L'Huillier;;9169;296;42;1052;10559
Pauline_ANEPF;Pauline Lavenant;ðªðº Vice PrÃ©sidente en charge des Affaires EuropÃ©ennes @Pharma_ANEPF | ð¨ðµ Ãtudiante en 5Ã¨me annÃ©e de pharmacie Ã  Toulouse;1307;1339;967;6164;9777
grandin_laurent;Grandin Laurent;Engagé dans l'action collective depuis plus de 30 ans au sein de la filière #fruits et #légumes. Actuellement président d'Interfel;3427;444;901;6123;10895
LaRepDpyrenees;La Rép des Pyrénées;🗞 1er quotidien d'info locale en Béarn et Soule, compte 100 % humain ! Animé par @robaly @JC2Pau @Ambre_trn;63745;507;19334;542;84128
RenouveauBxM;Renouveau Bordeaux Métropole;Le groupe d'élus progressistes à @BxMetro.;507;100;279;478;1364
VirginieDrapier;Drapier Virginie;Présidente bénévole @Cedisformation #sobriété #logement #emploi #formation #santé #handicap #Lille4;3144;489;396;3031;7060
Martine7lnwb;Martine ASSAR LEINENWEBER;En charge de l'Observatoire des métiers et des questions liées à l'industrie du futur au sein de la  la Direction générale de l'INSTITUT MINES TELECOM;7658;692;311;3575;12236
cegepduvieuxmtl;Cégep Vieux Montréal;Le cégep du Vieux Montréal (CVM) est un établissement d'enseignement collégial offrant 52 programmes, profils et options. #cvm #cegepduvieuxmtl;359;222;2306;25;2912
arefsalem;Aref Salem;Chef de l'Opposition officielle à l'Hôtel de ville de Montréal et conseiller de la Ville dans @ArrSaintLaurent pour @EnsembleMtl. @MTL_Ville #polmtl;2877;1681;2532;1495;8585
bbel34;Boris Bellanger;Greffier principal. Adjoint au maire de Montpellier, délégué au patrimoine historique et au quartier Centre. Socialiste. Montpelliérain d'origine bretonne !;977;977;929;2699;5582
titrespresse;Titrespresse.com;Les derniers titres de la presse en France, Suisse, Canada et Luxembourg, venant des principales sources d'informations.;1809845;649;3518;30;1814042
domi_1703;Thierry Grugnon - Égérie FHF 2023;"Executive Director des acteurs du territoire🙏

Mascotte officielle de la French Care🦃🇨🇵

Ex-Ministre de la Santé et du Funk

Territoire du Meurmieunois";5560;22;2014;5199;12795
franckstassi;Franck Stassi;Journaliste #BTP (matériaux, construction, aménagement, bois...) et Biens de #consommation @usinenouvelle. Blogueur @businessmarches. Compte personnel.;12838;455;1056;16597;30946
matheomanon;Stef;;1903;43;20;9152;11118
lagrossefouine1;lagrossefouine;Nier les violences policières, nier la pénibilité du travail, nier les conflits d’intérêt, un gouvernement de niais!;68154;26;641;72326;141147
LiegeChene;Chêne-liège;maladive;124312;139;388;176856;301695
FabriceLo;Fabrice;Ecologie. Détermination. Droits humains. L’avenir est à réinventer / Ecology. Determination. Human rights. We need to reinvent our future.;3387;176;114;9360;13037
4aout;Agence 4août;4août est une agence de communication citoyenne. Agence labellisée en 2022 #RSE Agences actives ⭑⭑. #conseil #digital #création;1744;1064;903;956;4667
MohamadParis20;Mohamad L Gassama🇲🇫🇪🇺;"Delegué de #Renaissance pour la 15e circonscription #Paris #Paris20
élu à la mairie du 20 (2008 - 2020)
BF RE Paris en charge de la Politique de la ville";8561;3878;4013;24406;40858
Cevennes75;Larco;;1895;131;18;164;2208
le_Parisien;Le Parisien;L’actualité qui vous concerne📱🗞️;541639;840;3261347;718;3804544
Herve_Bailly_Fr;Herve Bailly Safran;"Purchaser at Safran
#Safran #Aeronautique #Casting #Fonderie #Forging #Forge #Machining #Additive #Inovation #Environnement #Rafale #Dassault #Boeing #Airbus";1690;1306;154;223;3373
enisseo;Enisséo;Auteur, musicien et revendeur en herbe. Instapoet, instant regret. Lanceur d'Arlette. Chief Happiness Officer for France (the country, not the meal).;31780;318;323;5321;37742
Axlndsoft;Andone;No deal in absolute;1900;597;17;1875;4389
boenbot;Toute l'info en France;Les dernières infos et actualités en temps réel;45387;33;114;11;45545
SamiraDIRAT;DIRAT Samira;;1189;532;112;3564;5397
stephaneledez;Stéphane Ledez;Directeur Territorial @enedis @departement59 - Pdt SLE #Flandre Membre du COS @CEHDF - Pdt @FNCS_HDF - @SFENorg - #TransitionEcologique #Universalisme #Music;5500;1552;1661;10461;19174
Julietteetienn5;Juliette etienne;"Socialiste jusqu'en 2017, Macron 2022 Allergique aux extrêmes
Pas de DM";60573;2533;2596;196376;262078
reseau_internat;Réseau International;Site de réflexion et de réinformation;51742;2686;28646;138;83212
RN_BFC;Groupe RN BFC;Actualité des 18 élus du groupe @RN_BFC, présidé par @JulienOdoul au Conseil régional de Bourgogne Franche-Comté.;5358;416;1880;3819;11473
GerardDupin;Gerard Dupin;International Consultant Telecom & Environment;124696;4998;3064;87788;220546
Reporterre;Reporterre | Le média de l'écologie;"Média indépendant, en accès libre, sans publicité, à but non lucratif, dédié à l'urgence écologique. 
Financé exclusivement par les dons de ses lecteurs.";25477;334;140182;680;166673
guigui30000;Karman-line;J'aime la science, l'astronomie et fabriquer des trucs;3500;51;54;2277;5882
QuimperleVille;Ville de Quimperlé, Kêr Kemperle;L'actualité de la ville de #Quimperlé.;1120;179;279;158;1736
IsegoriaNantes;Isegoria Audencia;Tribune Etudiante d'@Audencia : Débats et Conférences avec des Personnalités. Entrée libre & gratuite;1993;381;879;569;3822
christianVASSE;christianVASSE;;3131;79;57;50;3317
mauricedelorme3;Maurice Delorme;đ«đ·đ«đ·70 ANS đ«đ·2 bonnes raisons de suivre ce compte 1/ tout sauf #Macron 2/ tout sauf #Macron  đ«đ· đ«đ·#jambonbeurre;33445;3324;3171;2200;42140
_Bens_M;pǝɯɯɐɥoɯ;La fatalité existe que pour ceux qui l’acceptent;92281;1844;3323;17235;114683
TWLorz;Desperated french;Point de vu franc et sans filtre avec une touche d’humour et de second degré, ici vous trouverez de quoi oublier les horreurs qui défilent sur le fil d’actu;3275;4734;5610;399;14018
GouletNathalie;Nathalie Goulet;Conseillère de la Ville, district d’#Ahuntsic, arrondissement Ahuntsic-Cartierville;3488;2352;1569;3605;11014
Robin_Salecroix;Robin Salecroix;ð¦ Vice-PrÃ©sident de @NantesMetropole en charge de l'eau et de l'assainissement / Ãlu @villeNantes - SecrÃ©taire DÃ©partemental du @PCF et membre du C.N -;2534;1093;1412;4760;9799
HeleneCruyp;Helene Cruypenninck;Adjointe à l'Environnement et à la Nature en Ville @Angers #LaREM #Horizons #5ansdeplus Changement climatique, déchets, vélo, voyages, stargazing...;731;332;831;1656;3550
cashinvestigati;CASH INVESTIGATION;Enquêtes sur le monde merveilleux des affaires. Incarnées par @EliseLucet, diffusées sur France 2. Une production @PLTVfilms. 📺➡️ #CashInvestigation;2921;154;182850;621;186546
seb92800;seb92800;"Responsable de pôle technique. 
Coureur à pied et triathlète amateur. Ancien arbitre  national de handball.";1581;218;33;2108;3940
oxfamfrance;Oxfam France;Oxfam est une ONG internationale qui mobilise le pouvoir citoyen contre la pauvreté #Climat #Inégalités #Solidarité #Humanitaire #LAffaireDuSiecle #LAffaireBNP;17703;1346;151689;6996;177734
ConseilPauvrete;CNLE;Conseil national des politiques de lutte contre la pauvreté et l'exclusion sociale. Le CNLE est composé de 65 membres dont 32 personnes concernées.;269;443;1287;231;2230
enilordnA;✨Androline;Caroline, 30 / Mad dreamer 🇫🇷Louis’s mom💖 030820 . waiting for Ben Barnes to marry me.👀;45340;276;862;35032;81510
clauderenard777;claude;"Massaliote
Super-Héros du #Motchus doté d'une vision à rayons-X pour la lecture des grilles.
Mes tweets n'engagent que la responsabilité du gouvernement.";30218;913;340;36249;67720
villedegrigny91;Ville de Grigny (91);Compte officiel de la Ville de #Grigny (30 000 habitants) ! Ville la plus jeune de l'Essonne, membre du réseau mondial des maires pour la paix.;3485;525;1119;871;6000
Mad_Margaux;Mad_Margaux;;1047;753;266;4905;6971
Grain2Vie;Marjan Henricowicz;Décroissance / Génération écologie / né à 333,8 PPM / Vive le temps libéré du productivisme et de la croissance ! @GEcologie #degrowth #planetboundaries;4058;945;553;2750;8306
Contexte;Contexte;L'info politique dont les professionnels ont besoin đź‘‰ contexte.com;53637;1303;33471;216;88627
glassofschotch;.;;2131;403;41;19905;22480
the30man;Charles Diers;Adjoint aux sports @Angers / Alumni @ESSCA_Ecole / Co-fondateur @LaDalleAngevOFF / Ex-footballeur @LFPfr;10104;1251;5988;12804;30147
AurelieCoudouel;Aurélie Coudouel;#CM attachiante & à l'affût. Respire/Mange/Aime #Veille #SocialMedia #SocialTV #eReputation #eMarketing. Twitteuse compulsive droguée aux #TVShows.#SeriesAddict;354239;514;11069;28851;394673
zersinan1;zer sinan;militant communiste révolutionnaire internationaliste ! Le communisme, et l’avenir du monde!😣🧐😠😡🤬🤯😳;228021;1846;582;14256;244705
Theo_Parigo;Théo Farmer ;Pronouns : pota/toe (@Lamaresseux_ a 13 ans oskour) | vague connaissance de @111inho44;35400;401;2794;36571;75166
philippe_ratto;philippe ratto;Directeur d’offres RATP Dev lot bus et trolleybus #mobilite #transportspublics #lyon;113;234;61;717;1125
Conservateur20;Souverainiste 2.0;Comment passer les pointes d'hiver avec seulement 50% de nucléaire ? Les EnRi produisent peu l'hiver. On revient au charbon/gaz comme l'Allemagne?;11686;2654;1242;455;16037
rigaud_laurent;Laurent Rigaud;Président de la CMA Hauts-de-France | Vice-président de la Région Hauts-de-France. Mais avant tout, homme de terrain;1433;3051;2029;4494;11007
JMaStarforever;JMaStar;;2159;659;48;6524;9390
francoispinche1;François Pinchemel;technocrate du développement durable (de lapin(çalinge));14720;369;185;9191;24465
FLallemant;florence lallemant;"Anesthésiste reanimateur urgences #ChruLille
#SfarGreen
#développementdurable";473;441;157;705;1776
Prefet976;Préfet de Mayotte;Compte officiel de la préfecture et des services de l’État dans le département de Mayotte.;4412;302;11938;542;17194
Pierre_Labbe_;Pierre Labbé;Moteur de première main, 47 km, bone etat, pas de frais a prévoir, contrôle technique ok, boite de vitesse neuve;2969;17;13;76;3075
AOC1978;Amélie Oudéa-Castéra;Ministre des Sports et des Jeux Olympiques et Paralympiques;4060;637;39112;2018;45827
TheDarkPixel;OlivierðDassonville;Digital Jedi, #socialmedia manager, digital #mediastrategist, #gamer, pilot #fpv Social Jedi for @web2day & @lesMachinesNtes.;173653;4064;5560;7687;190964
melahalk;melahalk;"Analyste  Politique  Economique Financier   Social
Activiste  1 grand Canada pour tous et tous pour 1 grand Canada.
Activiste  1 transition climatique réaliste.";2285;125;12;32;2454
REQMontreal;REQMontreal;Le REQ est un réseau d’acteurs ancrés dans le territoire montréalais à l'origine de projets de développement durable, d’implication citoyenne et d’ERE.;1645;1123;524;83;3375
midy_paul;Paul Midy;đ«đ· DĂ©putĂ© de Paris-Saclay (Essonne) âą Membre du @CNNum âą Entrepreneur âą Co-fondateur de @paris_digitale âą #Numerique #FrenchTech #MidyĂ14h;3377;2806;7043;7925;21151
littlebigfred;LittleBigFred;;103119;178;1602;31199;136098
templie40351919;templier;;474;37;3;114;628
jbgagnoux;Jean-Baptiste Gagnoux;Maire @LesRepublicains de Dole , Vice président du Conseil Départemental du Jura;587;1060;484;520;2651
AudreyPulvar;Audrey PULVAR;Écoféministe à vélo/en métro. Universaliste woke. Adjointe à la Maire de @Paris. Conseillère Régionale d’Ile-de-France.🇫🇷;62522;5676;122245;46602;237045
ChristopheHuy;Christophe Collignon;Ministre wallon du Logement, des Pouvoirs locaux et de la Ville. Bourgmestre en titre de Huy. Et grand supporter du Standard de Liège...;2524;956;2509;1349;7338
PhdConseils;PhD Conseils;Courtier Assurances de Personnes Epargne financière SOFRACO. Coach financier FILIB. Formateur professionnel.;186;1;0;0;187
infernale95;utah2828 - #Macron2022;LE COEUR A SES RAISONS QUE LA RAISON NE CONNAIT PAS;234687;2028;1056;11383;249154
duodecimal_;DUO DECIMAL;Expertise-comptable;1134;98;46;8;1286
Chricie29;Chris M;Assignée à résistance  - citoyenne engagée pour la défense des libertés;350;2;4;991;1347
lily_ANESTAPS;Lily Rogier;Vice présidente en charge des Affaires Académiques à l’@anestaps 💙 Stapsienne à temps pleins 🏊🏼‍♀️;457;289;235;1018;1999
RevPermanente;Révolution Permanente;L'info du bon côté de la barricade depuis 2015. Nous avons besoin de votre aide, faites un don : revolutionpermanente.fr/fair…;45670;943;74868;4587;126068
CabinetExium;CABINET EXIUM BEAUMONT;Cabinet d'Expertise Comptable;135;26;3;0;164
alpazur_audit;Cabinet Alp'Azur Audit;;231;1;1;0;233
Mme_Hall;Mariannig Hall;"DG Espace Mendès France (Culture Scientifique)
précédemment DG Crous, DGA Social CD79, Directrice Territoires Région";15878;564;817;17172;34431
ro2consult;RODES;;52;44;7;15;118
NadineLevratto;Nadine Levratto;"Ăconomiste, directrice de recherche au CNRS 
đ L'Ă©tonnante disparitĂ© des territoire industriels (Pr. Ecole des Mines); Les Ă©cosystĂšmes entrepreneuriaux (ISTE)";1863;884;2983;2814;8544
AudaceGaming;Audace Gaming;Volet Gaming d’Audace Studio. Projet en cours de développement sur Twitch/YT/TikTok. Contact : audacestudio.business@gmail.com;94;246;18;144;502
ArchiMalakoff;Architecte Malakoff;Promeneur observant la ville et architecte dessinant projets.Ici, je tweet #Malakoff  ✌️🙂✌️;417;141;217;2414;3189
RICHARDpatrick_;RICHARD patrick✏️;"ProfDeTechnologieMartonne patrickrichard.eu 
Président xn--tc-bja.fr  
DôN Afrique raiffet.org
#BigDataÉdu #FibreÉducationEurope 100%Fibre @LavalAgglo";26650;4992;2094;8039;41775
SceauxEnsemble;Sceaux Ensemble;Groupe municipal Ville de #Sceaux (92) élus #LREM, associatifs, n'appartenant pas à la majorité. #AvecVous;395;414;93;446;1348
pierrehman;Pierre;Consultant - communication, rÃ©seaux sociaux, influence et d'autres trucs chouettes ð´ð®ð¹;46343;920;1132;24165;72560
MyTransitParis;MyTransit Paris;Actualités des transports de Paris: #RATP #RER #Transilien #SNCF #Paris;13572;140;125;71;13908
Dunkerwest;LDzodiak;;80438;4158;568;582;85746
ClintGrease;Clint Grease;#RenaissanceEuropéenne 🇪🇺 #MajoritéSilencieuseRépublicaine #communisteUnJour… #nonAuRetourAlternanceStérile #pourUneOppositionConstructive #EtPuisOnVerra;56148;1725;1860;29296;89029
Prefet78;PrÃ©fet des Yvelines ð«ð·;Compte officiel du prÃ©fet et des services de lâÃtat dans les Yvelines (France) yvelines.gouv.fr;21396;1640;24626;4644;52306
bouleber;bertrand boulenger;Journaliste de sport, passé par @ESJLille. Collaborateur pour @LeCycle1 et @lavoixdunord. Cycliste et photographe animalier à mes heures perdues.;3134;185;188;4410;7917
Ephemerenuit;Ephémère;"Dormir pour toujours, bercés par les vagues
@Ephemere@m*st0d0n.t0p";5121;76;71;34693;39961
zario58;E2P;Paris est devenu invivable. Le mouvement #saccageparis est sa seule chance, contre une mairie idéologue et destructrice.;87535;997;1396;120611;210539
Vitopirate;Doc;;43;12;10;38;103
libdemnightmare;Armée Nationaliste Révolutionnaire Bolchévique ☭;Place au peuple et à la révolution nationale prolétarienne. #augoulag les libdems et les azovites. #augoulag les wokes corrupteurs des mouvements 👩 et 🏳️‍🌈.;11567;149;290;7315;19321
cofinaudit;COFIN'AUDIT;"Cabinet d'expertise comptable. Accompagnement des Chefs d’entreprise. Création, investissement, cessions, transmissions...
cofinaudit.com/";356;55;22;14;447
MDelafosse;Michaël Delafosse;"Maire de Montpellier - Président de la Métropole. 
Professeur d’histoire et géographie - met en œuvre la gratuité des transports - cycliste - jeune papa";20943;2159;31409;51002;105513
PaulH_B;Paul-HB.;;5801;40;58;164;6063
LinucheB;Linuche Bertrand;Pas envie d'échanger des insultes donc je bloque;5422;533;90;24630;30675
PharaonChambers;Pharaon Chambers;La révolution des consciences et de l'imaginaire pour fonder un autre monde vivable n'est plus un luxe mais une nécessité pour que survivre l'espèce humaine! 🕔;701;71;11;412;1195
adriendelacroix;Adrien Delacroix;Maire adjoint #SaintDenis urba-aménagement | Conseiller territorial  #PlaineCommune habitat et foncier | Conseiller régional. #Gauche #Écologie #logement #Hlm;3726;2638;2449;3626;12439
AngersOnline;Angers Online;A suivre !;52233;952;3787;245;57217
CorwinAmbre92;Corwin d'Ambre;;14512;1051;478;12069;28110
thinkaboutFR;Simple French Man (SFM) juste me;;1531;108;10;3376;5025
BPartisans;Brainless Partisans ð´ââ ï¸â¢ï¸â£ï¸ðª;"Ne soyez pas victimes de lâignoranceâ¼ï¸
/ Suivez-nous sur Telegram t.me/BrainlessChanel";51232;35023;38159;14869;139283
SkySpace1865;Sky Space;"J'aime: science, nature, ciel, espace
Je défend liberté, égalité, fraternité, démocratie et humanité
#الحمد_لله_على_نعمة_الاسلام
كل الناس أخوة في الإنسانية";20918;2136;146;12233;35433
en_psy;Psy EN ð§ SociÃ©tÃ©;"Comment (se) pe(a)nse la sociÃ©tÃ© ?
#interpsysocial Organisation de l'Ã©cole.
L'#orientation : espace pour rÃ©flÃ©chir Ã  l'organisation de la citÃ©.
#PsyEN";3107;576;280;1044;5007
Iauradee;Laura Dee;;9796;452;93;4531;14872
ffunivers;Orange pressé 💉💉 BioNtech 💉 NIH/Moderna 💉#BA5;"« L'ignorant affirme, le savant doute, le sage réfléchit. », Aristote.

Les vaccins sont sûrs et sauvent des vies. #FaitesVousVacciner";63277;1976;750;9765;75768
DNArchi;DNArchi;DNArchi vise à questionner la conception architecturale numérique en proposant des éléments théoriques et pratiques pour la connaître, la penser et l'assister.;398;256;221;127;1002
nathalieappere;Nathalie Appéré;Maire de #Rennes. Présidente de @metropolerennes.;7955;1882;23855;3083;36775
BabinetCharles;Babinet Charles;"Responsable #Reconquete #circo4904 ;
Candidat #Legislatives2022 ;
Adjoint de la Déléguée Départementale 49 ;
Membre du Conseil National R! #CNReconquête
ن";7800;128;315;2879;11122
LeBreto05734837;Le Breton;;31423;1482;1288;17058;51251
