Utilisateur_id;Utilisateur_name;Profile_bio;Tweets;Following;Followers;Likes;Score
lemondefr;Le Monde;"L'actualité de référence par la rédaction du Monde | Piloté par @hpagesy @gregorbrandy & @PBerhouet
Nos comptes Twitter associés : lemde.fr/3ApwJXb";445119;671;10646193;1701;11093684
JustinTrudeau;Justin Trudeau;Father, husband, @liberal_party Leader, 23rd Prime Minister of Canada. | Papa, mari, chef du @parti_liberal, 23e premier ministre du Canada.;44258;920;6459787;131;6505096
RFI;RFI;"Suivez toute l'actualité du monde et de l'Afrique en direct 24h/24h!➕@RFIAfrique @RFI_eco @RFIsports @RFI_FrFacile @RFIMusique @RFImag
✈️ Telegram : rfi.my/TGfr";402665;782;4340936;4312;4748695
BFMTV;BFMTV;Première sur l'info Retrouvez-nous sur Snapchat/Instagram ➡ bfmtv 🗳 S'informer, c'est choisir;721702;560;3982204;1718;4706184
afpfr;Agence France-Presse;Morceaux choisis des fils d'actu, coulisses & RT des 1.700 journalistes de l'AFP à travers le monde. Compte Officiel.;464057;1366;4089546;103;4555072
Le_Figaro;Le Figaro;La culture de la liberté depuis 1826;742407;559;3695410;6331;4444707
jeune_afrique;Jeune Afrique;Pour suivre toute l'info en #Afrique : un mensuel, un site web, des applis mobiles et des comptes Twitter. Pour l'actu #business, suivez @JA_Eco;121220;388;3803404;525;3925537
le_Parisien;Le Parisien;L’actualité qui vous concerne📱🗞️;541676;840;3261442;718;3804676
libe;Libération;"🔸 Bienvenue sur le Twitter de Libé
🔸 Abonnez-vous : bit.ly/3CiQ0ZB
🔸 Hors-série 50 ans : bit.ly/4394mK0";286976;301;3511649;2506;3801432
Mediapart;Mediapart;Journal d'information numérique, indépendant et participatif. Seuls nos lecteurs peuvent nous acheter ! Suivez aussi @MediapartBlogs. #FreeMortaza;154435;2012;3079375;4530;3240352
franceinfo;franceinfo;L'actualité en direct et en continu avec le média global du service public.;371971;1396;2342670;18037;2734074
antonioguterres;António Guterres;"Secretary-General of the @UN.

We will never, ever give up making this world better for everyone, everywhere.";4569;222;2120418;42;2125251
Afropages;Afropages;Afropages recense l’actualité africaine. Nous proposons une sélection de liens vers des sources d’informations rédigées par nos partenaires de référence.;2080999;629;15130;13;2096771
Europe1;Europe 1;"Europe 1, la radio qui vous informe et vous divertit au quotidien. En direct ou en #podcast. đźŽ§đźŚŤđź“»
đź“ž 01 80 20 39 21 (non surtaxĂ©)";438627;3628;1638289;10527;2091071
franceinter;France Inter;France Inter : InterVenez Fil officiel de France Inter, la radio publique généraliste de Radio France.;178501;4319;1834987;5403;2023210
maria_andy2;MARIA ANDY;GRANDE Fan d' ♥♥ Andy Murray ♥♥LIVERPOOL ,' ASSE, Celtic Football Club    , Borussia Dortmund  BARCA  Iga Swiatek;1475453;3263;6938;496053;1981707
LesEchos;Les Echos;L'actualité économique, financière et boursière française et internationale.;535488;511;1394108;338;1930445
titrespresse;Titrespresse.com;Les derniers titres de la presse en France, Suisse, Canada et Luxembourg, venant des principales sources d'informations.;1810221;649;3519;30;1814419
Algeria_Tweet;Algeria 🇩🇿 الجزائر;Information related to #Algeria #Algérie #الجزائر 🇩🇿 #تحيا_الجزائر. #خليك_فالدار;131959;58;1605727;4400;1742144
LEXPRESS;L'Express;"S'informer pour rĂ©ussir đź—ž

Retrouvez-nous sur â¤µď¸Ź
Facebook đź‘‰ bit.ly/FBLEX
Instagram đź‘‰ bit.ly/IGLEX
YouTube đź‘‰ bit.ly/YTLEX
LinkedIn đź‘‰ bit.ly/LKINLEX";231119;678;1472082;244;1704123
RTLFrance;RTL France;Information, coulisses, replays... Bienvenue sur le compte officiel de #RTL ! #RTLMatin #RTLMidi #RTLSoir ➡️ Suivez-nous également sur Instagram : rtl_france;392481;232;1156547;5883;1555143
TSAlgerie;TSA Algérie;Premier quotidien électronique algérien. Information en temps réel sur l'Algérie;97933;118;1357746;4;1455801
Limportant_fr;L'important;Le site l'Important sélectionne des tweets du monde entier pour en retenir...l'important. L'info par les réseaux sociaux.;1135029;2300;300514;13927;1451770
Algerie360;Algerie360;Actualité et Information sur l'Algérie et l'international en temps réel;139593;16;1293211;8;1432828
francediplo;France Diplomatieð«ð·ðªðº;MinistÃ¨re de l'Europeðªðº et des Affaires Ã©trangÃ¨res @gouvernementfr @francediplo_EN @francediplo_AR @francediplo_ES @francediplo_DE @francediplo_RU;44721;1605;1280846;9411;1336583
LePoint;Le Point;"Retrouvez nos informations exclusives et l’actualité en continu sur LePoint.fr. 
Abonnez-vous : 1€ le 1er mois 🗞 bit.ly/2OY6K5e";284031;1330;1028567;8197;1322125
lau68951920;lau;đąđââđ·đđ;673379;4994;3418;626309;1308100
nordsud6213;hel.b #ensemble #Macron 2017-2027 #renaissance;"#Ensemble @EmmanuelMacron, #Renaissance
les Bleus , les bleues, 
AVEC VOUS POUR NOUS TOUS
Soutien aux Forces De l'Ordre, militaires, pompiers.";601572;3738;7065;688970;1301345
YvesPDB;Yves Pozzo di Borgo;Sénateur (2004-2017) Conseiller Paris7e (1998-2020) ex-IGAENR ex-COE OSCE UIP ex-Af Commissions Européenne AE Défense ex-Administrateur Tour Eiffel (2001-2020);650758;32610;95542;465933;1244843
gouvernementFR;Gouvernement;Twitter du #Gouvernement français.;56005;87;1165399;16945;1238436
OuestFrance;Ouest-France;Bienvenue sur notre compte Twitter ! ðŸ¤— Retrouvez toute l'actu de l'Ouest, de la France et du monde aussi en newsletter ! ðŸ“© ðŸ‘‰ ouest-france.fr/newsletters;531847;3902;659397;4141;1199287
kinshasaweb;ð¨ð©âð¾Â« Papa avait dit le peuple dâabord Â»âð¾ð¨ð©;Twitter officiel de MuadiaMvita.Lungeni@outlook.com ..Mes tweets s'engagent vers l'Afrique & ...  I;854950;1777;25498;289073;1171298
LoudL;Louise de Lannoy;;1036810;3326;14124;92433;1146693
Nabyleu;LOUTAKH ? 馃馃嚫馃嚦馃挃;Sports et loisirs | SANT - MOUGN - MOYTOU - DOYLOU | 6/2 馃弳馃嚫馃嚦 YALLA PITI脡 99 | Madril猫ne 馃馃挏 Borom @ibraMiBusiness / Instagram.com/nabyleu_;513774;39104;293657;252900;1099435
lapin47;Angry_Bisounours #FreeAssange #64ansCestNon;Liberté Égalité Fraternité Laïcité Féminisme Écologie Altermondialisme Solidarité Justice République Démocratie Pacifisme;592088;13051;15283;457750;1078172
CGTNFrancais;CGTN Français;Compte officiel de CGTN Français;69707;206;980455;307;1050675
CanalOblik;CanalOblik φ🔻 🐝 #UnionPopulaire #JLM2022🐢;"Canal oblik est un réseau de diffusion d'information pour le Spectacle Vivant
Sur Mastodon : @Paulinoo2@mamot.fr";514785;5631;5148;466942;992506
LP_LaPresse;La Presse;Le site d'information francophone le plus complet en Amérique.;144851;196;833420;13;978480
AlgeriaHerald;الجزائر محروسة AlgérieInformations.com🇩🇿🇺🇸;#الجزائر_محروسة Collecting data on the #CancelAlgeria agenda and exposing the culprits to the world. AlgeriaHerald.com is owned by  @HeritageAlgeria;971307;197;6064;910;978478
2MInteractive;2M.ma;2M est une chaîne de télévision généraliste, marocaine du service public. Accessible via  le réseau numérique TNT, sur satellite et Internet.;46284;155;918932;1800;967171
RadioCanadaInfo;Radio-Canada Info;Nos articles, nos alertes de dernière heure et des tweets de nos journalistes, pour ne rien manquer de l'actualité.;271354;718;690117;188;962377
Pilotte_daniel;Daniel pilotte de la Barolliere ð¿ð®ð±ð·ðºð«ð·â¦ï¸;En cpl HÃ©tÃ©ro #TeamPatriotes #JambonBeurre #GouvernementdelaTromperie #UnionDesDroites #UnionDesPatriotes #Antimacronistes #GiletsJaunes #Frexit #Fdo âï¸ðâ£ï¸ð¦;518935;15473;14085;404724;953217
tvanouvelles;TVA nouvelles;À la télé, sur votre ordinateur ou votre appareil mobile, TVA Nouvelles est LA référence au Québec pour ne rien manquer de l'actualité. tvanouvelles.ca;404740;822;542384;200;948146
bouyguestelecom;Bouygues Telecom;Depuis 1996, chez Bouygues Telecom nous vous aidons à faire grandir les relations humaines. #OnEstFaitPourEtreEnsemble Découvrir nos métiers bytl.fr/Metiers;692391;69051;173737;9072;944251
7sur7_cd;7SUR7.CD;Le plus grand site d'infos en RD Congo. Site d’Infos générales: Sécuritaire, Politique, Économique, Sociale, Culturelle et Sportive. Infos fiables.;74812;140;832632;270;907854
RTBFinfo;RTBF info;Toute l'info de la RTBF. Des questions, commentaires, images, infos? Contactez notre compte interactif @NewsroomRTBF;459626;297;445437;173;905533
dtzb;derteilzeitberliner;Berlin-lover, Icelandophile, Danophile, Media, Politics, History, News, Languages, Travel, Freedom and Happiness :);240103;4991;3128;605827;854049
TotalEnergies;TotalEnergies;TotalEnergies is a multi-energy company that produces & markets energies on a global scale: oil & biofuels, natural gas & green gases, renewables & electricity.;14992;304;830228;5221;850745
jacksonmukunda;ð¨ð© Jack Pistol ð¨ð©;Part of the advocacy for Change in DRCâ¡ Entrepreneurâ¡ Catholicâ¡ @FCBarcelona Fanâ¡Hard-Hustling Husband and Father to Curtis, Tracey & Wendellâ¡ #RwandaIsKilling;457495;2832;86967;297501;844795
CuriousKd2000;Curious George;"Revue de presse lévogyre.
""Ici, tout le monde est fou. Je suis fou. Vous êtes folle."" (Le lapin blanc à Alice)";751944;1392;1592;87502;842430
jazzmanahn;Jazzmanahn;;412750;4961;2592;400317;820620
LCP;LCP;La Chaîne parlementaire - AN. TV d’infos politique et citoyenne. Canal TNT 13, LCP 100% . 📨 Newsletter : bit.ly/newsletterAN 🎬 Youtube : bit.ly/38qiW36;145779;2244;664413;1345;813781
radioexpressfm;Radio Expressfm;Radio généraliste à vocation économique. sur bande FM : Grand Tunis 103.6, Sfax 104 ou partout sur internet radioexpressfm.com/fr?prorad…;146635;245;657013;70;803963
LCI;LCI;Bienvenue sur LCI, #La26 sur la TNT. Le meilleur de l'info, de l'analyse, du décryptage et tous les grands événements en direct #RespectZone;166020;1021;619144;2289;788474
Banquemondiale;Banque mondiale;Compte officiel du Groupe de la Banque mondiale. Nous aidons les pays en développement à mettre fin à l'extrême pauvreté en favorisant une prospérité partagée.;37437;1160;738837;5367;782801
eric_patris;Eric Patris;"@EricP@mamot.fr

I me tu rispechjani i me upinioni parsunali 

Mes tw reflètent mes vues personnelles

Tantu chì Parigi cumanda, ùn si pò sperà nunda.";263194;4033;5069;492167;764463
CybelleKamba;cybelle Kamba Kabasu 🇨🇩;"#Epouse_Mère
#EntrepreneurSociale
#Ambassa100jeunespagedespoir

 🇨🇩❤️ #Économie_internationale #Politique #Tourisme ❤️😊 #Esprit_libre";215988;5103;196141;343072;760304
blackdekpe;OUABI Abdel Aziz;Pharmacist 👏🏾. Tech lover. nothing serious in here . 🏳️‍🌈 👻gossipboy97 ☎️61949891;449724;5177;31189;270420;756510
Mousttaphaa;๐๐๐๐๐๐๐๐๐;DU COULOIR DE LA MORT AU HAVRE DE PAIX !#LeMoustaphaรฏsme #ParadisDesAmes #HumainDeshumanisรฉ;39913;4591;58232;648633;751369
RLDI_Lamy;Dr. de l'immatériel;"Lionel Costes, 
Rédacteur en chef
Directeur de collection
Lamy Droit de l’Immatériel";364016;17915;17297;348002;747230
ActusPays;Lisa en direct đźŚŹ;"Ex JRI pr une web tv financiĂ¨re et pour les chaĂ®nes du Parlement.
Ma mission : informer sur l'actu. internationale et franĂ§aise.
Sur ts les sujets, sans tabou.";403653;7863;16038;303444;730998
PatrickNele;Patrick Nele ðªðºð«ð·ð©ðª;Breton , europÃ©en .ð;287729;3458;3447;435214;729848
pressecitron;Presse-citron;Connectez-vous Ă  l'innovation ! đźŤ‹;83309;485;637589;6446;727829
leJDD;Le JDD;Vous allez en entendre parler, le JDD vous informe en premier. Découvrez notre offre d'abonnement 100% numérique sans engagement ⬇;266228;874;456873;211;724186
eliot_meredith;eliot_meredith ✝️;Nous sommes le ciel bleu où les nuages passent sans laisser de trace. #Patriotes + Soutien aux ☦️,Fichiers Illégaux Macron Matricule Gal 844 Polit. 835 Classe 4;446381;3567;3289;261773;715010
StigmabaseF;Stigmabase | LANG;Français & Italiano  — Español  {Fighting stigma}  - A Canadian Non-Governmental & Nonprofit Initiative — Part of @stigmabase Team;702367;1057;1357;0;704781
sudouest;Sud Ouest;đź—žđź“± MĂ©dia rĂ©gional franĂ§ais;255708;1685;445449;1080;703922
hugoclement;Hugo Clément;#SurLeFront Contact pro : contacthc@winterprod.com;7319;1244;692471;1024;702058
Legislatozor;Legislator 0.1;Si tu ne sais pas pourquoi, Legislator lui sait pourquoi.;699901;6;180;0;700087
artere01;ð´ââ ï¸;J'dis pas QUI j'suis ni Ã  ma pute, ni sur Twitter. #229wÃ¨minð¥;130427;1605;1216;566452;699700
lalibrebe;La Libre;"đź“° L'actualitĂ© en Belgique et dans le Monde, les news environnementales, les nouveautĂ©s Ă©conomiques et culturelles.
đź“Ł Faisons vivre l'info I @LaLibreEco";420908;2780;275016;247;698951
dc_morel;Chantal morel ­čç▓­čçź ­čç║­čçŽ ­čç¬­čç║;#La├»cit├ę #R├ępublique #Universalisme #F├ęminisme #Democrate #ecolo (avant j'├ętais de gauche, mais ├ža c'├ętait avant NUPES);69130;1048;8462;607331;685971
JTAtv5monde;Le journal Afrique TV5MONDE;Suivez toute l'actualité en #Afrique chaque soir à 20h30 TU en direct sur notre page #Facebook par la rédaction de #TV5MONDE;23920;309;654502;279;679010
TICKETmaghaiti;TICKET MAGAZINE;Retrouvez tous les textes de Ticket sur lenouvelliste.com !;37853;401;639712;97;678063
APS_Algerie;ALGÉRIE PRESSE SERVICE | وكالة الأنباء الجزائرية;"Actualité nationale, sport, économie et internationale. 
L' #APS assure différents services multimédia, en plus de sa présence sur les réseaux sociaux.";60416;160;613189;8;673773
dzonline;dzonline - Algérie - الجزائر - ⴷⵣⴰⵢⴻⵔ;Toute l'actu en relation avec l'#Algérie ! All news about #Algeria . أخبار الجزائر . ⵉⵏⵖⵎⵉⵙⵏ ⵏ ⴷⵣⴰⵢⴻⵔ;188733;1226;471816;6845;668620
Tian_A1;Tian_A1;Expatriate french gay - Observer specialized in analysis of international web media - Veritas vos liberabit;626433;894;1845;25690;654862
franceinfoplus;franceinfo plus;Enquêtes, décryptages et infographies... Toutes les clés pour comprendre l'actualité. Pour l'info en direct, rendez-vous sur @franceinfo.;234478;696;417968;1284;654426
ladh;DH les Sports +;Compte Officiel DH les Sports + - Toute l'actualité belge, internationale et sportive, c'est sur le site web de la DH !;510916;210;142078;141;653345
JeanVal26536332;Jean Jeanval;"Suivi par @NicolasReviens
(Gouvernement d'Action)";379293;2050;2005;262950;646298
jeancayeux;Jean ðð¾ CAYEUX IT ð«ð·;Transformation numÃ©rique #transfonum :  cybersÃ©curitÃ©, dÃ©matÃ©rialisation, prÃ©sence numÃ©rique, formation, assistance info, veille. #Humaine #Aristote #Science;181258;10470;12976;427683;632387
EbenYaakov;Eben Yaakov Feld & pas de ce monde;"Le monde est dangereux à vivre ! Non pas tant à cause de ceux qui font le mal, mais à cause de ceux qui regardent et laissent faire...
A.Einstein. Pas de MP svp";319402;4410;3204;303635;630651
GREUBELINUX;GREUBE HUMAINE;affilié a  Amnesty International tweets sont les miens  #UnionPopulaire #FranceInsoumise @geenpeacefr @amnestyfrance @chainedelespoir @ldh_Fr @Solidarites_Int;488712;2655;1358;134966;627691
MarianneleMag;Marianne;"Hebdomadaire en kiosque le jeudi | ""Le goût de la vérité n'empêche pas de prendre parti"" – Albert Camus";106471;855;517613;1320;626259
netguide;Netguide;Nourrir ses centres d'intérêt, cultiver sa curiosité, contrôler son infos. Découvrez notre plateforme sur Netguide.com;607737;1;3086;0;610824
JdeMontreal;Le Journal de Montréal;Des nouvelles accessibles et complètes : sports, politique, spectacles, argent et judiciaire. Soyez toujours bien informé avec Le Journal de Montréal.;305215;907;300297;109;606528
PiNetworkFrance;Pi Network France đź‡«đź‡·;"CommunautĂ© officielle de #PiNetwork en France đź‡«đź‡·
Minez les crypto-monnaies directement Ă  partir de votre smartphone.";569987;1;24105;1;594094
twist1961;Viviane Godenne ð;Anticonformiste ,Ã©clectique,passion animaux & boomer mais riche de mes expÃ©riences ,je clos ici le livre Â« les couleurs de ma vie Â»....!;331642;1848;1676;257277;592443
tetsu0724d;TETSU Ⅱ;"〜精一杯を君たちに〜
二代目🇯🇵
変わらない今も 感謝  
I'll do what I can in order.
Don't follow, please.
Block if u don't like.
🐭変わらず🐻人生いろいろ 細かいことは良し 待ってます 🐭🐱以外の♪はスルーw◆◇◆◇◆";476025;11;0;112673;588709
MarieAnne_086;Marie-Anne;"“Aimer est, dans son essence, le projet de se faire aimer.”Sartre “Les parfums, les couleurs et les sons se répondent.”Baudelaire  
 --Professeure - retraitée";332428;2227;1620;249863;586138
gilleskheops;Gilles DEGUNTOVIC ⭐🇫🇷;l'OM coulera dans mes veines jusqu’à mon dernier souffle  Marsello identitaire 🇫🇮 Μασσαλία supporter et historien de OM 💙 #TeamOM  ancien  @VGCU84 😉👍👏⚽;155275;6866;10441;412450;585032
RMCInfo;RMC;"ð»ðºð² Info-Talk-Sport / Radio-TV-Digital  |  
â°ðð¥ Nos Ã©missions: #CharlesMatin #ApollineMatin #MatinaleWERMC #FaceAFace #GGRMC #EstelleMidi @rmcsport";249087;1278;328339;4019;582723
laprovence;La Provence;Toute l'actualité du quotidien La Provence : région, sports, OM, France, économie, politique, spectacles, ...;279066;362;298651;2165;580244
EUwatchers;EUwatchers;"Everything #Europe in one place monitoring European Information
EUwatch.bsky.social
RT progressive civil society
Unaffiliated not Apolitical
 🇪🇺 🏳️‍🌈 🇺🇦";536058;7843;25596;8552;578049
ZOREIL1945;ZOREIL;Il n'est pas bon d'être malheureux, mais il est bon de l'avoir été.  Depuis 1962, le jour de mon anni, pensée aux victimes de la tuerie d'Oran.;360492;4398;3424;208650;576964
publicsenat;Public Sénat;La chaîne politique et parlementaire. TNT canal 13, et 24/24 sur publicsenat.fr Aussi sur Facebook, Instagram et Linkedin;153208;484;419270;3599;576561
DDDamiennn;DDDamiennn;"39 ans.
Esthète et réservé.
Professeur d'Italien par le passé.
Cœur à prendre.
Respect, justice et liberté.
Suivi par de nombreux VIP.
Qui m'aime me suive...";238381;930;3615;331185;574111
Le360fr;Le360;"Le média du #Maroc 🇲🇦 
le360.ma  | AR @le360ar | Sport @le360sport | Afrique @le360_Afrique";145935;3;426494;163;572595
ONU_fr;Nations Unies (ONU);"Compte officiel des Nations Unies. 
Paix, dignité et égalité sur une planète saine.";35050;1374;532908;1457;570789
Senat;Sénat;"Compte officiel du Sénat français.

👥 facebook.com/senat.fr
🌐 linkedin.com/company/senat 
📸 instagram.com/senat_fr

La newsletter :
✍ xn--sn-bja.at/C8cWym";50029;2379;509013;1600;563021
LeDevoir;Le Devoir;Toute notre couverture de l'actualité, pour vous.;177305;721;382141;519;560686
newsafricanow;Newsafricanow;News|Events|Happenings|Rumours & More Across Africa +2348023229520 For Further Info!;556124;1647;1474;353;559598
RDelinfo;Robot De l'Info;"Nono est un robot de l'info en temps réel.
C'est le compagnon idéal de l'actualité en continue";557850;13;549;9;558421
Charlie_Hebdo_;Charlie Hebdo;"Charlie Hebdo | Journal satirique, laïque, politique et joyeux !
Nos dernières publications 👉 lesechappes.com";12915;326;542166;534;555941
jleonidasbrr;s o u l j a h ⚽️ 🐓;Trust Nobody Except God | Amoureux de l’@OL | #SorareOptimist | Cairo 🇪🇬 | #CryptoOptimist;474414;1294;12094;63911;551713
Snip6974;Le Tech Lead marié 🤵 💜;"Haut-savoyard.
Photographe amateur.
Consultant IT chez nos amis suisses.
Geek à mes heures perdues.
piaille.fr/@snip69
Mastodon @snip69@piaille.fr";52536;1177;1243;496584;551540
ProfToujours;Christophe Chartreux سلام;"« Apprendre avec la tête, avec le cœur et avec les mains » - JH Pestalozzi 
Chevalier des Palmes Académiques - Le Maroc au coeur - PS - Libertin littéraire";472540;12976;14205;49457;549178
JeanLillier;Lillier Jean Claude;Ingénieur Air France retraité;191220;2990;1363;350133;545706
JackdEliz;Jacques M. đđŸ #Reconquete #Circo3502;J'ai voulu changer la vie, la vie m'a changĂ©. Alors j'ai changĂ© de vie. Avant d'ĂȘtre de droite, j'ai Ă©tĂ© de gauche : guĂ©rison dĂ©finitive. Je bloque dĂšs insulte.;230837;4034;8127;302504;545502
peaceandlau;Lauren Lolo Knowles ✊🏿✌🏿;Journaliste Histoire/politique, étudiante en #ESS, co-fondatrice @citedeschances (#empowerment #politique des jeunes de banlieues) et élue locale à Fosses (95);226320;824;14204;299148;540496
KaplanBen_Fr;Kâplan;° Enseignement Supérieur & Recherche ° Sciences ° Politique & Culture(s) ° Anti-communautarisme ° Démocratie Directe ° Free speech makes free people °;188781;4316;11507;334251;538855
mapyntonga;Marie-Pierre Medouga;Consultante #Stratégie #Transition #RP #COM chez @AEcodem & M P & C - Enseigne chez Mediaschool Reims, Efficom & @UniversiteCergy - Ex Pdte @RiviereSauvage;266561;8038;9148;253027;536774
tonicesteve;Toni C.;Me gusta viajar, practico submarinismo y observo con expectación las bondades y las miserias de la sociedad y la política actual;376389;3775;3968;149129;533261
YukiNek56432140;Yuki ☮️ À jour de tous les vaccins obligatoires;"J'ai trop le désir qu'on respecte ma LIBERTÉ pour ne pas respecter celle des autres. Sagan    
LaRem s'abstenir. No MP.";219137;2218;4588;305247;531190
rkivehirai;ًnini is seeing twice 💜;are you shy I wonder why 🇩🇿🇵🇸;315683;997;1502;210786;528968
PierreABISAAB;Pierre Abi-Saab;"almayadeen.net
Guetteur mélancolique - متربّص كئيب
QUI DONC INVENTERA LE DÉSESPOIR";213187;21335;143996;142333;520851
MichelGuenette3;Michel Guenette;;508327;4111;5708;706;518852
alain_co;AlainCo #JeSuisPrometheen;LENR-Forum tech-watcher. Disruptive tech:#LENR,#EmDrive...  I don't endorse all, do due diligence!#JeSuisPrometheen #Promethean;425426;567;2732;90084;518809
Jn_Bllt;Jane-O. φ agent classe 3 🍒🌿🐝🔻🐢 #NUPES;"« L’omission est la forme la plus efficace du mensonge. »
 (George Orwell)

Socio
@Diesel@mamot.fr";260451;8595;9004;233658;511708
Ahabounette;Ahabounetteð¿;"""Que l'annÃ©e recommence et que l'annÃ©e finisse
 Sans que jamais le peuple ne touche aux bÃ©nÃ©fices."" Â©Fakir";228260;2838;3003;274346;508447
PierreChTux;Pierre Chevalier;"Animal bipède à pouces antérieurs opposés,
Bricoleur plénipotentiaire Libre,
GNU/Linux Debian^WDevuan,
Géologue,
Explorateur minier,
Saharien,
Orpailleur,
Etc.";42572;5003;4026;448948;500549
diogene2607;diogene2607;A l'origine, l'homme n'était pas un animal sauvage... ▶️🐘@diogene2607;391497;5388;10501;92389;499775
MAP_Information;Agence MAP;Fondée en 1959, la MAP est l’agence nationale marocaine de presse. Elle compte plus de 300 journalistes et correspondants au Maroc et à travers le monde.;59725;151;438809;124;498809
CitaroCapacityL;Arsène - #FJW - GIEC libre;"J'ai commencé ma vie avec 2 grands avantages: pas d'argent et de bons parents Mag#Thatcher
Libéral DDHC1789 | Pro nuke ☢ | AntiMal  | LHumainDAbord";294864;4423;8949;189856;498092
daniele_favari;Favari Danièle (poil à gratter);Ecrivaine engagée, Lançeuse d'alerte loi Waserman, RIC, Changeons la Constitution, virons Macron.;205595;1926;2750;287679;497950
as_49191;A.S;"ð¨âð»Communication numÃ©rique | Mes photos Ã  dÃ©couvrir sur mon compte Instagram â¤µï¸
instagram.com/aureliiensamsoâ¦";155887;1508;1832;337152;496379
greenpeacefr;Greenpeace France;Greenpeace agit partout dans le monde pour protéger l’environnement, le climat, la biodiversité et promouvoir la paix.;35511;803;444963;14264;495541
feedpushr;Feedpushr feeds.;Some feeds pushed by Feedpushr.;495071;0;240;0;495311
JdeQuebec;Le Journal de Québec;Des nouvelles accessibles et complètes: sports, politique, spectacles, argent et judiciaire. Soyez toujours bien informé avec Le Journal de Québec.;263117;1861;227343;114;492435
GsTsion;Tsion ðªð¹ð«ð·;;223540;2000;8229;258550;492319
Maleeek;Maleek ð¢64ans c'est toujours Non.;La haine est le signe d'un mal-Ãªtre. L'humain et l'environnement avant l'argent. L'Ã©cologie est ma seconde nature. Fin du mois, fin du monde mÃªme combat. ð¢âï¸;211276;6282;5716;266194;489468
AssembleeNat;Assemblée nationale;"Le compte officiel de l'Assemblée nationale 
#DirectAN";25187;637;462869;0;488693
lautreamont13;Michel Saint-Hilaire;"Freethinker. I is another. Arthur Rimbaud . Sweden
No DM";85900;5000;3872;391288;486060
CarineM605;Carine M đ«đ·;"đ©đŒâđ» IndĂ©pendante, mariĂ©e, maman, de #droite #NouvelleEnergie #Liberte ""Du fanatisme Ă  la barbarie, il n'y a qu'un pas."" Denis Diderot (1745)";172594;1657;2821;307222;484294
sudinfo_be;Sudinfo.be;Sudinfo - A chaque instant au premier rang;383659;1548;90302;427;475936
ChristianDomine;Christian Dominé;Président @JPA_nationale;246022;5001;3809;221086;475918
MauriceMartin01;Maurice Martin ♦️;Chef d’entreprise. Immobilier Professionnel j’ai initié le♦️comme signe de la tolérance,de la fraternité,de la non violence;196201;20401;21836;236567;475005
babibelle33;babibel sur GETTR: @babibelle33;"Je like pr remercier pour info donnée, pas forcément parcequ'elle me plait
Si censuré pseudos sur
Parler: @Babibelle3i
gab: @babibelle33
Telegram: @babibelle33";239227;1023;3072;225516;468838
bfmbusiness;BFM Business;Première chaîne d’information économique et financière de France.;168326;1567;297332;1113;468338
BaixSegura_es;djyne de la Costa España 🕊️🕊️🕊️;L'exil est l'état d'une personne qui a quitté sa patrie — volontairement et/ou sous la contrainte — et qui vit dans un pays étranger ici ou ailleurs  🕊️🕊️🕊️;391408;1410;1386;73525;467729
PhilippeBodin2;Philippe BODIN;"Ex LR et ex Force Rép. suivi par: B.Retailleau,A.Houpert,N.Morano,V.Boyer,L.Trochu,W.Thay,G.Platret,É.Ciotti,B.Cauchy,A.Bercoff.
Adhérent Pionnier RECONQUETE !";171059;7013;6900;281753;466725
SeveZubiri;Seve Zubiri;20+ años por el mundo de la cooperación al desarrollo, género, derechos humanos, educación, multiculturalidad, educación mundo maya y la soberanía alimentaria;298501;12049;10976;141294;462820
AminaJMohammed;Amina J Mohammed;Deputy Secretary-General of the @UN Amina J Mohammed. Committed to the #SDGs and building a better world for all.;7486;1058;449499;3763;461806
ledauphine;Le Dauphiné Libéré #dauphinelibere;Le Quotidien régional de l'Isère, de la Savoie, de la Haute-Savoie, de la Drôme, de l'Ardèche, de l'Ain, des Hautes-Alpes, du Vaucluse et de Haute Provence;357060;226;100422;154;457862
martine_dub3;Martine Dubé;Retraitée, domaine financier;158143;431;494;297775;456843
PSGInna;Michaël;Même les ténèbres doivent passer. Un jour nouveau viendra... piped.video/watch?v=TcXQNS…;442433;3235;3228;7090;455986
ardadeuxiem;☮ 𝘼𝙧𝙙𝙖 · 🇬🇬;"j'aime la vie., sciences politiques ; histoire ; actualité ; sport. 
le débat est essentiel pour comprendre. 
#démocrate #européen #socdem #kémaliste";134389;4981;1500;314779;455649
ggomez_chef;Guillaume Gomez;Meilleur Ouvrier de France Président d’Honneur des Cuisiniers de la République et d'Euro-Toques France #compteperso;43017;2374;239051;170660;455102
tdgch;Tribune de Genève;Compte officiel de la Tribune de Genève. Toute l'actu #Genève, #Suisse, #Monde, #Economie, #Sports et #Culture. Sur Facebook: Facebook.com/tdg.ch;345075;457;109318;167;455017
Nice_Matin;Nice-Matin;đź—ž1er Groupe mĂ©dia de la CĂ´te dâ€™Azur đź‘‰đźŹ»Raconter: ce quâ€™il sâ€™y passe, ceux qui y vivent et la font avancer, ce qui comptera demain.;206167;1020;243984;543;451714
Seaotter369;Eelco;Dutch ๐ณ๐ฑ Free Speech for everyone - Living on ืึฐืึนืึธื Flat Earth - Geneva Bible & KJV APO - Enoch - ืืช Cepher - Deut 32:4-5 ๐ RhD (-) NEG โตฃ Am not a ๐ฆ or ๐ฝ;162659;10016;9266;268401;450342
LehmannDrC;Christian Lehmann;"Romancier, médecin, rôliste, GNiste, geek-vintage. Journal de Pandémie dans @Libe. Auteur de la trilogie ""No Pasaran"".   
Fuck around? Find out.";291054;553;38388;120286;450281
jeromegodefroy;Jérôme Godefroy;Ancien speaker à la TSF, né sous Vincent Auriol. Journaliste depuis 1978. Boomer perplexe.;269178;4890;50733;125312;450113
Sigaud3;Sigaud JP ð«ð·;"IngÃ©nieur mÃ©tÃ©o retraitÃ©, climatologue. IHEDN. 
Soutien aux mÃ©decins qui ont soignÃ©, et aux suspendus. #Peronne #Montagnier #Wonner #HenrionCaude #Raoult";192929;3892;5691;247187;449699
ChouchouMpacko;Chouchou Mpacko 🇨🇲;"Public Worker .
What I don't know,I will open a book or Ask.
SDGs Community Ambassador
DigCit SDGs Awards Winner.
Certified Sustainable Tourist
RT≠Endorsement";341445;2483;61957;39582;445467
SeteFrance;Sete France #BDS et #soutienAdrienQuatennens;Les fafs et les sionistes (qui souvent êtes les mêmes), gardez vos distances!! Je ne vais pas vous l'envelopper avec du bolduc et du papier fleuri!;305164;4504;2960;132828;445456
c_vollaire;Catherine Vollaire;Enfant de la PQR, team SR. Profile pic : Mads Berg;93270;1011;5328;344753;444362
tr_vink;đ ÙÙŰ”ÙŰ±;mi palois, mi niĂ§ois, mi parisien, mi molette;105612;2665;2646;333182;444105
intwittoveritas;Rosa Rosam;"đčChargĂ©e de Mission Culture. Paris. ""Castigat ridendo mores"" (cherche dans le Gaffiot !)";183886;2064;31668;226314;443932
PatWhite70;patwhite70;"Citoyen - Professeur journalisme @JournalismeUQAM Fondateur @HuffPostQuebec. Ex @Reuters @pressecan @CTVNews @Canoe @JdeQuebec; DG @patwhitecom @projetJ";302438;46006;41822;51754;442020
petimiti;Christian B;Mélomane/collectionneur de blues, voyageur, physicien (directeur de recherches émérite au CNRS) No DM #VIGILANCE #Résistances #StopFachos @petimiti@mastodon.top;254366;4410;15963;164851;439590
goodbye17171717;Pat Laroche;Seul ami de Franky et JF.;91135;3362;6964;332922;434383
BuenoxedKid;Quentin;;26750;205;249;400574;427778
feva88;Feva #WeAreAllAssange#Marin;;225449;647;348;201019;427463
6livier;Lucas 6livier đąâïž;PĂšre, pardonne-leur pas, car ils savent ce qu'ils font;29643;3334;2202;391558;426737
JosepBorrellF;Josep Borrell Fontelles;High Representative of the EU for Foreign Affairs and Security Policy/Vice-President of @eu_commission #EUdiplomacy @eu_eeas My blog: europa.eu/!yx86UC;7178;222;414522;2966;424888
chrislaine33;LAINE christiane#Renaissance đ¶âđ;"#SoutienMacron2022 #Renaissance - #Ensemble 
Â« Ăvitez les gens nĂ©gatifs, ils ont toujours un problĂšme pour chaque solution. Â» Albert Einstein";253697;1890;7666;159765;423018
lonewolfs70;Laurent Procureur bénévole 🧹φ🐢;Le châtiment de ceux qui refusent de s'occuper des affaires publiques est que les affaires publiques tombent entre les mains de moins vertueux qu'eux. Platon;163834;2534;4315;251455;422138
MYOS4;MYOS;History, politics, TV, US, UK, France/ Politique, séries télé, Etats-Unis, GB;163872;1923;746;254897;421438
fabienprevots;Fabien Prévots;fabiome.com #influenceur Apporteur d'affaires #Finance #Biotech Coach #Formateur #socialmedia #web2.0  #Top10 with the Highest Impact on #Cloud (Ranking: 4th);341737;35009;37642;1183;415571
cesar92803973;Rato;đ MVP 2022 twitch.tv/ratoboi31;5393;705;136;405993;412227
avril_sylvie;Frexit_2017;Plus une société s’éloigne de la vérité, plus elle hait ceux qui la disent.;369582;5013;4680;27669;406944
francoislegault;François Legault;Premier ministre du Québec;30231;205;373459;2389;406284
LaTribune;La Tribune;"Journal économique et financier - Economie, Entreprises & Finance, Tech, Idées : latribune.fr
Découvrez notre nouveau quotidien numérique: kiosque.latribune.fr";141405;908;260144;2206;404663
lautard65;lautardcorinne;compte de secours lautard7;302152;1745;2804;92188;398889
Malijetactu;Malijet;Site d'information et d'actualité sur le Mali;153704;479;243568;1000;398751
24sante_fr;24H Culte;Retrouvez toute l'actualité sur cultinfos.com : la #recherche, #stars,#people...;396562;692;872;27;398153
lpovert;Lionel Povert đ alias ThĂ©ophile PĂ©trichor;Curiosity killed the cat. But so far I'm still alive, my curiosity keeps me going. La curiositĂ© a tuĂ© le chat!  Ma curiositĂ© me maintient vivant, en mouvement.;203761;5003;1581;187808;398153
DiogenedArc;Philippe Poigeaud 🇺🇦;"Auteur euro-américain tendance latino 🇫🇷🇧🇷🇪🇺

𝑶𝒎𝒏𝒆 𝒔𝒐𝒍𝒖𝒎 𝒇𝒐𝒓𝒕𝒊 𝒑𝒂𝒕𝒓𝒊𝒂";338490;7214;10758;41036;397498
AurelieCoudouel;Aurélie Coudouel;#CM attachiante & à l'affût. Respire/Mange/Aime #Veille #SocialMedia #SocialTV #eReputation #eMarketing. Twitteuse compulsive droguée aux #TVShows.#SeriesAddict;354246;514;11069;28851;394680
BarbaTruc20;BarbaTruc đđșđŠđ;"Je dis ce que je pense selon mes diffĂ©rentes sources d'informations. Je milite pour sauver la vie des gens fragiles. 
Je crois au QuĂ©bec ouvert sur la diversitĂ©";90088;1705;2443;299157;393393
kakese_leon;Leon KAKESE;Chercheur en Sciences politiques et Administratives PhD || Coach Sentimental Senior;110365;8755;183956;89393;392469
jamesinparis;James Dunne;Citizen. Whistleblower. Former Technical Doc Mgr, Qosmos. Fired for saying no to Mass Surveillance tech for Assad. Privacy is a human right. War is terror.;240913;977;2464;147147;391501
arnaud_thurudev;Arnaud@Thurudev;"Hibou du Web, je veille... Et je partage ma veille
Parfois ça prête à rire, parfois, ça donne à réfléchir";355923;10875;19273;1753;387824
Armees_Gouv;Ministère des Armées 🇫🇷;Compte officiel du ministère des Armées;37442;664;324981;22031;385118
Sandra_Congress;Sandra nommée ChoupiQueen (parfois pas choupi);"💉x5😃 
Grâce à plein de twittos, j'apprends bcp
On se marre aussi!
Nommée ChoupiQueen 😍
Bref, je twte  surtout du Choupi";87319;708;1971;294152;384150
Stock_Market_Pr;Stock Market News;Stock Market News and Press Releases. #StockMarket & #Crypto;351891;58;30043;41;382033
blaisengo;b1@153;Mes đ§đ§, đšđ© ultracrepidarian;241441;2194;8134;129428;381197
Zehub;Hubert MESSMER 🏃🏻‍♂️🧘‍♂️ 🎶;Veilleur DDurable - Alsacien Européen curieux de tout, en particulier #ChangementClimatique #Enr #Bio #Biodiversité #Climat #VEILLE #GIEC;344287;837;7296;26294;378714
LaurentAlfonso;Laurent ALFONSO;"European Affairs Officer, Civil Protection
 🇪🇺🇫🇷@SecCivileFrance 
&
Union for the Mediterranean 🌿
Civil Protection Expert 
@UFMSecretariat";27159;5953;7286;337869;378267
AMARIEBL;AMB;;216905;3343;1821;154917;376986
Ad_Vitam44_;🇫🇷 ✞✟† 🅰️d Vitam 🐓🪢🇫🇷;#SolidaritéPatriotique #HumourSarcastique 🤜🏻💙🤍❤️⚔️🛡️🇫🇷la vraie loyauté prends des années à se construire,et seulement quelques secondes à être détruite.;108147;24050;25089;218720;376006
lavenir_net;lavenir.net;"Le meilleur site belge sur l'actu régionale / The best Belgian website for regional news. 
Pour le sport, suivez-nous sur @lavenir_sport";298310;114;75933;1550;375907
Rev_de_Presse;Jean Rev;""" Telle est la vie des hommes. Quelques joies, très vite effacées par d'inoubliables chagrins. Il n'est pas nécessaire de le dire aux enfants. "" Marcel Pagnol";332890;6688;9871;21554;371003
ras_le_foulard;Krikata Saut Mouton đ;"Sologamy Squad âš | đđżđđŸđđŒ Â© I 
JE SUIS UNE FEMME đ­

ApprĂ©ciĂ©e pour divertir et non pour revendiquer đïž

AfrorĂ©aliste | J'aime la Bagarre";100228;2707;2450;265036;370421
Horystar_;Howorystar;Pick-up line enthusiast;29482;1090;396;337725;368693
Weezyinho;Wilson🦉;#TeamPSG 🗼#SacramentoProud #FreeYoungThug 🐍 #RIPTakeoff 🥀;292096;879;2011;71041;366027
claran55;SoBeau ðªðºðºð¦ð«ð·;"Humaniste, athÃ©e, pro-UE.
#niFNniFI car ce serait la FIN.";49215;754;1593;313703;365265
EagisCorp;Anthony ( 本当に) Vajda 🪷🐱🕊️🇺🇳🗾7️⃣8️⃣;otaku,poly-handicapé ancien enfant-soldat ex-traumatisé sexuel , quarteron hongro-malgache, matheux, double master math info cryptologie data analyst;268628;1981;382;93921;364912
Challenges;Challenges;Toute l'actualité de l'économie, de la finance et de l'entreprise 💰 Chaque jeudi en kiosque 🗞 Facebook - Linkedin - Instagram: @Challenges;117001;610;244683;2106;364400
rozlbrahim;인생은 계속됩니다;;78468;3095;1012;278201;360776
quaibranly;musée du quai Branly - Jacques Chirac;Arts et Civilisations d'Afrique, d'Asie, d'Océanie et des Amériques /#OuvrirLAlbumDuMonde #ExpoSonglines et #SenghorEtLesArts #AnneEisner;26581;2207;309642;21493;359923
mtwit75;Enzo Morel;Journaliste puisque n'importe qui se dit journaliste;32754;3045;12402;311561;359762
GaveEmmanuelle;Emmanuelle Gave;"Mère.Lauréate du Barreau de Paris.
DEA Droit des Affaires- (Paris II) 
LL.M Duke University.
Institut des Libertés.";15994;13015;60987;268714;358710
jss7581;jss7581;Le politiquement correct est la langue de gens qui tremblent à l'idée de ce qui pourrait arriver s'ils arrêtaient de se mentir (Pierre MANENT);37533;635;871;317662;356701
burkina24;Burkina 24;L'actualité du Burkina Faso et de l'Afrique 24h/24;72922;19;281223;1236;355400
Patrice4020;Patrice Lempereur;Conseiller Communal à Ans - Président de la Société de Logements du Plateau;156394;5000;3411;189685;354490
AniceLajnef;Anice Lajnef;"Pour une économie équitable et responsable.
Pro business, anti endettement.
Pour une monnaie au service de l'économie réelle.
Telegram: t.me/Lajnef";48285;246;129508;176445;354484
FourageBernard;đź‡«đź‡· Bernard Fourage đź‡«đź‡·;đź‡«đź‡· Nantes #Jesuispatriote đź‡«đź‡· Suivi par Guillaume Bigot, Jean Messiha, Christine Kellyâ€¦;158806;8673;8767;178119;354365
vast_victor;Vast Victor 🇫🇷🇨🇭;"Les grands pays le sont
pour l'avoir voulu.

Charles de Gaulle

#Telegram t.me/Vast_Victor";111842;5108;4643;231195;352788
LalobaRose;ð¹RositaBanana;NÃ©e Ã  l'HÃ´tel Dieu par l'opÃ©ration du St Esprit... Je suis nÃ©e sans le demander, je vais mourir sans le vouloir, alors laissez moi vivre Ã  ma guise.;214111;1289;16571;120601;352572
Angel_Tango;Roseline Robertson;"""La France est un paradis peuplé de gens
qui pensent vivre en enfer""
(Sylvain Tesson)
""Mourir pour que d'autres puissent vivre libres""
 (Carine Roussel - #8mai)";29915;1377;1452;318875;351619
KZaaaH;KZaH;"La haine est plus bizarre que tu ne le penses ; sa conduite est inexplicable, comme l’apparence brisée d’un bâton enfoncé dans l’eau.";135009;2636;1490;209786;348921
ellb78;ELLB78;Souverainiste Patriote Je veux retrouver ma France d avant Juriste justice loyauté;94319;812;1051;252445;348627
sputnik_afrique;;@sputnik_afrique's account has been withheld in Portugal, Finland, Sweden, Ireland, Slovenia, Czech Republic, Poland, Slovakia, Hungary, Italy, Malta, Germany, Greece, Romania, Netherlands, Bulgaria, Austria, Luxembourg, Latvia, United Kingdom, Denmark, Lithuania, Croatia, Estonia, Cyprus, France, Spain, Belgium in response to a legal demand. support.twitter.com/articles….;254026;219;94192;4;348441
ChanPerco;Jonathan Chan ð¡ð£;"Relayeur Actu Digitale & #marketing. 
CrÃ©ateur de contenu B2B Ã  @LaBrigadeDuWeb | #MBAMCI 13 | #StartUps #SocialMedia | Mes tweets engagent la Terre entiÃ¨re";251372;3225;57980;35379;347956
JBVBIN3T;Jean Babinet #noGreenwashing đđđđ;"Ăcologie raisonnĂ©e
Membre Voix du NuclĂ©aire.
Expert  Solaire & Chauffage ,
RĂ©novation Ă©nergĂ©tique,
SupaĂ©ro 1985
DĂ©croissant assumĂ©";94741;1245;2798;248207;346991
JuliaCerisi;Julia Cerisi;"#Liberté
#NonAuVaccinObligatoire
#AntiPassSanitaire
#NonAuPassDeLaHonte
Messagerie privée : je n'arrive pas  à répondre à tous. Veuillez m'en excuser.";144239;5680;9445;186262;345626
MaximeBernier;Maxime Bernier;Chef du @ppopulaireca / Leader of the @peoplespca;38514;8361;244524;54191;345590
_2019_nCoV;-_ 2019_nCoV_-;"đź‡®đź‡ąÂ« On ne voit bien quâ€™avec le cĹ“ur. Lâ€™essentiel est invisible pour les yeux Â»
-Ce compte n'existe que parce que vous lui donnez la possibilitĂ© de s'exprimer.";96169;8630;22084;218542;345425
pierrecappelli;Pierre Cappelli đ;"J'accompagne votre transfo numĂ©rique et votre croissance digitale
/ex @Inria_Lille #TransfoNum #innovation #mĂ©tavers #web3 #influence/Tour du monde en cours";165402;13163;39715;127068;345348
Samirsane2;samir elbordelico⚖️🇸🇳⭐️🇵🇹;business Lawyer ⚖️ #muslim 🙏🏾❤️🕋#géopolitique# football# réal Madrid KB9 # social# Xam Sa Wareef# 🙌🏽🤌🏽;3819;4711;2457;334222;345209
JeanYvesCAPO;Jean-Yves CAPO;"Entrepreneur -
Esprit libre sur tous sujets - Profondément 🇫🇷 
Compte Telegram au cas où : t.me/JeanYvesCAPO";108175;1495;14726;220651;345047
leralpointnet;leralpointnet;S'informer en temps réel;239666;1261;98057;487;339471
LitsaniChoukran;Litsani Choukran;MEDIA & TECHNOLOGY ENTREPRENEUR. Senior Consultant in Com/Media/Digital/Strategies. Author, Designer, Developper, Film Maker, Columnist & Founder of @politicocd;75923;401;228362;34187;338873
CRTV_web;CRTVweb;Official  Account - News and Corporate Cameroon Radio Télévision. Opérateur du service public de l'audiovisuel au Cameroun. Compte Officiel. Actu & Corporate.;44334;2610;289124;2327;338395
LN356;Hélène;French, passion for Alexander the Great, Greek and Roman antiquity. Practise of old master copy painting. #teamGrecs;234223;2310;1774;98637;336944
Mona87284429;LolaFreedomð¥ð¥ð¥;C'est nous les gentils;183103;2079;1121;149485;335788
Sciences_Avenir;Sciences et Avenir;ð¨ðð De l'infiniment petit Ã  l'infiniment grand et du Big Bang aux gÃ©nÃ©rations futures, le meilleur de l'actu scientifique;62747;254;270518;888;334407
TF1Info;TF1Info;Suivez toute l'info des rédactions de @TF1 & @LCI et l'actu des #JT #LE13H #LE20H #JTWE avec #TF1Info. #RespectZone;120264;780;210856;2278;334178
Sylvypn;Sylvie P;Femme française patriote je me bas contre le wokisme et pour préserver notre civilisation et notre culture  ZZ2022;205990;931;1019;124992;332932
J_Bardella;Jordan Bardella;Président du Rassemblement National, Député européen.;19562;538;293639;17646;331385
lecho;L'Echo;"L’Echo informe et inspire celles et ceux qui ont l’esprit d’entreprendre. Une question? Contactez le 0800 55 050.
📍Avenue du Port 86C bte 309 (BE0404.800.301)";259683;356;69609;1509;331157
Strategies;Strategies;"đ° La rĂ©fĂ©rence des professionnels du marketing, de la communication et des mĂ©dias. Abonnez-vous : bit.ly/3GzfViK 
Les offres d'emploi âĄ @StratEmploi";56025;585;264908;7864;329382
LPCRouge;LePetitChaperonRouge;"Observatrice de vies humaines.

#Resisteamfr
#JeSuisSleepingGiants
#NousToutes
#AtelierDEcriture";120574;1955;3890;202962;329381
T_Nenninger;Dr Thomas NΞNNINGΞR;Médecin spé, Philosophe partisan. #ThinkDifferent Me contacter: keybase ou signal. Envie de m'offrir des chocolats? Ici: tippin.me/@T_Nenninger;151575;6095;23696;147996;329362
NichoulB;Nichoul BNJ;"""Les chefs c'est comme les étagères : plus c'est haut et moins ça sert.""";27756;607;490;296692;325545
CathCervoni;Catherine Cervoni;"Relation presse, médias & d'influence -RP/RP2.0- stratégie 360- formation catherine-cervoni.com Blogueuse le soir ;-)";151715;4259;28679;140158;324811
SudRadio;Sud Radio;ð» #ParlonsVrai sur Sud Radio ! Retrouvez @PatrickRogerE @cecile2menibus @JJBourdin_off @ELevyCauseur @andrebercoff @valerie_expert @Poulin2012 @guycarlier2013;163685;7557;148769;4552;324563
Democratic_AC;المركز الديمقراطي العربي;مؤسسة بحثية مستقلة تعمل فى إطار البحث العلمي الأكاديمي تعنى بنشر البحوث والدراسات في مجالات العلوم الاجتماعية والإنسانية والعلوم التطبيقية ضمن مجلات علمية محكمة;233052;175;57221;33569;324017
journalmetro;Journal Métro;Média branché sur l’actualité de Montréal, sa culture et son art de vivre. 📽💬;182736;866;140149;211;323962
ralifromparis;Rali;#politique #Paris #Rabat #Perigord đȘđș đ«đ· đČđŠ đźđ± đ - droite - contribuable - pro business - Marianne fund - anti misĂ©rabiliste - specialistologue;107723;5043;7914;202716;323396
chocoylatine;Philippus de burdigala­čĺÖ­čĺŤ­čÜÁ­čĆ╗­čĆŐ­čĆł­čŹĚ;"rire de tout de peur dÔÇÖ├¬tre oblig├ę dÔÇÖen pleurer.
informaticien pompier Marabout
#chocolatine #ath├ęe #sciences #UBB #FCGB
instagram.com/philippus_peji";132435;1773;2855;186214;323277
GaucheMafia;LaGaucheMafia 🌿ⓇⓏ🌿;Souverainiste ✝️🇫🇷✡️🇦🇲 #Poutine🇷🇺 #Trump🇺🇲 #Israel🇮🇱 #Czech🇨🇿 #Orbán🇭🇺 #ZOZZ🇫🇷 #Zemmour🇫🇷 @Reconquete_off @TeamPatriotes;131593;24631;29234;137540;322998
Taigasangare;Johannes Herrmann (Phylloscopus);Oiseaux. Crapauds. Autres bêtes. Catho. Païen selon l'abbé G. Larve assistée pour Horizons. Pue-la-pisse pour LREM. Peste woke pour RN. Vert brun pour Politis.;203640;5464;9635;102016;320755
thibault_am;Thibault AM;Engagé à faire progresser la France, à agir pour l'Intérêt Général avec les valeurs de progrès fondées sur la science & la raison. 💪🇫🇷🇪🇺🌍;162311;1506;2635;151992;318444
emma_bovy;Cosette;en attendant l’inspiration, ràs;177593;2976;2771;134753;318093
HugoMe;HugoMe;Je est un autre. Ou comment dire des bêtises sans se les prendre sur le coin de la tête le lendemain. Nouvelle résolution : je ne réponds plus aux abrutis.;202611;805;2316;112305;318037
lesoleildeqc;Le Soleil;"Les manchettes de l’heure du quotidien Le Soleil,
la référence en information à Québec";192775;181;124295;27;317278
AuRupteur;Au Rupteur;L'aiguille qui titille. Infos honnêtes suralimentées à la déconne et à la passion sur de gros objets à 4 roues (ou plus) qui vont vite, principalement des F1.;95458;910;100565;119664;316597
cavousf5;C à vous;"Rendez-vous du lundi au vendredi à 19h sur @france5tv avec @BabethLemoine et toute l'équipe ! 
📲 Réagissez avec le hashtag #CàVous";61242;3046;211685;40168;316141
jatais;ð JataÃ­;"ð§ð·ð®ð¹ð«ð· Socio-Ã©colo-fÃ©ministe. Je m`horrifie, me marre ou m'Ã©meut trÃ¨s souvent ici. Des fois j`apprend des trucs ;-) #TeamChocolatine";28192;245;286;286817;315540
Cloo8_;Cloo8 off;50 off, 17 dans la tête (ça ne bougera plus) et 85 dans les artères (c'est de mieux en mieux).;97453;634;948;213888;312923
PREDIGAN;PREDIGAN;"libre de mes pensées 
Défenseuse du made in France 🇨🇵, des agriculteurs et éleveurs 🇨🇵";30756;4183;1298;275469;311706
KersausonDe;Florent de Kersauson;Investisseur #Startups ex Alcatel et Belgacom. MBA Cornell. Conseiller Régional de Bretagne et Candidat aux Sénatoriales;123047;5990;34046;147000;310083
charivarii1;Chatelier;"Citoyen du Monde et de l'Univers

""Il n'est point de bonheur sans liberté, ni de liberté sans courage."" Périclès.";172218;330;904;136461;309913
tcabarrus;Thierry de Cabarrus;Carte de presse 35.183. Quarante ans de journalisme et toujours la même passion pour l'actualité. On peut tout se dire, mais en argumentant sans insulte.;123543;2954;69628;113572;309697
PASCALPOINTUD;Pascal Pointud;"La politique beaucoup moins
Le Tarot beaucoup plus
La Ruralité toujours";188651;5139;14020;101037;308847
lucasgautheron;Lucas;Doctorant en philosophie de la physique (IZWT). Ex Paris VII / ENS Paris-Saclay. Trésorier du GOULAG et ex dir.publication @LeMediaTV;103517;3437;7253;194430;308637
JUNINH0_love;⭐️⭐️;"@OL @LDLCASVEL @LeLOURugby #SportLyonnais @Spurs @49ers @athletics
Dejounte Murray Fan account";48078;2138;329;257848;308393
JacquesBriet;Jacques Briet (@jbriet@mastouille.fr);Découvreur dézingueur.;262040;671;1852;41395;305958
senegal7com;senegal7;C'est un site d'actualités de référence basé à Dakar. Il est créé pour informer juste et vrai, en temps réel;262780;2573;39725;138;305216
Made_in_Alsace;Progressum;Le pays doit se reprendre : justice, économie, énergie, éducation, gestion de l'Etat, responsabilisation des individus, sécurité  #JFK, Greatest Leader ever;183406;5000;2185;114035;304626
Var_Matin;Var-matin;Toute l'info du Var: actualité, sports, économie, politique, culture. Retrouvez-nous sur varmatin.com;180311;937;122326;157;303731
SylvieGeo;Sylvie Geoffrion;Lectrice gourmande. Gourmande lectrice. Retraitée, je ne pratique plus les sourires forcés. Ceux que j'offre viennent du coeur.  Je suis une gentille. Outaouais;136203;1709;3152;162372;303436
JMGlachant;Jean-Michel Glachant;IAEE President 2023 - Professor Florence School of Regulation - IAEE Award 2018 for ‘Outstanding contributions to Energy Economics’;140632;2958;16138;143586;303314
julienpalukucom;JULIEN PALUKU;Min/INDUSTRIE-RDC,Gouverneur Nord-Kivu(2007-2019),Maire de ville(2003-2006),Administrateur de Territoire (1998-2003),Député 2006,2011,2018. Enseignant 1989 à..;5197;1385;295279;250;302111
ONUinfo;ONU Info;L’actualité de référence des Nations Unies en français | Compte officiel d’@ONU_fr | Suivez-nous sur Facebook, SoundCloud et YouTube ➡ onuinfo;76368;12300;193895;19517;302080
LiegeChene;Chêne-liège;maladive;124353;139;389;176882;301763
pixeh_;87;#44 #bmw #chelseafc #boehlyout;84202;886;3993;212329;301410
PhilippePoutou;Philippe Poutou;Compte officiel de Philippe Poutou, porte-parole du @NPA_officiel;5318;39;293073;775;299205
quatremer;Jean Quatremer;Correspondant européen de Libération. Chroniqueur « La faute à l’Europe » (France Info, LCP), « 24h Pujadas » (LCI) et 28’ (ARTE);94273;1372;183225;20246;299116
bah_C_Mag;FOUILLE HATE ACCOUNT Je vous jure je les déteste;Elle/Iel Future Maire de Morne-à-l'Eau. Papillon 🦋 YEMANJA 🧜🏿‍♀️ ⭐❤💚🏳️‍🌈 CARIBEAN FIRST JE NE PARLE QU'À MON PEUPLE. FWI🇬🇵⃠ 🦀 paypal.me/BahMag;130573;1288;750;165627;298238
Simeon_5;S. Nkola Matamba;Congolais đšđ©. Ăcrivain. Auteur : Nos Grandes Causes Communes (2021). #QDS đ đ§ :contact@snkolamatamba.com;192360;742;35324;69607;298033
wembi_steve;Steve Wembi;Criminologist, Investigative Reporter, Freelance Journalist and War reporter. CEO of @infosdirectC;43711;97;236429;16289;296526
TomekTR;TomeK TR;INTJ - Σελ•TomeK - Ingénieur Systèmes et Réseaux. Photographe amateur et grand gourmand. La vie c'est comme un voyage en #train. Bénévole #qml transilien.;265441;399;1156;29135;296131
lUMPmatuer;Macron m'a tuer;L'UMP m'a tuer et le PS m'a enterré ! #PlusJamaisPS #Ecologie #Linux - Pro-Mediapart #TeamOfficine :-) @AdieuSarko2012;274014;11282;10138;267;295701
FredSergent;Frédéric Sergent;"Ce n'est pas la victoire qui rend l'homme beau, c'est le combat (M. Ferron).
#Gauche #ProgrèsSocial #JusticeSociale";187454;1300;2511;104320;295585
P5Lawrence;ǝɔuǝɹʍɐʅ \o/ 🜃;Exégète à mateur Mes touits vous engagent;277314;2820;2748;12083;294965
franckyxm;🕊️🇨🇵❤️‍🔥🇷🇺,🇦🇲,🇾🇪🕊️Vive le Roy!;"Roy de France et Dieu du monde Jésus Christ!
Reine de France et mère du peuple Trés Ste Marie.
princesse de France et gde soeur du peuple, Ste Jeanne d'Arc.";127042;4890;3875;156589;292396
AdresanSoso;Lili Adresanđș;"đșJe suis une humoriste dĂ©butante.
Quoi? Ă§a vous pose un problĂšme ?
De toute faĂ§on il y a un dĂ©but Ă  tout.
Et je vous emmerde.
Je parle Ă  tout le monde.";92694;5001;4380;189332;291407
aBamako;aBamako;;65619;45;225665;50;291379
ladepechedumidi;La Dépêche du Midi;L'actualité internationale, nationale et régionale depuis 1870;165011;514;123370;2447;291342
cyrilboji;GWARD 🇫🇷🇨🇦🇬🇷🦂🇦🇲🇮🇱🇷🇺🇱🇺;"Contre le Hollandisme deguisé,l'usurpateur Macron du en même temps!""la loi protège la foi tant que la foi ne dit pas la loi""⛔️🟢🍉/⛔️ExtrémG/LFI/Wokisme/EELV🤡";234373;275;787;55112;290547
DBouffee;Dominique Bouffée;Macron n'est pas mon president,il n'est rien-;75130;2190;2877;207924;288121
Micheben;”COMPOSTERREAURISTE” MimiPetite🐭👩‍🌾⚖☮🗺32946;"Fibro. Ne doutez jamais qu’un petit groupe de gens réfléchis et engagés puisse changer le monde... M.Mead
Sans affiliation à un parti..ni..ni...";104073;561;3343;180080;288057
EnRlnyln;e.Dln'™;"LYONNAIS #TeamOL /🎶/⛰🏃🏾🚵🏾‍♂️/#F1;#MotoGP;#FormulaE,#WEC,#WorldSBK,#AH19 #JB17/ Renewables Energy";284057;508;698;2399;287662
HiWhatsuphere;SoOuvreLesFenêtres 🍓📚💸;"#teamparents #teamBretagne #teamprofs #teamsciences 
Maman de musiciens 🥁 Femme de musicien 🎸
Lutte en cours 🦀";88106;2548;1499;194343;286496
ArthusBrega;Pastafaripirate matricule 21726;"Gaulois Franc et direct Si vis pacem para bellum
Matricule :21726 . J'aime le Saint Mont et le Bourgogne . Toujours un Armagnac pour les amis . Soutien exmuslim";28683;6505;6612;244195;285995
ChristinaHell;Chris Tina;xn--pialle-r964e.fr/@Christi…;128525;4656;776;151571;285528
jeremyerline;Jeremy erline;Livreur de nouvelles amateur et professionnel #DroiteSocialeEcolo #FCB #teamSRFC #spurs #TeamRedbull #F1 #PKMN;222951;3868;2901;55767;285487
pbeyssac;Pierre Beyssac ð«ð·ðªðºðºð¦;ð´ââ ï¸ Directeur Internet Europe #DNS #ipv6 BSD #trains #ImpactNumÃ©rique | Founder @eriomem_net nic.eu.org gandi.net | Porte parole @PartiPirate. @pb@mast.eu.org;242165;1404;18563;21642;283774
LaCroix;La Croix;"Bienvenue sur le compte Twitter officiel du journal La Croix.

Et demain sera tout aussi surprenant.

linktr.ee/journallacroix";198668;1295;78338;4746;283047
Elisabeth_Borne;Élisabeth BORNE;Première ministre 🇫🇷;5924;1040;272661;2859;282484
AdolpheBenitoG;Tous infectés, tous libérés!;« Pétainiste sous Pétain, Gaulliste sous de Gaulle » Adolphe Benito Glandu 1985;174137;848;1072;106312;282369
boujemaa_b;bilal_boujemaâ🏳️🕊⚖️🗽Proc💛🎗🐝🏴‍☠️fiché:6456;🐺pertinent & impertinent: 🌍🦋Anticorruption:égalité écologie humanisme logement dével.nt 1/3&1/4monde...répartition des richesses,animaux👽Proc:Matricule6456:;138212;433;668;143037;282350
ControleurPM733;PM733 #24ansDeCheminsDeFer;Chef de Bord TGV Axe Atlantique / Mandaté CGT Cheminots / Bénévole ONCF (Orphelinat) / Président Coord IDF Cheminots Don du Sang / Compte géré sous #ChartePM733;186413;5829;7209;82839;282290
Ecoff123;Gif Animé;Bisounours pessimiste un peu cynique | Je fais des gifs | #Levain | #QuanticGhosts | @Ecoff@mamot.fr;109595;835;818;170082;281330
gyrovaguerie;revan;;20849;370;183;258036;279438
ThomasCOTTINET;Thomas Cottinet;#Ecolab #GreenTech #data #i4Emploi - ex @LIBERTE_LL @DGTresor #CollTerr @INSP_Fr @Centralelille - Elu #Taverny #ValParisis #eelv co-secrÃ©taire 95ð» TweetsMyOwn;44088;13641;13728;207189;278646
DavidUlysse1;David Ulysse ððð¥;Lâessence des droits fondamentaux est inviolable (article 36, alinÃ©a 4, de la Constitution de la ConfÃ©dÃ©ration helvÃ©tique) join GETTR @DavidUlysse;156678;2967;1730;117007;278382
beatricelecoz;loumayoun83;..carrière dans le tourisme pendant 35 ans;214457;2726;3346;57034;277563
FlashTweet;FlashTweet, LA Matinale du Changement;⏰ RDV à 7h30 pour le #Top10 by @EmmanuelleL9 #innovation #metaverse #web3 #IA #Marketing #AR #VR #startup #Tech #SocialMedia #TransitionEcologique #TransfoNum;118433;4527;57477;96951;277388
AliceVachet;Alice Vachet;Animator-ITWđSustainable & Social Business Activistđ #Podcaster LâEmpreinteđ§â»ïžSpeaker #Ecologie #ESS #RSE;19573;5312;63874;188474;277233
Winc_King;WincKing;Pork Ribs 'n Donuts;125805;1308;1388;147727;276228
markettagswords;tagswords;"Toutes les bonnes affaires du web
Bons plans trucs et astuces, gagner de l'argent, webmaster développement personnel #affaires #argent #web #affiliation #SEO";273145;1184;690;452;275471
ashitzka;eren;Je regardai, sans parler, les plis du sable sous la lune. Le désert est beau.;127760;390;2234;144906;275290
Nain_Portekoi;Nain Portekoi;Parce que l'humour noir est à l'humour ce que le radis noir est au radis.;85697;937;138466;49677;274777
KavuncuRomain;KAVUNCU Romain;comptable BAC+5 Politique et bénévole association Handicap;102963;4265;2789;163407;273424
Menilmuche;Fabien;Bio : dégradée;254752;2455;7706;5973;270886
manson_fx;Fx_ Manson bientot Clara 🌈🌈🌈🌈🌈🌈🧡;Cinephile , lectrice de Roth, Mann, amatrice de jazz, une femme un peu blasée par l'idiotie. Condamnée par le crabe.;142011;4246;1273;121559;269089
FrenchExecutor;PSG⭐;supporter de Paris un jour, supporter de Paris TOUJOURS allez @PSG_inside #LDC #valknut #psn : RYJAdu29 level 32 ATM Mahée, Megane a jamais dans mon coeur ♥️;43676;2300;984;220913;267873
FrancisTaquin;Francis Taquin;"Lutte PACIFIQUE contre le Nouvel Ordre Mondial Tyrannique !

NOUS sommes PACIFIQUES !!! š« š« infowars.com š";143502;748;2461;120968;267679
K_insoumise;ð¢ð Kiwi âï¸;"Depuis 2012 Ï #LFI ððð»ð»
#Greenpeace #Bloom #Nupes âï¸
ð¢ Gaucho woko humano ð¤ª ð¢
Insoumise Ã  vie â¤ï¸ 3 beaux enfants pour nos retraites, j'ai une mÃ©daille ?";54198;2704;2659;207695;267256
joelpriejan1;Joelle QUI VOTE À 9 VOLE UN PEUPLE🥚;👁 #PasDeVague #ChristineRenon #NonALaReformeDesRetraites #RefonteDesInstitutions #ABROGATION #CRISEDEMOCRATIQUE🍉 #NonAuPacteEnseignant;144766;5661;6993;109107;266527
FondationNH;Fondation Nature Homme;ONG reconnue d'utilité publique. Nous oeuvrons, depuis 1990, pour que les solutions écologiques et solidaires deviennent la norme de demain.;19747;1251;237984;7189;266171
LesMotsRouges;Romane;"""La situation de M. Assange devrait concentrer toute la mauvaise conscience démocratique de  l'Europe"" Jean-Luc Mélenchon";250746;2091;2955;9443;265235
AnankeGroup;Ananke Group;Ananke Group is a security, risk management and service support company that identifies and manages risks in Africa and the Middle East. Retweet≠endorsement;57592;1199;4736;200106;263633
dnatweets;DNA;đź—ž Toute l'actu alsacienne qui vous concerne ! Abonnez-vous pour nous lire en intĂ©gralitĂ© đź‘‰đźŹ» bit.ly/35Qd0Ru;99537;514;161282;2089;263422
Rodolphp;Rodolphe Peté;Sud-Est, Paris, Rennes. Journaliste, cinéma, musique électro, littérature, gourmandises, #teampainauchocolat. Souvent sur les rails. 🐻😎🎧 Youtube@rodolphepete;214268;5000;1934;41975;263177
lopezthe;lopez đ âïž;"Comme un petit radeau frĂȘle sur l'ocĂ©an.
@Lopezthe@mamot.fr";80316;3341;2965;175525;262147
Julietteetienn5;Juliette etienne;"Socialiste jusqu'en 2017, Macron 2022 Allergique aux extrêmes
Pas de DM";60575;2533;2597;196377;262082
Themislv_vls;Themis;"ð¦£ Mastodon : @Themislv_vls@piaille
SarsCov2 se transmet par aÃ©rosols : portez un masque (ffp2) â¢ purifiez/renouvelez l'air intÃ©rieur";81635;1303;2647;175460;261045
kola_nick;Nick Kola;;145769;694;552;113551;260566
montreal110;Marc St-Cyr;Engagé je lutte pour l'environnement,le politique, je fais avec,je ne supporte pas l’injustice! Antisémites ne sont pas les bienvenus,je supportes Israël 🇮🇱;189674;3256;3454;63563;259947
GaranceAmarante;Michel đđ;"VĂ©lotafeur libĂ©ral.

PlanĂ©taire trĂšs omnivore.

RSSI, architecte des solutions de sĂ©curitĂ©.

Pervers Ă©picurien athĂ©e.

â

Team #aerocyclo";142952;3466;1330;111840;259588
Mystic_Cayman;ğ¨ğ¾âğ¼Mystic_Caymanğğ¦£ ğºğ¦;"ğ· xavier_abl_ 

#TeamGuadeloupeğ¬ğµ #FWI #Caribbeanstrong #VakansÃpeyi #Streetart #Venezia #Paris";138870;4805;2259;113625;259559
PhilippeMurer;Philippe Murer đź‡«đź‡·;Gaulliste/souverainiste/ 3 thĂ¨mes essentiels pour la France:Ă©conomie & social, environnement, flux d'immigration;56354;2560;65723;134822;259459
TheNancyRoc;Nancy Roc;Journalist- communication specialist. Specialties: #Haiti #Canada #politics #Climate #HumanRights #Environment;128291;2366;109045;18842;258544
lestrepublicain;L'Est Républicain;Compte officiel de la rédaction de L'Est Républicain, quotidien d'informations régionales en Lorraine et Franche-Comté. Un titre du Groupe EBRA.;145412;516;111030;1475;258433
Toulouse;Toulouse - Mairie et Métropole;Compte Twitter officiel de la Mairie de Toulouse et de Toulouse Métropole. Suivez @ToulouseAlertes pour les alertes météo.;48867;189;205945;2942;257943
n_attend;Nathan;Mon rêve c'était d'être connu en faisant trembler San Siro -  #ACMilan #HeatNation #RavensFlock;253877;963;642;2370;257852
LttaC;Nez Vert;k♡ | ce qui sera, sera;195832;633;2270;58365;257100
BanalCommeTout;BanalCommeTout;đ» Banal, parce que juste #dĂ©mocrate, niveau collĂšge. // Sujets: Sciences / Climat / BiogĂ©e / pas touche Ă  la #DUDH / Paix / violences policiĂšres / Nupes âșâ  lfi;95511;3962;1426;155960;256859
__Verlaine__;Verlaine;"Politique et société   |
- ΙΧΘΥΣ - |";46994;1882;59205;148329;256410
boubou_le_prof;Boubou SIDIBE;Que dire?ð¤·ð¿ââï¸ð RTâ  Endorsement!;123434;3895;66599;62322;256250
shilderi;Association Collaborative d'Adoration de Bridget;"je ne suis rien j'ai juste des idées.

 vous connaissez l'élephant qui fait comme l'oiseau ?

dm si vous voulez join un discord de g@m€rz de gauche";158389;1708;5096;90848;256041
BernardGobitz;GOBITZ Bernard;"Ceci est un compte personnel. Les opinions exprimées n'engagent que moi.
Pour l'Association des Usagers des Transports/FNAUT IdF, voir le compte dédié.";13547;3405;1144;237905;256001
BleueEvelyne;charasse evelyne;Femme petit gabarit grand sens de l'humour et dérision poétique  à lire ici : charasseevelyne.over-blog.co… et des petites histoires là :;179261;13061;19421;44152;255895
L_ThinkTank;(Little) Think Tank;➡️ Groupe interne de discussion sans caractère officiel | 🔴 Le fil Twitter, indépendant, est uniquement destiné au partage de l'actualité dans divers domaines;25368;1577;223870;4935;255750
Manoudu19;Manou;;148146;5000;2417;99834;255397
7sur7;7sur7;Toute l'actualité belge et internationale en continu;217669;43;37566;8;255286
kirafiky;𓂓;"Procure-toi mon recueil ""Retour à l'Essence-Ciel"" 💙 | DSMP.";146506;599;8775;98951;254831
benjimk;Benjamin Umba;💵Banquier, 👨🏽‍🎓Master en Business Management et amoureux du voyage 🛫;27978;999;110652;114848;254477
Bordeaux;Bordeaux;Compte officiel de la ville de #Bordeaux. Infos, actu... Des nouvelles du Port de la lune.;15653;2003;234568;1645;253869
ClovisChMartel;đ«đ· Mansuram in fide ad dextram, RĂ©publicain;Conclusion : Â«Une Union EuropĂ©enne haĂŻssable conduite par des gens mĂ©prisablesÂ»;135715;4997;3470;109658;253840
cfhinor;Chichi;je n'étais ni pour ni contre le KFC, mais ensuite le peuple de l'herbe a attaqué;88976;2228;4902;155958;252064
ElianeFines;Lili dit Jojo;"« Quand le soleil se lèvera, Beyrouth, ma ville, n’existera plus » par Patricia KHODER. 
« Il ne faut pas céder, il faut s'aider » Gilets Jaunes Janv 2019.☂️🌈";96902;1742;1760;151577;251981
TimeLinux;Tux Inside🇫🇷🐧;Non-woke convaincu. Ennemi du Nouvel Ordre Diversitaire Pour la libération de la France #Frexit #FA22 #UPR;86766;407;655;163868;251696
ScapNico;Nico Scap;Cool;47024;165;414;203720;251323
grebert;Christophe Grébert 🚴‍♀️;Je bouge à #vélo à #Paris et banlieue. Mes intérêts : mobilité, ville, urbanisme, climat, environnement, démocratie, citoyenneté, LGBT, médias, plantes vertes;119705;1023;14301;116162;251191
CourrierPicard;Courrier picard;Compte officiel du Courrier picard, le quotidien régional de Picardie;139061;501;110401;904;250867
nouvelles2025;Nouvelles du monde;Nous vous enverrons les dernières nouvelles.;244435;2113;3747;3;250298
girolles36;léaument saïd philippe matricule 2391 classe⭐️⭐️⭐️;spécialiste du billard français en trois bandes avant, en recherche d'efficience;132154;364;711;116789;250018
ErwanNICOLAS11;ERWANð;"â Soyons fermes, purs et fidÃ¨les ; au bout de nos peines, il y a la plus grande gloire du monde, celle des hommes qui n'ont pas cÃ©dÃ©. â 
Charles de Gaulle NoDM";40289;5001;4436;199564;249290
infernale95;utah2828 - #Macron2022;LE COEUR A SES RAISONS QUE LA RAISON NE CONNAIT PAS;234753;2029;1055;11388;249225
Robe_0000FF;Robe_0000FF (bleu);"Devops (si tu ne sais pas demande je t'expliquerai) essai de comprendre le Droit sur les bancs virtuels.
Trop souvent #Team1erDegré";53975;669;1256;193172;249072
Elysee__2022;Politique;Actualité politique en France;242925;117;5653;34;248729
alaindu891;alainmontel;de Gauche depuis bien longtemps, je suis libre de ne pas me soumettre à tout et n'importe quoi, biodiversité, musique etc @nuisancessonores la plaie;126053;1620;1351;119494;248518
Joaobap57934294;Computer Science/cyber security& Network;Switching,Routing,Design&Troubleshooting,MPLS,SLA,QoS-Multicasting,Netwok-Data Analyst/virtuazation &Automation;225023;2451;15674;4974;248122
1Senegalais_L;Sénégalais Lambda🇸🇳🇵🇸;#Polytechnicien #ESP #SS #RMA🏆 #CFC💙 #Lakers;85619;17612;40270;103789;247290
RudyCluzel;Rudy Cluzel;Directeur de la Communication et des Affaires publiques @UFElectricite #Energie #Climat #ColloqueUFE | ðAlumni Sciences Po;109940;2934;4349;129373;246596
Jean_eusebe;Jean-Eusèbe du BB67000;"Fan de LE TRAIN.
BB67000 stan account.
PP du formidable @grillaum
Je déteste Kirby.
38 ans.
Je co-Anime @ParlonsTrain quand je fais pas le Gauchiste.";68255;686;1506;175393;245840
22MDOLIVIER23;MDOLIVIER;"#PlerredeCoubertin a dit : le principal c'est de participer, 
@NicolasSarkozy a dit : le principal c est de GAGNERð¾ðð¾ð";223080;4992;3427;14098;245597
hdjebar;Djebar HAMMOUCHE đ đđđ;Ce n'est pas leÂ cheminÂ qui estÂ difficile, c'est leÂ difficileÂ qui est leÂ chemin. -SĂ¶renÂ Kierkegaard #NoMoreDZ;229923;3911;1501;10256;245591
RwandaMFA;Ministry of Foreign Affairs & Int'l Cooperation;The Official Twitter handle of the Ministry of Foreign Affairs and International Cooperation. Government of Rwanda.;13358;640;225253;6298;245549
JadoreMontreal;J'adore Montréal;Bienvenue! Il s'agit d'un compte non gouvernemental de la ville de Montréal, Québec. Nous re-tweetons uniquement les principaux comptes d'intérêt pour la ville,;242515;1292;1122;96;245025
LeNectarivore;Stefu-ἀνερρίφθω κύβος-Alea Jecta Est⚛️🕎☮️;Ελευθερία ή θάνατος🗽🦅Vosgien🌲🌳 Lorrain & patriote, 🇫🇷🌈⚜️, pacifique, #libertarien, curieux, autiste✌️🫶🕊cœur libre❣️Épris de la #Roumanie🇷🇴☦️ 🖤♒️🐀💦;123064;5001;671;116127;244863
zersinan1;zer sinan;militant communiste révolutionnaire internationaliste ! Le communisme, et l’avenir du monde!😣🧐😠😡🤬🤯😳;228091;1846;582;14264;244783
lopinion_fr;l'Opinion;Nous traitons essentiellement de l'actualité politique, économique et internationale avec un positionnement revendiqué : libéral, pro-business, européen.;144044;566;97995;1674;244279
almokeur;almokeur;A Gauche, né railleur incisif, athée pratiquant, anticlérical débridé, je moKe et je n'aime pas les cons ! Mes RT n'ont pas valeurs d'adhésion...;234205;5167;4712;92;244176
FindinLanguedoc;Finding Languedoc;"Ted & Jemima in #Aude #Languedoc #Occitanie #France:
#news #agenda #podcast #video #photo in FR & EN
#Carcassonne #Narbonne #Lezignan #Castelnaudary #Trebes";223372;585;647;19541;244145
GionoH;Giono Henri;Astronomie et Paella;21745;776;606;220363;243490
lisefalardeau;Lise Falardeau;Éducation B.Ed., ex-fonctionnaire (Parlement du Canada), féministe / politique, histoire, sciences, environnement, justice sociale, économie, culture (Fr & Eng);132410;3723;3591;103663;243387
cestrosi;Christian Estrosi;Maire de @VilledeNice, La France Audacieuse - Président de la @MetropoleNCA - Président délégué de @MaRegionSud - @La_F_Audacieuse;37413;1760;197927;6085;243185
hostilus;titus hostilus;Je suis ex Tullus Hostilius abattu par le Piaf Pour une 9ème croisade puis le retour de toutes les libertés et surtout celle d’entreprendre;137865;1835;1459;101964;243123
OvaliePaDuRhone;Ovalie de la Tiretaine en vadrouille;futur ex handballeur à genou partiel, Jaunard Forever, financier de Section. dorénavant en Sudouestie après 12 ans à Lyon et Villeurbanne;82185;2837;3099;154104;242225
24heuresch;24 heures;Suivez-nous pour être au courant de toute l'actualité vaudoise et d'ailleurs traitée par les journalistes de 24 heures. #Vaud #Suisse;153055;703;86248;1868;241874
_Housewife;Dramione 🫀;J’aime seulement Harry Potter. Serpentard 🐍 | 🇨🇬;233295;1033;5432;1139;240899
JeanJacques92;ðºð¦ papi JJ le bigourdan ð´ððºð¦#HDCCG;"@jeanjacques92@masto.bike 
ð´tardif, ex-vÃ©lotaffeur Enghien - La DÃ©fense 28km A/R";105000;285;989;133588;239862
greenvincent;Vincent Laurent;Consultant stratĂ©gie digitale đź“± RP đź“° / Enseignant @ESG_Mtp @espublicite/ Intervenant #EspritCritik @clubdelapresse/đźŚ»/ #ruralitĂ©s #tierslieux #Occitanie;79240;3621;5522;151438;239821
123_INFO_FR;123 INFO FR;Toutes les infos 24/24 - 7/7. | Ici on tweet tous les articles d'actualité | Conditions d'utilisation ➡️ msha.ke/123info | @GoNews_Off;237319;63;1058;1327;239767
75002Parisienne;Parisienne 🇫🇷🇪🇺;World citizen, proud European. Paris is my hometown and the Seine runs through my veins. Political junkie. Sarcastic on occasions ... or so I'm told.;90958;1918;2897;143588;239361
MauriceMolinero;đżMOLINERO Maurice.đ«đ·đżđ«đ·;đ«đ· Retrouver une France FranĂ§aise De vieille souche ProvenĂ§ale et PiĂ©montaise arrivĂ©e en France en 1885 . #zemmourđżđ«đ·PIONNIER du Premier Jour circo1308;110087;3926;3858;121483;239354
blues_pablo;Caliban;"*Künstlich un;intelligenter* .pragmatisierter. +maschinell gelehrter+ :automatisierter: Diplom.Phrasen.Drescher";125330;1829;983;110974;239116
loindevant;loindevant ℹ️ 🆓;"Appliquons la volonté du peuple organisé, non celle de mafias
#LogicielLegislatifContinu aux suffrages valorisés par acquis
➡️ tinyurl.com/p96sfe3w";224798;1701;1970;10407;238876
DiasporaEngager;DiasporaEngager;World’s #1 and Largest #International #Diaspora #Engagement #Network #Platform. Visit diasporaengager.com/miniRegi… to register a Free Account to find #Opportunities.;231074;2779;3400;2;237255
Calnos1;Calnos ๐บ๐ฆ -๐๐๐๐+๐ - ๐๐๐๐;Dit de la merde, spรฉcialiste en la matiรจre. --  Fan de chat - #Acouphรจne (3 ans) - #Athรฉe - #Antithรฉiste - L'amour est une purge - Misanthropie : 53.;72992;358;463;163393;237206
AudreyPulvar;Audrey PULVAR;Écoféministe à vélo/en métro. Universaliste woke. Adjointe à la Maire de @Paris. Conseillère Régionale d’Ile-de-France.🇫🇷;62526;5676;122248;46604;237054
FrancoisBulloc1;Francois Bullock (Patriote XV);Fais ce que dois, advienne que pourra ❗️                 Vive INTERNET NON CENSURÉ 👍 «LA PEUR TUE LA RAISON» ANTI PASS SANITAIRE-Je suis 10%;46290;927;7105;182568;236890
GARREAU75;François GARREAU;"En charge de la mission #RSE auprès du Comex
@GeneraliFrance | Président de la Commission #DD @FranceAssureurs | #Assurance #Finance #Generali4Sustainability";112942;6981;16403;99277;235603
larrouturou;Pierre Larrouturou;Justice sociale & climat. Député européen @Nouvelle_Donne - Rapporteur général Budget 🇪🇺2021. Member European Parliament @TheProgressives 🌎📈 Né en 319 PPM.;15934;60621;62188;96256;234999
legendre891;legendre christophe;agriculteur  céréalier;48529;4489;4066;177403;234487
NiusMarco;marco nius;"Luthier-Ingénieur en génétique microbienne- musicien -enseignant
Pas de #spike , Pas de chocolat";55468;766;45708;132066;234008
Silvio_Gesell_;Silvio Gesell;Omnino absolutum Imperium;173056;3926;3730;52984;233696
ChamboncelBen;Benoît Chamboncel;Délégué régional Bretagne et Vice-Président du Conseil National de Territoires de Progrès | @TdP_Bzh |@RurAlliance |#Culture | #Ruralité |#Laïcité|;60859;3524;6709;162271;233363
CNES;CNES;L'actu du CNES, le Centre National d'Études Spatiales.;33781;1904;183085;14453;233223
poune2212;Céline ⚽️;humaniste, féministe, maman. Ni Macron ni le pen ni Z . antivax passez votre chemin.;9598;984;420;221286;232288
grandmaisonclau;claude grandmaison;Passionné par tout ce qui m,entoure, à l',écoute de tous et j,aime donner mon opinion;103838;1368;2318;124678;232202
franceonu;La France à l'ONU 🇫🇷🇺🇳;Mission permanente de la France auprès de l'ONU / French Mission to the United Nations | Follow Ambassador @NdeRiviere 🇫🇷🇪🇺🇺🇳;41872;2540;168430;19065;231907
LeTemps;Le Temps;Site suisse d'information. Il décline ses contenus avec exigence et indépendance. Abonnez-vous à nos newsletters thématiques: letemps.ch/newsletters;153204;254;74780;3111;231349
DiasporaNews123;Global Diaspora News;#Immigration, #Refugees, #Business, #Humanitarian, #Asylum, #Travel, #Education, #Science, #Human #Rights,#Sustainability, #Prophetic, #Culture,#Africa, #Peace;224354;3288;3693;2;231337
arthur_jve;Arthur Jv đ¶đ»;Citoyen engagĂ©, modĂ©rĂ©, libĂ©ral, europhile - Consultant en stratĂ©gie pour #PME et #ETI;21186;1561;1456;206711;230914
Antigonartemise;ROBERT;;104156;5001;1088;120668;230913
JA_Eco;Jeune Afrique Éco;Tout savoir sur l'actualité économique de l'#Afrique - secteurs, entreprises, patrons, tendances - grâce à Jeune Afrique / @jeune_afrique;25875;256;204554;25;230710
chantal63;Pour la justice;;69381;3684;4892;152519;230476
guela_romaric;kanné Mady Romaric Guela;Président UINPH '' Union Internationale et Nationale pour le Progrès de l'Humanité'';119907;4418;5027;100868;230220
gottabekd29;Kiam Davidson;Fier Montréalais. Intérêts pour les enjeux sociaux, l'entrepreneuriat collectif & la politique. Et un peu de sport dans tout ça...mes tweets n'engagent que moi.;27893;1144;1306;199640;229983
minimoi1969;Francois Labrie;Jamais l'esclavage n'est aussi bien réussi que quand l'esclave est persuadé que c'est pour son bien.;16122;573;1516;211661;229872
sophie_bussiere;Sophie Bussiere đ»;Porte parole @eelv. ConseillĂšre rĂ©gionale Nouvelle Aquitaine EELV. Membre du CA de la FEVE.Avocate au Barreau de Bayonne.;26780;4103;4747;193949;229579
VincentdeVince2;Vincent de Vincennes;Réinformateur et pourfendeur de la secte gauchiste qui détruit la France depuis 42 ans, en particulier depuis 2012.;126947;3774;3940;94423;229084
ALERTES_INFO;ALERTES INFO;ALERTES INFO, BREAKING NEWS : Toute l'info, le sport et les médias en direct;220730;83;7311;2;228126
Franois592;François, Gaulois réfractaire, matricule 1777;l’€URSS: structure à l’impuissance organisée. La citoyenneté européenne n'existe pas! l'EU n'est pas une nation!  🇷🇺 + Sannat, Jovanovic, Gaves, Delamarche;146892;1798;2840;76303;227833
Steve_Tiger1;TIGER⚜;Québécois qui commence à être gêné de l'dire 🤷🏻‍♂️ La valeur d'une société se mesure par les principes qu'elle défend.. N'aie pas peur, Éveille-toi!;75643;7772;18728;125120;227263
RoblesNatalia;Natalia ROBLES;Responsable #Communication Digitale @GRDF. #Energie #Biométhane #GazRenouvelables #Méthanisation #BioGNV #EnR #TransitionEcologique #GRDF #Energy | #FrAgTw;75681;8268;31977;109825;225751
OMALEY33783919;O MALEY;"#NUPES
. 
#LGBT
. 
Allié des féministes
. 
Droit des animaux
. 
À vélo, comme en politique, si on avance pas, on tombe
.
On passe la seconde #EELV ?";41650;1867;780;181391;225688
Fovsman;Killing Joke 🇸🇳🏆🌟;Social Mbalagueur - Former Viner - CEO & Founder De Mes Conneries - Qui Mème Me Suive - Depressed @acmilan Fan 🔴⚫ - ℂ𝕙𝕒𝕞𝕡𝕚𝕠𝕟 𝕕'𝔸𝕗𝕣𝕚𝕢𝕦𝕖 🌟;151995;3179;19568;50494;225236
agenceecofin;Agence Ecofin;"Agence Ecofin est une plateforme d’informations économiques et financières africaines, constituée de 11 fils d’actualités spécialisées 
Aussi sur @ecofinagency";149892;1120;72812;907;224731
zehavoc;Djamé..;Associate professor in NLP, engaged citizen. Tweeting about work, life and stuffs that I care about. All my tweets can be used freely. @zehavoc@mastodon.social;121684;2981;5180;94196;224041
rbrtcormier;Robert Cormier;"Citoyen lambda; indépendantiste, social-démocrate, centre-gauche.";41702;1436;1707;178081;222926
BoudPrototype;Galette parfaitement lucide;he/his, 90’s;32415;582;1606;187915;222518
marcalainb;Marc Alain Boucicault ð­ð¹;Ecosystem Builder | Founder of @BanjHT | Alum @Harvard @Kennedy_School @AmericanU @CtpeaHaiti | Fellow @FulbrightPrgrm @OneYoungWorld EX @el_BID @WorldBank;62810;2204;111493;45665;222172
HiceMMG;Future;We Made It;205943;697;2581;12162;221383
aa_french;ANADOLU AGENCY (FR);"Le service Français de l’Agence Anadolu vous propose des dépêches, analyses, contenus multimédia
Suivre aussi :
@anadoluimages EN: @anadoluagency AR:@aa_arabic";191298;34;29844;18;221194
presseocean;Presse Océan;"▶Suivez l'actualité de la Loire-Atlantique avec @PresseOcean, journal quotidien.

Le compte associé @PresseOceanLive permet de suivre des événements en direct";142416;1095;75385;2154;221050
GerardDupin;Gerard Dupin;International Consultant Telecom & Environment;124732;4998;3066;87832;220628
Vol_de_Nuit_333;Dr Olivier RP David;Gouin 🌈 · Olfacteur compulsif · Maître de conférences en chimie organique @ILV_UMR8180 @uvsq · J’écris pour @NezLaRevue · Osmotécaire · Écrabouilleur de 🦀;30487;1284;2423;186268;220462
AntoineDireKing;Militare Universalis ð´ââ ï¸ðªðºð¨ðµðºð³;"Terroriste intellectuel                                         
LibertÃ©, tolÃ©rance, Ã©coute.
ExceptÃ© pour un certain mouvement brun";31738;1734;343;186428;220243
deslnfor;➡️ Desinf rmateur 🗞🐾🔭🖥️ #NoFakeMed;Tout savoir pour rien comprendre;86147;519;980;132212;219858
pmlahaye;đź‡«đź‡· pmlahaye;"RĂ©publicain, laĂŻque, SaintSimonien et chauvin ;-) Quand je retweet c'est que j'approuve mĂŞme avec rĂ©serves";137920;3427;1637;76684;219668
Tunisia_Watch;Tunisia Watch š¹š³Ā®ā¢;;212937;4;6432;11;219384
Arnaud3J;arnaud3j.;"« La magie croit aux transformations immédiates par la vertu des formules, exactement comme le socialisme. »
 Gustave Flaubert.  Lettre à Du Camp, 1879...";139171;1870;3789;74092;218922
eurasia_today;Eurasia Today đ«đ·;"Â«Article 11 - #LibertĂ© dâexpression et dâinformation :
 2. La libertĂ© des #mĂ©dias et leur #pluralisme sont respectĂ©s.Â»
(Charte des droits fondamentaux de l'#UE)";61672;1554;1751;152709;217686
1ptiterose;petite et forte à la fois;je rappelle ceci les échanges doivent rester conviviaux pas de MP🙏⛔je soutiens les personnes suspendus et suis anti pass et 💉 covid vive la 🇲🇫et la liberté;119955;7452;6819;83234;217460
lebon80;Lebon;;84670;2827;2674;126974;217145
MalikaAzzoug;Malika Azzoug ð¢ð¢ð¢;RÃ©voltÃ©e par l injustice et l indiffÃ©rence de ce monde et la bÃ©tise humaineð¡;90497;4975;2330;119056;216858
TFilastin;vaudais toujours;""" Réveillez-vous ! – La nuit du sommeil touche à sa fin… Levez-vous comme des lions Et ne reculez pas car la mort guette la lâcheté "" Abou Kacem CHEBBI 🇹🇳🇩🇿";184637;2601;5313;24183;216734
b_dsn;Bruno DE SAN NICOLAS;#CDO #ideationaute #tech4good #flightsim #Geek #strategy #innovation #hacker #Maker #MHacker #TransfoNum #Mobylette #moto @bdsn@mastodon.social #running #VTT;47331;4187;2924;162219;216661
Jean_Asia_;Ze Jean in asia ✝️;Ingénieur, libéral économique et catho assumé. Ce n’est pas incohérent, la France est ultra rigide en économie et quasi anarchiste sur les sujets de société.;72515;677;832;142627;216651
Mazagan_Ft;Tara F (56);Liberté d'expression ! Contre le globalofascisme : entourloupe covidienne, islam conquérant, immigration massive, UE, écolo, antiracisme, antifa...;78890;9815;11073;116739;216517
PARIZELC;PARIZEL Christiane;;113635;2315;1867;98566;216383
herodote1789;Herodote1789;sociologue spécialiste de l'antisémitisme;203129;2715;1181;9326;216351
AntoineTrouche;Antoine Trouche;Urgence écologique, justice sociale et rock 4 temps • Ingénieur et communiquant, engagé;8525;245;1572;205997;216339
manni477;Heintol Kien;infirmier, soins pour tous, #MilitantOuvrier. #gamer. Aéronihiliste. Pour la répartition du travail et de la richesse ☭ #Éphémérouge;115489;2866;12464;85156;215975
Badciss;badciss ™;Développement, économie, médias;58150;3208;47487;105565;214410
nikopol;Jean-Philippe Brette ⚛;"Moins de CO2 pour moins cher.
@SauvonsLeClimat @nega_Tep @ouinuc @PNC_France @FrGISOC @GISOC_info @EPRfanZone @INCoFEEE ecomodernist fr.linkedin.com/in/br";128061;3292;3330;79108;213791
FaRockBen;Fa'Rock 🎸🎧;Music, Football & QTs.;82925;1237;2763;126800;213725
Roseey_ANDIMA;Roseey ANDIMA✊🏾;/Pan africanist/ ACTIVIS/ Patrice Lumumba, Thomas sankara, Sékou touré, Mandela sont mes modèles. aspirent: juriste, HOMME D'ÉTAT. Mes Tweets M'ENGAGEANT.;52362;639;10531;149679;213211
DraduagF;Draduag;Une vie pour la PMI j'aime la créativité, l'opiniatreté, deteste la gauche caviar et la droite capitaliste (protestant) draduag.skyrock.mobi/1.html;147431;1842;1833;61846;212952
LO974;DIJOUX;Programmation Pharo,html,css,js,sql,php,python. #techs,sciences,IA,exobio, ......;69913;2692;1062;139162;212829
monnier403;clement;;206149;167;807;5459;212582
ecom_news;ECOMNEWS;Toute l'#actualité #économique, #politique, la vie des #entreprises et des décideurs, sur le grand Sud. @EcomnewsMedia @ecomnews_live @ecomnews_agenda;141896;3207;50371;16901;212375
2Ceyrat2Furious;Gérard Ceyrat;"Auteur, Compositeur, Interprète
Poète de la Rurbanité et du vivre pas ensemble
Dernier album Jaune et bleus de l'âme
L'ange Noir de Ceyrat
#JancoZouz";122424;4966;797;84172;212359
Medias24;Médias24;La référence de l'information économique;43638;1742;165671;1180;212231
VixWorld;Christophe Vix-Gras 🇪🇺🇪🇸 🇫🇷🦔;"Co founder @rosabonheur @technoparade
Activist RDR @playsafeparis + Tourism LGBT @pgmtourisme
mastodon.top/@astrovix";41133;1146;2913;167012;212204
CarineCarion;CarineCarion;Centres d'intérêt Twitter : social, économie, santé, politique, international, éducation, écologie, Star Trek & MCU, astronomie, IEF, autisme.;22903;337;338;188485;212063
dugocha;chantal - EM 2016 - adhérent Renaissance - FREU;"Ose penser par toi-même 
 
""Moins on a de connaissances, plus on a de convictions""
Boris CYRULNIK

#MajoriteSilencieuseRepublicaine
#NousSommesLà";162372;3544;1547;44529;211992
lindependant;L'Indépendant;Premier quotidien dans l'Aude et les Pyrénées-Orientales. Suivez aussi @LIndep_perpi @Narbonne_lindep @Carca_lindep et @sport_lindep;171123;974;37548;1756;211401
douchink;꧁✿🌸╭⊱ Ðoυcнιɴĸα ⊱╮🌸✿꧂ 🦉🍃🦋🕊️;"★彡""𝒞𝑜𝓊𝓁𝑜𝒾𝓇 𝒸𝓁𝒶𝒾𝓇 𝑜𝒷𝓈𝒸𝓊𝓇, 𝑒̂𝓉𝓇𝑒 𝑜𝓊 𝓇𝑒̂𝓋𝑒𝓇 𝒹'𝑒̂𝓉𝓇𝑒, 𝓈𝑒 𝓈𝓊𝓇𝓋𝒾𝓋𝓇𝑒 𝑜𝓊 𝓇𝑒𝓃𝒶𝒾̂𝓉𝓇𝑒"". 彡★ 𝑃𝑎𝑢𝑙 𝐸𝑙𝑢𝑎𝑟𝑑";106468;613;1608;102134;210823
ory_nick;Ory-Nick ⚡⚛️🎮;"Per Audacia Ad Astra. 

Compte généraliste, moins de jeux, plus d'autres choses !

#GoNuclear (bot selon les antinukes)";61829;2863;672;145368;210732
Reyrog;Roger REY;"L'actualité vue par le petit bout de la lorgnette d'un ex maire d'un petit village du #Jura, Correspondant Presse le Progrès-Jura.
#Jazz #Humanisme #Numérique";132440;4987;3595;69673;210695
zario58;E2P;Paris est devenu invivable. Le mouvement #saccageparis est sa seule chance, contre une mairie idéologue et destructrice.;87603;997;1396;120693;210689
jacopogio;jacopogio ðºð¦ðª;"1PRISM.com #GoodLobby #Renewables #Energy #Brands #Strategy #Politics #Sustainability #FutureIsNow
Consultant
NEW= mastodon.energy/@jacopogio";88483;793;1899;119388;210563
Annepa11;AnneLiseđ;"ChĂ©ris ton quotidien, il est un trĂ©sor ! 
La bienveillance au service de liens plus forts ...";56772;4979;1878;146917;210546
yello777;Yell⭕;Citoyen d'un Monde, qui uni, qui protège, qui permet l'épanouissement de chaque citoyen.;122917;4235;564;82242;209958
attac_fr;Attac France;Attac s'engage pour la justice sociale, fiscale et écologique et mène des actions contre le pouvoir de la finance et des multinationales.;47598;2527;142584;17023;209732
CHRISTINESOTO12;CHRISTINE SOTO;Consultante #Communication #IA #Media #RP #Event Blog @ParlonsDeCom - Membre @LaBrigadeDuWeb @RebondisseursFR #4PattesPourUnFauteuil ð«ð·ð¬ð§;42865;4774;7918;153832;209389
jeanletaxe;Jean Le Taxé #STOPtheSTEAL;"Taxé! Racketté! Spolié! Muselé! Dénigré! Désinformé! Manipulé! Déshumanisé! Intoxiqué! Insulté! Envahi! Harcelé! Déculturé! Remplacé! RebelleModéré!🐸 
Français!";183249;1775;1485;22540;209049
LeDroitca;LeDroit;Le quotidien francophone d'#Ottawa-#Gatineau. Aussi sur @LD_Sports et @LD_Arts.;179272;156;29484;14;208926
LiodeCre;Lionnette💟;pas étanche sous les avalanches;40310;423;413;167052;208198
PonsJuju;Candide;Aux cœurs fidèles, tout est accordé.;76967;1067;416;129735;208185
tewoz;Eric T.;"Coincé entre #illustration & #Tech ; je tweete #mavieauboulot #sketchnote #dessin #innovation #AI #VR #IoT #startup Mes tweets n'engagent que moi. In❤️with #HK";39677;3159;4765;160528;208129
Pirouette15;Dom Barbarella;Adore les animaux, la nature, la lecture et la musique et déteste #Lepassnazitaire #UnionNazieEuropéenne et surtout #StopWEF #NiOubliNiPardon;47624;1897;2735;155652;207908
EcomnewsAfrique;ECOMNEWS AFRIQUE;@EcomnewsAfrique est le #média numérique d’information #économique en temps réel sur les pays d'#Afrique. #ECNAfrique @EcomnewsMedia @ecomnewsmed @ecom_news;32110;394;173360;1220;207084
melaniejoly;Mélanie Joly;Députée l M.P. Ahuntsic-Cartierville | Ministre des Affaires étrangères | Minister of Foreign Affairs;30810;2767;144415;28892;206884
QuibusL;quibus ð¢ð«ð·ð¨ð¦âð¼;;96086;1885;1335;106965;206271
lerepu;Le Républicain Lorrain;Chaque jour, l'actualité en images, en vidéos et en sons. Le Républicain Lorrain, plus forte diffusion de Lorraine. Un titre du Groupe EBRA.;168029;204;37340;494;206067
le_coq_hardi;Coq Hardiððª;;58591;424;651;146100;205766
MaximeTHEBAUL10;Maxime THEBAULT;"Histoire, politique, presse.
Reconquête!";82374;4122;6167;113060;205723
Aubin_Hellot;Aubin Hellot;"#Écoterroriste selon la définition de Darmanin. 
#Documentariste #Politique #Cinéma #Spiritualité #Colombia #Economie #Histoire et surtout #Nupes à donf.";87180;3203;3596;111686;205665
Ndiathiaar;ğ¸ğ³Ndiaga Yaaramğğ;Tripolaire et borderline. Les RT ne m'engagent pas.;68842;2279;2175;131366;204662
olivcim;Olivier Cimeliere;Made in @CELSA_Officiel - Plume, #Dircom, #journaliste, tjs blogueur - #SocialMedia #influence #Communication #Foot #ComPol #Climat #ComdeCrise #Actualites;111402;1845;18379;72022;203648
Phineas_Barnum;Phineas_Barnum;"J'apprécie l'interaction informative [& contradictoire] #durftevragen
#oupas, passe ton chemin";192516;1688;2640;6788;203632
jerome_clam;Jérôme CLAM;;197918;5007;265;3;203193
Soanange;AmTh;­čçź­čçĚ­ŁôŁ­ŁôŞ ­ŁôĽ­Łô¬­ŁôŻ­Łô«. ­ŁôŤ­Łô«­Łô╝ ­Łô╣­ŁôÁ­Łôż­Łô╝ ­Łô▓­ŁôĚ­ŁôŻ­ŁôŞ­ŁôÁ├ę­Łô╗­Łô¬­ŁôĚ­ŁôŻ­Łô╝ ­ŁôĚ­Łô« ­Łô╝­ŁôŞ­ŁôĚ­ŁôŻ ­Łô╣­Łô¬­Łô╝ ­ŁôČ­Łô«­Łôż­Łöü ­Łô║­Łôż­Łô« ­ŁôÁ'­ŁôŞ­ŁôĚ ­ŁôČ­Łô╗­ŁôŞ­Łô▓­ŁôŻ.;87185;5574;6090;103813;202662
Meli_Positive;Petit Bout de Locksée;Méli👸🏼| ❤️💚🖤 | Étudiante en communication 👽| @meli_positive📷 | @madras_en_folie🩴|;131506;1088;6885;63046;202525
tb6sud;Tom Tom;"Un dyspraxique qui aime commenter l'actualité.
Fan de sports, de politiques, d'histoire géographie de Jv et d'animaux.
#Secrweet23";45916;1596;838;154124;202474
Iznogoud1984;Iznogoud @iznogoud@shelter.moe đđđđ;MariĂ© Ă  @EvilGuimauve, romantique contemplatif et planificateur machiavĂ©lique. Fan de bonne politique (amĂ©ricaine et franĂ§aise) et autres oeuvres de fiction.;170982;99;92;31077;202250
SergeOrru;Serge Orru;environnementaliste joyeux ! Militant de l’économie légère, l’économie sobre au plus faible impact sur le climat , la biodiversité et notre santé.;45433;2130;6953;147533;202049
AnneFroment;AnneF;;30967;834;761;169330;201892
maestro_dinho;Wize.dom;ð­,ð, ð¨ð¬ ð¨ð©;15056;257;226;186254;201793
Alexa2B74;Alexª-2B;⛔️blocage Antivax, AntiScience, FN, LFI, religions ▶️ Zéro croyance 👉 nitter.net/alexa2b74/status…;59226;1982;1558;138870;201636
pascal_mulegwa;Pascal Mulegwa;Journaliste, Correspondant @RFI et @FRANCE24 en RDCđšđ©| ancien  @jeune_afrique @TV5MONDE @Medi1radio ... passĂ© par @ESJLILLE |Ăpoux et PĂšre|;30635;998;157974;11653;201260
RauxJF;JF Raux - Les questions qui dérangent…;Ex- DG de l’UFE (Union Française de l’Electricité) - Connaisseur de l’histoire économique et industrielle de l’électricité. Stop mensonges sur ces sujets.;130446;1869;5952;62933;201200
KimKimuntu;Paulette Kimuntu Kim;;87918;19235;85359;8660;201172
Papillon787Cr;SPARTACUS;"""Avant de demander ce que le pays peut faire pour vous demandez vous ce que vous pouvez faire pour lui"" RT n'est pas toujours approuverūüėČ";88039;2223;919;109231;200412
Thomas_Auriel;Thomas, The French;"La maison brûle et on se préoccupe de la couleur de la lance à eau.
On est très bon pour réduire le confort des autres.

@ThomasAu@mastodon.xyz";47516;1087;3407;147703;199713
profbzh29;petitprofencolere/Bruno LE COZ ð¢ ðºð³;HarcÃ¨lement moral,1Â° cause de suicide chez les profs. Ãducation nationale, administration gÃ©rÃ©e par des criminels.#PasDeVague @petitprofencolere@mamot.fr #NUPES;117933;3560;6102;72106;199701
JadixSainou;𝐌𝐞𝐥𝐥𝐨𝐰;Consultant - Environnementaliste - Animateur Territorial chez @sgdsbenin #RMFC;55947;468;739;142335;199489
baleke_gedeon;Gedeon Baleke 🇨🇩;Activist ,Political and Diplomatic Analyst .Patriot ,Proud African 🇨🇩.Substantiated by God and my technocrat of Father who taught me to never honour nonsense.;35071;857;3455;160000;199383
pnudfr;ONU Développement;Engagé avec nos partenaires pour lutter contre la pauvreté, les inégalités, la crise climatique et atteindre les #ODD. Suivez @ASteiner & undp.org/french;25720;1073;163262;9106;199161
RDUPONT21;CAMILLE;;82042;1080;1072;114829;199023
ECA_OFFICIAL;ECA;The UN Economic Commission for Africa (ECA) is headquartered in Addis Ababa with offices in Dakar, Kigali, Lusaka, Niamey, Rabat & Yaounde. IDEAS to ACTION.;36373;1985;137912;22723;198993
Willem_Dia;աɨʟʟɛʍ ɖɨǟɮǟȶɛ 𓅓;Futur milliardaire;66728;5003;1746;125339;198816
troll_russe;Troll russe;"#QuilsRetournentEnAfrique 

Jamais testé, jamais ""vacciné"".

t.me/Troll_russe

Elon Musk, give me back my 5600 followers, please : @Pierre_1er";97604;993;2790;97267;198654
AFD_France;Agence Française de #Développement (AFD) 🇫🇷 🇪🇺;Nous sommes la plus ancienne banque de développement au monde et engagés pour un #MondeEnCommun #SDGs #ODD @AFD_en @AFD_es | DG @RiouxRemy;37840;2258;125236;33270;198604
otta_daniel;daniel_otta Liberté, Egalité, Fraternité, Laïcité;"Alpha A5 connue, pas une autorité mais elle connaissait tout les bus et d'où on venait et allait, EX-GA, ex-GM, GD
#TEAMPANDORE 🏴󠁧󠁢󠁳󠁣󠁴󠁿 🏴󠁧󠁢󠁷󠁬󠁳󠁿";121819;5006;811;70089;197725
Clouchicloucha;Clouchicloucha #NoFakeScience;Français, Européen, libéral, social, pragmatique, entrepreneur. Pense que la richesse passe par l'épanouissement, le travail et la liberté.;107364;251;557;89164;197336
VLequertier;Vincent Lequertier;30 ans à analyser la conjoncture économique et financière afin de bonifier les capitaux qui me sont confiés. Gérant de fonds diversifiés internationaux.;72564;894;9824;113819;197101
auroreoliveiii1;aurore;ð0 vax ð;113371;687;683;82267;197008
LucNAROLLES;Luc NAROLLES Journaliste - Surligneur de Talents !;JAF-info | l'info pour les pros ! - Editions Média-Talents - #Jardinerie #Animalerie #Fleuriste - Mes activités perso sur twitter @LNarolles;191058;2854;1897;997;196806
fredhermelin;Frédéric Hermelin 🎬;"Head of Communication @linagora
Frenchyentrepreneur.com Editor | @Frenchweb @Forbes_Fr Contributor | #Innovation ♥️ #FrenchTech #TeamOM 🇨🇵 🇪🇺 🌍";179620;308;7202;9616;196746
PublicEnem_y;Festé_94 💥💥💥;Les egos gagnent des followers, les vrais gagnent le respect dans ce monde de #PouletsSansTêtes®™📍Chaîne YouTube 🗣🎙 piped.video/@Comprendrelepoq…;90581;4662;5667;95714;196624
KalemiMatilda;Matilda Croft;Sans-dent de sagesse.;33624;2420;4133;156336;196513
PatriceRoyTJ;Patrice Roy;Chef d'antenne 17h RDI, TJ18h Radio-Canada, spéciales politiques et ...papa .;23831;692;170873;1037;196433
euronewsfr;euronews en français;Notre mission : donner à chacun la capacité de se forger sa propre opinion en proposant une grande diversité de points de vue. #AllViews;115030;248;80989;105;196372
AnnaDi_Mario;Anna Di Mario 🇪🇺;Amateur EU watcher. Intermittently on Twitter and elsewhere.  Trolls are muted, haters are blocked.;156159;1566;5677;31511;194913
PierreKharmaz;Pierre Kð±;Techno-Innovation-Sciences #IngÃ©nieur - #ESTP - Free Â« Homme libre, toujours tu chÃ©riras la mer ! Â» DDHC 1789 - LibÃ©ral convaincu. Twitter account are mine.;15824;4882;2114;172001;194821
TUNumerique;Tunisie Numérique;Tunisie Numérique : La Tunisie à l'ère de la Démocratie;92772;10;102021;1;194804
SupBenji63;SuperBenji63 - TERFs hate account;"#LGBTQIAPKð³ï¸âð
#BlackLivesMatter";70984;950;787;121916;194637
AsterNyhavnsman;Capitaine-Camarade Nyhavnsmann contre Manu Macs;Esther — ✝️ — 🇫🇷 Camarade française & capitaine communarde 🚩 — ⚒️ Socialiste libertaire 🏴 — 🛤️ Fana de trains & urbanisme 🌃 — 🛣️ SCH fangirl 🏴‍☠️;30073;270;455;163819;194617
DailyDigital;Daily Digital;Media d’information en continu de référence pour les professionnels du #numérique. #TransfoNum ⎜#innovation ⎜#RH ⎜#startup ⎜#Data ⎜#IA ⎜#FinTech;173805;3347;13278;4004;194434
Catcat66Catcat;Catcat;Geekette mais pas que.Passionnée de littérature, musique en tout genre,cinéphile, et passionnée de #Goldmaking sur #WoW;92505;2396;985;97966;193852
tamuke06;Bel Ami;the Art of Peace. #FreeLebanon ð±ð§- @Nouv_Energie ð«ð·. LibertÃ©, ResponsabilitÃ©, LaÃ¯citÃ©. Â«Â Si un espoir est permis, tous les espoirs sont permisÂ Â»;56929;1000;3671;131830;193430
FlayDeni;Telma&Louise;"“

La première victime d'une guerre, c'est la vérité. Rudyard Kipling.";39740;549;4414;148628;193331
Rob__EDELJI;Rob edoph'  EDELJI;"Sciences de l'information-communication, #échecs #chess . 
Quand l'Imbécile montre la Lune, le Sage regarde le doigt.
Mécanique des fluides monétaires.";124696;3155;761;64586;193198
Small_Hawkeye;Little Simz Stan Account. 🧋;| Amoureux de cinéma, musique, photographie, de l'amour, de la vie, de l'Univers | RnB Lover | Potterhead | INFJ-A | 🎬 Letterboxd : smallhawkeye #HawkeyeCiné;93453;632;706;97074;191865
pier2kan;Pierre Dekan ðºð¦;Notre Ã©poque est marquÃ©e par le recul sans prÃ©cÃ©dent dâun des principaux hÃ©ritages des LumiÃ¨res : la vÃ©ritÃ© en tant que pilier moral et politique.(Eva Illouz);157459;1362;2669;30366;191856
TheDarkPixel;OlivierðDassonville;Digital Jedi, #socialmedia manager, digital #mediastrategist, #gamer, pilot #fpv Social Jedi for @web2day & @lesMachinesNtes.;173657;4064;5562;7687;190970
diasporasahraui;Diaspora Saharaui;À la quête de cette vėrite qui se trouve au fond de chacun de nous.;101921;40046;40367;8293;190627
LydiaMattio;Lydia la Rebelle;je ne réponds pas aux messages privés, je ne cherche personne, j'ai ce qu'il faut dans ma vie. je vis avec passion mes émotions.....;94810;2848;1606;91023;190287
GuyotVincent02;GUYOT Vincent;#céréalier dans le nord de l'#Aisne, #betteraves, #pois, #colza. Expérimentateur en techniques alternatives et non labour. #FrAgTw @passioncereales @Agridemain;48160;2252;20770;118897;190079
fred_mrs;frederique richard;"#STOPDUBLIN  
Plus on applique le règlement Dublin,
moins on respecte le droit d'asile
piped.video/f4mCR1N5HCQ
#RefugeesWelcome";47777;1379;1362;139126;189644
djodePrynckio;ஜோ De Prynckio☢️ 💪🏾 👨‍👩‍👧‍👦🦸‍♂️♿💜💛;"leader #teamchoupi.
mes dm, c'est le bureau de la #bienveillance. Le courage d'être joyeux malgré les épreuves est en chacun de nous. @HBCNantes💛 💜";97928;905;2790;87985;189608
GlissantBot;GlissantBot;This is an artwork by The Otolith Group based on the work of the great Edouard Glissant. Glissantbot is technopoetic being constantly creating quotes.;186507;56;2680;13;189256
ChtThomas;el Tooms;« In another life, I would have really liked just doing laundry and taxes with you. » /// Médaillé en chocolat @_nostroblog ///;101775;4898;1342;81145;189160
HarjitSajjan;Harjit Sajjan;MP for Vancouver South. ð¨ð¦ Minister of International Development and @PacifiCanEN / Ministre du DÃ©veloppement international et de @PacifiCanFR. He/Him/Il/Lui;16000;1228;164480;6917;188625
225Kgst;­čîâBruce Wayne­čîâ;"­čçĘ­čç«1m93­čçĘ­čç«
Psycho Pass Fan Account";102660;363;446;84601;188070
P_TARISSI;Pierre TARISSI ن;"Vice président Formation Industrie @AM_Alumni
---
@ArtsetMetiers_ @ESSEC
71 ans, marié
#Corse #Recherche #Industrie #BusinessAngel
facebook.com/pierre.tarissi";140513;13307;12857;21271;187948
HVaucher;đź‡¨đź‡µ Jacquhenryđź‡¨đź‡µ;Bonjour đź‡¨đź‡µ@MarionMarechal đź‡¨đź‡µ#RECONQUĂŠTE đź‡¨đź‡µ#Jambonbeurre đź‡şđź‡˛@elonmuskđź‡şđź‡¸  đź‡¨đź‡µ@ZemmourEricđź‡¨đź‡µ  Suivi par @JeanMessihađź‡«đź‡·  AdhĂ©rent ReconquĂŞte nÂ° 144450;91692;7074;7023;82100;187889
Esban_;Esteban. Ⓐ;"J'ai pas fait d'études, j'emmerde tes politiques, j'ai pas fait HEC
J'ai pas b'soin d'ça pour m'exprimer quand j'vois des pauvres sur la chaussée";46227;387;11453;129632;187699
NtareHouse;Ntare Rushatsi House;Bienvenue sur le compte officiel de la Présidence de la République du #Burundi.;5633;9;181959;29;187630
Corse_Matin;Corse-Matin;Corse-Matin, le quotidien de la Corse. Toute l'information de votre région : actualité, sports, économie, politique, culture... corsematin.com;94176;334;91922;1186;187618
laudemare;batlau;;42071;3664;1169;140204;187108
Salex_01;Salex 🇺🇦;Le politicien pense à la prochaine élection, l'homme d'État à la prochaine génération - Ingé informatique (+M. Sc.) - 🤦‍♂️;42705;369;414;143390;186878
DoleVeronique;Dolé Véronique;;42517;2302;1683;140229;186731
Hugo_Lz;˗ˏˋ Hugo Lpz 羅禹國 ˎˊ˗ 🇺🇦;⌬ Multidisciplinary, #Sciences #MOOC #JS #D3js, #Chinese, Foreign relation. Previously: @CRIparis, @Wikiatlas, @Mapotempo, @INALCO 🇺🇦;67856;864;1214;116792;186726
cashinvestigati;CASH INVESTIGATION;Enquêtes sur le monde merveilleux des affaires. Incarnées par @EliseLucet, diffusées sur France 2. Une production @PLTVfilms. 📺➡️ #CashInvestigation;2921;154;182849;621;186545
pthibaut;Pascal Thibaut;"Correspondant de Radio France Internationale en Allemagne. Gazouillis privés 
Ma newsletter : lettredallemagne.kessel.medi…";43315;71152;67897;3525;185889
TristanKamin;Tristan Kamin;"Ingénieur sûreté nucléaire ☢️
Tuons le « nucléaire honteux ». 
Le pourcent (%) n'est pas une grandeur physique.
Lisez les réponses avant de répondre T_T.";125976;598;58474;573;185621
memoristic;Pierre Ristic đ»đ đ;"Rural, je fais de l'Ă©cologie et du numĂ©rique âą Bosse dans l'obsolescence logicielle âą VĂ©gĂ©tarien et Ă©co bagnolard âą đ» Team La Force đ @eelv âą
Smrt faĆĄizmu âđŒ";155514;957;4522;24602;185595
myricau;Myriam CAU;« Qui aurait pu prédire la crise climatique ? » N’importe qui avec un cerveau, depuis au moins 1990 « la démocratie française… quoi ? qu’est-ce ? » Urbaniste;119674;5933;5930;53598;185135
24matins;24matins.fr;Actu et info en direct. Nos autres comptes à suivre : @24matins_sport, @24matins_tech et @24matins_eco;178751;4;6106;24;184885
alwihdainfo;Alwihda Info;1er média #Tchad-ien d'informations. L'actualité internationale avec @alwihdainfo | في قلب الأخبار الدولية At the heart of international news;86444;21;97242;85;183792
Mateoc3364;Mathieu;citoyen lambda, aime la France, l'Europe aussi aime la démocratie avant tout.Pour s'exprimer librement il convient d'abord de laisser s'exprimer ses adversaires;30213;2084;967;150503;183767
PierreMorinQc;Pierre Morin đșđŠ âïž;Fier militant de la Coalition Avenir QuĂ©bec.;148056;819;3783;30944;183602
brunoboutteau;Bruno P. Boutteau;"Data scientist Université Marie Curie/MBA Paris-Sorbonne/Ing. Polytech Lille
My employer disowns my tweets.#quantumcomputing enthusiast";42582;269;259;139999;183109
DworaczekBendom;Dworaczek-Bendome;Journaliste indépendante, Fondatrice & Directrice de publication du site DB-NEWS. Communicante politique, spécialiste du Gabon.;159932;3334;9016;10169;182451
DoungaJohn;John Dounga;bonjour;52768;1204;1896;126531;182399
EdenVal1;Val Girardon;"#PraticienneFreinetðð #VoisinsDenfert ð¡ #JardiniÃ¨re ð©âð¾ð #AnimalEnVille ð¾      
                  Membre Bienfaitrice C.E.N.A.ð¶ Edenð«Easyð«Night&Pasha";57652;2246;942;121341;182181
michelhenrion;michel henrion;Lobby Award Web Leader. Journaliste. Accro à la com' comme d’autres au shopping…;101911;12206;24045;43598;181760
Jeff_Dup;­ŁĽü­ŁöŻ ­Łö╗­ŁĽŽ­ŁĽí­ŁĽŁ­ŁĽĺ­ŁĽč­ŁĽĽ;┬ź Hier vous n'├ętiez qu'une foule, vous ├¬tes un peuple aujourdÔÇÖhui ┬╗ - #Ard├Ęche;166519;1410;5485;8326;181740
_Askel;Axel Pillaud;Tweete Rugby đ et Politique â | Supporter du Stade Rochelais, donc champion d'Europe â­â­ | (Fier) militant Socialiste đč | AdhĂ©rent Ă  la @LDH_fr âïž |;87621;2528;5331;85911;181391
elliascott;Velaris, la cité des étoiles.;Tu me rappelles ce que le monde devrait être.. ce qu'il pourrait être, avait-elle dit à Chaol autrefois.;100175;574;3197;77203;181149
55Bellechasse;Bertrand SCHOLLER;Roseau face au système & chêne sur mes valeurs / J’utilise les mots pr dire les maux et les combattre / je connais mes cibles : lui, 1984 & Transhumanisme NIET;44268;8405;37119;90893;180685
StarmediaPhoto;F. SAINT- MARTIN;Photographe évènementiel , corse de souche, réunionnais de couche, royaliste, Orléaniste par hérédité et moqueur par vocation;156097;705;1756;21917;180475
latulipenoire31;đŠP.F.Ađšđ”âïž;"souverainistes. 

đšđ”đšđ”đšđ”đšđ”
Ă©crit l'histoire...l'honneur est dans la vĂ©ritĂ©.#NUISIBLES INFO . #justicepourlola.";27083;4026;3964;144955;180028
Ulr1kD;Ulrik Darnetz;;11049;248;181;168349;179827
ecomnewsmed;ECOMNEWSMED;L'actualité #économique, #politique et des #entreprises des pays de la #Méditerranée par @ecom_news. #UEMed @EcomnewsAfrique @EcomnewsMedia @ecom_news;80917;5179;88806;4906;179808
28minutes;28 minutes;#28min est le rendez-vous quotidien d'actualité sur @ARTEfr, du lundi au samedi dès 20h05. Retrouvez-nous aussi sur Facebook, Youtube et Instagram 👀 !;65907;2636;86310;24531;179384
jeannotdupeuple;c. jeannot;"UnionDsDroites;Non aux sanctionsUSA ctre lsFR=inflation;Non aux CandidatsPR/FEM/McKin;Non à UE/FEMproMigrants;non au toutNumérique(DavosMckinsey=Flicage,Blocage";73791;4985;3753;96822;179351
Pierranard;đ«đ·Pierre-Arnaud pionnier #ReconquĂȘte #Z2027;MĂąle blanc de plus de cinquante ans, je roule en Ă©norme SUV diesel.Boomer dans lâĂąme je ne pourrai ĂȘtre dĂ©construit que par une balle dans la tĂȘte.Multiphobe.;52227;11678;10916;104225;179046
SeleneSelene49;séléné;Ubi bene, ibi patria. ⵅⵯⵔⵉⴱⴳⴰ Corps des evocati. .Défense des animaux ,passionnée d’histoire .@Selene49@toot.cat # Résistance#soutien aux non vaccinés.;94622;1253;423;82704;179002
ademe;ADEME;Compte officiel de l'Agence de la Transition Écologique !;25912;9167;136739;7155;178973
voxjaen;Voxjaen;La vie, ce  n'est pas d'attendre que l'orage passe, c'est d'apprendre à danser sous la  pluie. - Sénèque;96794;1890;1943;78161;178788
neema_valerie;Valérie H.neema;"Coeur 
Brave 
Esprit";48541;1136;5816;122468;177961
oxfamfrance;Oxfam France;Oxfam est une ONG internationale qui mobilise le pouvoir citoyen contre la pauvreté #Climat #Inégalités #Solidarité #Humanitaire #LAffaireDuSiecle #LAffaireBNP;17704;1346;151686;6996;177732
LDameniste;Le Dameniste ☭;"Tandis que l'Etat existe, pas de liberté ; quand régnera la liberté, il n'y aura plus d'Etat 🚩✊";77341;28;681;99417;177467
ComteJeanine;Iv;;167892;2007;691;6863;177453
Euler0Math;Euler Math;Alpiniste ayant gravi Olympus Mons sur Mars, Plongeur ayant exploré l’océan sous-glacaire d’Europe, je ne suis qu’un Ignorant comme vous Tous.;113865;1010;1140;61214;177229
dobsky33;David Dobsky;A la recherche du thon perdu.;54688;15824;23096;83540;177148
skymarsha;Marshal;Communication et promotion, Que Dieu bénisse la RDC 🇨🇩;71519;4909;16113;84196;176737
PlateauCom;Plateau Mont-Royal;Le quotidien indépendant du Plateau. Si vous êtes sur le Plateau, dites-le à @PlateauCom. Un réseau+média de Bruno Boutot @boutotcom;140711;1775;3573;30434;176493
ibnmasouda;ibnmasouda;Si quelqu'un dit la vérité, donne-lui un cheval il en aura besoin pour s'enfuir. proverbe afghan.;83803;854;755;89820;175232
ArmandChalon;Chalon armand;De droite, ingénieur , carrière dans une entreprise internationale , suis engagé pour défendre notre culture, nos valeurs et redonner une ambition à la France.;107475;1085;1568;65079;175207
NACREspirale;Dr F Tétard Matr 1620 @nacrespirale@sciences.re;"Université Sorbonne Paris Nord Science et Génie des Matériaux IUT Saint Denis #ToujoursCharlie
orcid.org/0000-0003-3938…
@nacrespirale@sciences.re";113232;4536;3154;54026;174948
iwona46;🌟🌟🐳iwona 🇺🇦☮️✌🏻;You are not gone because you are always in my heart ‹Ragnar;128273;4126;1023;41315;174737
Catherinekat4;Catherine kat;Ma vie à commencé le jour ou j ai décidé de vivre ! ♥️ je vous souhaite le même éveil que j ai eu la chance d avoir . que la paix retrouve son chemin .;58164;16261;17803;82329;174557
chrisdabin;chris dabin;environnements;174065;199;198;22;174484
Chaos_Be;AJ Chaos (Lost in Transition);Divinité officielle du panthéon belge. Régule la vie politique, institutionnelle et socio-éco. #politics #economics #runner #INTP #Transgender 🏳️‍⚧️ she/her;108987;997;4263;60224;174471
drcasuallycruel;Dr Natalie 🧣🦀;👩‍⚕️• Christian • killing it at being a doctor ~ @taylorswift13, 15/6/18 • just too soft for all of it • worth so much more than a plane ~ my mum🍦She/her🍦;17353;1526;968;154591;174438
E_volution;Eric Eustache;"From 7 To 10 Billion People On EarthShip !
#Degrowth #equality #ClimateChange #Biodiversity #HumanRights";79624;7599;7863;79258;174344
mingus85;Mingus V ⚜️➕ 🔅;"Chercheur de cohérence.
Originaire des Lucs/Boulogne, plus grand charnier de France";40863;994;1008;131181;174046
Maiannah;ð¦­ð ð»Maiannah ð»ðð¬;"Ne trouvons plus d'excuses Ã  ceux qui n'en ont pas ð Amie des animaux,de la forÃªt,des OcÃ©ans et des ruisseaux ð¬
AESHco ULIS LycÃ©e pro. ð»";67366;1216;886;104567;174035
ArabNewsfr;Arab News French;Arab News en français est l’édition francophone du quotidien Arab News. facebook.com/ArabNewsfr, instagram.com/arabnewsfr et shorturl.at/hi;91512;83;82304;74;173973
dracobis;Draquoicoubeh đ;"22 yo | Turbogauchiste passionnĂ© de trains et d'informatique qui dĂ©teste la rĂ©ussite | FI hate account | PrivĂ© @minidracobis
@Draco'#2798";75331;718;2555;95165;173769
obraibant;₿itMoney™️ & Co. 🗽🇺🇸📜⚡️🇸🇻🌋🧑🏽‍💻🛰️💫;₿itcoin is freeing the 🌎 from the slavery of the Central Banks. We The People are making HISTORY...again! CBDC and centralized Digital ID are evil !;91808;1076;1414;79078;173376
fulei777;ian;;78459;1220;803;92568;173050
dominiqueouat;Dominique Ouattara;;4044;140;167782;593;172559
benoitm_mtl;⚜ Benoit Martin ⚜🚜🕊;"₵Ø₥₱ⱠØ₮ł₴₮Ɇ

je bloque tous les trolls 😉";67964;1915;10745;91792;172416
Izno91;Nieur33 🏴‍☠️⚛️;"Oeuf pensant.
Moussaillon du @PartiPirate";61393;438;698;109772;172301
yannigg;yanniggğ»ğºğ¦;"Ãcologie, recyclage et recherche en D3E
Chaine twitch twitch.tv/yannig93
tous-montreuil.fr";72956;3525;1776;93384;171641
IsaMadesclaire;Isabelle Madesclaire 2027_3;prof urbanisme IFU Paris8-Vincennes, retraitée, résistante et résiliente, Libye, Syrie, Droits Hm #Paris PLU #Paris14 Jardin des Franciscaines #CouventReille;166554;1808;1965;1297;171624
MarijkeF40;đź‡«đź‡· Froidthier;"PionniĂ¨re ReconquĂŞte! 
Boomeuse ""Ă©veillĂ©e""
Suivie par AndrĂ© Bercoff, for true and humane medecine,
Papanours
Pas de MP";62084;3105;1968;104433;171590
VRwatchingU;VRwatchingU;Insoumis.;115329;1361;2218;52594;171502
oAzzoo;AzOu;Paris instagram.com/oazoo75/;91399;598;16286;63156;171439
OFrancois60200;OlivierFrancois6020ن;Apparemment négative, puisqu'elle ne crée rien, LA RÉVOLTE est profondément positive puisqu'elle révèle ce qui, en l'homme, est toujours à défendre. Camus;144780;13242;12700;591;171313
aip_agencepress;AIP;Agence Ivoirienne de Presse;110434;72;60342;15;170863
ludovic_pouille;Ludovic Pouille;"حساب شخصي لسفير فرنسا لدى المملكة العربية السعودية

Compte personnel de l'ambassadeur de France en Arabie Saoudite

@FranceinKSA";43197;4552;64354;58756;170859
IdIHakima;Teymiyyah9.6;RH Manager,Auditor Jr,Responsable Finances du ROSC/BLT, #madritista…passionate de la lecture, du voyage,des mangas japonais,de la mode & lover of love🇷🇴❤️‍🩹.;54306;19265;30008;67139;170718
kereonnec;Adrien M ð¨âð¾ ð;"Ã©leveur ð,
vulgarisatÂ° productÂ° porcine
#BAbaducochon

circuits longs et courts

#AgriculteursDeBretagne
#emojibzh #FestNozeurðº
#CuisinierAmateurð¨âð³";26582;601;3766;139652;170601
ManYouTopie;Emmanuel Talayrach;Ils sauront [tu sauras] se frayer [tu sauras] un chemin [tu le sais]. 29029;139860;1307;1502;27911;170580
GerardRass;Gérard Rass 🇺🇦💔;Ecologue. Fan de la Nature sauvage. Donc pas écologiste. Humaniste donc pas collectiviste. Humain donc imparfait. LIBERTÉ d’abord;100160;3626;3382;63334;170502
superwomanIST;Claudieğ«ğâ¨ğ§;"Facilitatrice en bien-Ãªtre individuel
#ThÃ©rapeute #bienetre #lesenergiescestlavie
#eveilspirituel  (ancienne infirmiÃ¨re en reconversion/2eme compte)";61645;282;386;107979;170292
courrierouest;Courrier de l'Ouest;Suivez le fil d'actualité de courrierdelouest.fr;147016;725;21666;586;169993
tchadinfos;tchadinfos;Média de référence sur l'actualité tchadienne. Un décryptage sérieux et décalé offrant une radioscopie socio-économique et politique du Tchad.;39039;110;129748;1013;169910
grandosek;grandosek;;109048;2532;4258;53972;169810
MichaelMickha;michael Tavernier;prométhéen et libéral … autant dire complètement anachronique en France en 2023 😎… et très bougon;61615;2805;2217;102826;169463
HMarcault;Ze Herve Marcault;LIBÉRAL Arrêtons de confondre la Morale et la politique;57413;4610;1875;105405;169303
PatrickBry2;Patrick Bry;37 ans à Air France, 27 ans steward et photographe sous-marin , maintenant grand-père depuis 6 ans, passionné par l’histoire de l’art et plein d’autres choses.;35251;1458;1030;131538;169277
thomascorbet_mo;Thomas Corbet;Journaliste/interprète/traducteur (Midol, Rugbyrama, Tissot, Six Nations ltd, Westgate,...), auteur Drive Your Adventure Norvège et Portugal en van;56509;903;3815;107823;169050
GuillaumeQ1T1;Guillaume Quintin ð³ï¸âðð»;"ð»ð³ï¸âð Humaniste Universaliste Fils de Lutte @EspaceDesLuttes #EgalitÃ©LibertÃ©FraternitÃ© Sec Nal @lePG #SiamoTuttiAntifascisti
Mes tweets n'engagent que moi";93321;3934;20686;51100;169041
vbenard;XXC Benard;Fabriquant de threads (tous mes threads en lien) & membre du Complot Ultra Libéral - ingénieur désabusé et pessimiste.;128754;2972;11096;26194;169016
NilsVay;Nils Vay - 🔻🐢🇺🇦☮✌;"Sans cesse remonter le rocher du fond du ravin 
#NouvelleUnionPopulaireEcologiqueEtSociale
#AvenirEnCommun #LFI #NUPES";110546;1128;1290;55896;168860
IFCAfrica;IFC Africa;@IFC_org, a member of the @WorldBank Group, supports private sector growth, job creation, and poverty reduction in Africa.;12801;1659;150026;4209;168695
ana_anamddk;ana;Le temps met tout en lumière - THALÈS;57375;3554;14550;93214;168693
MatthieuGariel;Matthieu Gariel #СлаваУкраїні 🇺🇦🕊;électron libre, républicain, libéral et laïc 🕊️ • @Renaissance @pnc_france @voixdunucleaire ⚛️ • transport addict 🚇 • data scientist 👨‍💻;65549;7997;14158;80678;168382
FNarolles;François Narolles;"Créateur de métro, ex-marin, breton, parisien

Énergie, transports, défense, spatial, droit, et moult autres bidules.";46174;1451;7715;112638;167978
aurelien_veron;Aurélien Véron;Élu au Conseil de Paris | #ParisCentre | Porte parole @GpeChangerParis avec Rachida Dati | Liberté, liberté chérie 🇫🇷🇺🇦🇪🇺;78866;2369;19225;67420;167880
Madmoizelle;Madmoizelle;✨ La société s'écrit au féminin ✨;82077;1987;82432;1219;167715
Bombardier;Bombardier;"Leader in aviation, creating game-changing planes and supporting a worldwide fleet.
Crée des avions novateurs et offre du soutien à sa flotte mondiale.";8156;947;157000;1475;167578
un_pedago;ð¦ cl au;ex-Prof, aujourdâhui dans lâIT #ActualitÃ© / #Pedagogie / #Sport / Enseigne de temps en temps dans l'ESR / Centriste (6/10 sur l'axe G/D);126286;2451;3002;35826;167565
wangozi;Da Mamy;"Bachelor in Business Administration
Lecturer
Dr banque ""Caisse d'épargne"" Sartrouville Paris
Cand  Dep Prov. Kabambare. Insupporte l'injustice de la justice";51021;2262;4795;109418;167496
Maskloff;Serge Vincent;Acteur, syndicaliste.;120618;1958;13665;30885;167126
CdGournay;Chantal de Gournay;Quel bon pays est la France, à tous les escrocs, les aventuriers et les fripons! (Louis de Rouvroy);89446;2173;3462;71875;166956
Reporterre;Reporterre | Le média de l'écologie;"Média indépendant, en accès libre, sans publicité, à but non lucratif, dédié à l'urgence écologique. 
Financé exclusivement par les dons de ses lecteurs.";25478;334;140197;680;166689
hobidopy;♧flo⁷♧;"🪨                                 back to blue side                           🪨
                                                                       she/her";49934;279;245;116141;166599
Ikissdalife;Impertinent-Pertinent;"Donne son avis sur tout, surtout quand on ne le demande pas.
Syndiqué sudsolidairesroute.com/
Mastodon: pouet.chapril.org/@Impertine…";93712;4999;3994;63756;166461
NEOsourceFr;NÉO;"Nation Égalité Ordre /

L'ARN de la protéine SPIKE est rétro transcrit en ADN définitivement dans des cellules du foie in Vitro.
Pr Montagnier avait raison

 FB";113867;3433;2801;46175;166276
Yotogo_;Yotogo;“When I die I wanna be remembered for the life I lived, not the money I made.” - Avicii ◢◤ • 🇻🇳 • 🤍;19044;466;69;146692;166271
Vadeboncoeur_Al;Alain Vadeboncoeur MD;"Urgento @ICMtl
Prof titulaire @UMontreal
@Lactualite @luxediteur @Editions_Homme
@ECG_u @IPAM @IciSTAT @Noovo_Info
Opinions ici engagent moi et mon chat";60810;2099;77067;25782;165758
ChiliMosquito;Mosquito chili;;96990;795;802;67113;165700
StanMendy;Stanislas Mendy;Écolo / Scénariste / Footeux (@AS_Monaco mon amour) / Passionné par l'humain, l'histoire et la vie / Ni Bolchevisme, Ni Consumérisme / #Friconoclaste;85772;4997;2988;71862;165619
DrooBreizh;DrooBreizhðé¦æ¸¯ð­ð°ð¹ð¼;IntÃ©ressÃ©e par tout ce qui l'entoure.;60355;934;1002;102732;165023
B_Rouille;Benoît Rouillé;"Responsable Projets @InstitutElevage
#alimentation #vacheslaitières #coproduits #méthane #élevage #ceuxquifontlelait #FrAgTw #mestweetsnengagentquemoi";30366;2500;8420;123330;164616
Philippe_Echez;Philippe Thubé;res non verba;125705;472;548;37820;164545
FDragonfruit;Dragonfruit ð²ð«ðªðºðºð¦;"LibÃ©ral contre le populisme, l'antisÃ©mitisme, le racisme, le radicalisme religieux, l'homophobie, l'Ã©cologisme, l'ultralibÃ©ralisme.
IngÃ©nieur
Pro-science â¢";91411;1568;1193;70322;164494
GeneralNeva;SE Evariste Ndayishimiye;Président de la République du #Burundi (2020-2027).;948;15;163316;74;164353
atterres;Économistes Atterrés;De quoi avons-nous vraiment besoin ? - notre dernier ouvrage paru en octobre 2021 aux @editionsLLL : urlr.me/KhYPX;18897;994;142461;1853;164205
Politica_Econom;Política y Economía;“Nemo patriam quia magna est amat, sed quia sua”;143257;1;679;20199;164136
munegu_1427;氷輪 丸;Paul Mitchell hate account, mon club veut ma mort/ le SM Caen est le plus grand club de l'Ouest de la France ❤️💙;61939;458;867;100853;164117
clauer;@clauer;"""A force de vous comporter en moutons, vous finirez en côtelettes."" Créature d'Entreprise vénère. #motard #rocknroll #papiduweb";78958;6636;6050;72072;163716
Maxou_LaMenace;Maxou-Picsou;"joueur de tennis 🎾🎾
J'ai attendu des heures et j'attendrai encore des heures, jusqu'à ce que mon amour arrive et que mon coeur soit comblé";84749;3696;2908;72291;163644
RumeauMarc;Marc Rumeau;Relations internationales Politique Europe;74888;328;630;87592;163438
yjadot;Yannick Jadot;Ăcologiste đ«đ· đ» DĂ©putĂ© europĂ©en đȘđș;41636;1504;112193;7385;162718
rubycat24;Ruby C;Loving Mother and Grandmother. Mindfulness promoter. Terrified citizen of the World. đđą. please no private messages;89943;4132;2195;66235;162505
camillejourdain;Camille Jourdain;Consultant #InfluenceMarketing #SocialMedia, Membre @LaBrigadeDuWeb, Ambassadeur @Reech_com, Auteur @Editions_Kawa, Chez @Nowcoworking #Lille, Fan du #LOSC.;71924;5890;57070;27278;162162
GaetanEscorbiac;Gaëtan Escorbiac;"Candidat LFI pour les #européennes2019   
Conseiller du salarié CGT. 
Militant syndical, 213 jours de grève pour vivre dignement .
Aveyron 

#LGBT  🌈 #insoumis";76024;9853;18789;57345;162011
josly_ngoma;Josly Ngoma;Écrivain, entrepreneur et observateur de la vie politique en Afrique.;82078;2575;6762;70474;161889
gloiremurhigisi;Gloire Murhigisi;#Tech advocate | Consultant IT | @google ambassador | founder @JamboWorld | Dev | Google influencer | Content creator | I promote DRCongo 🇨🇩 | #EDUCATION;44495;785;7086;109486;161852
GNadeauDubois;Gabriel Nadeau-Dubois;Chef parlementaire et porte-parole de @QuebecSolidaire. Député de Gouin à l'Assemblée nationale du Québec.;20665;1942;134238;5001;161846
hyyhlel;سارة;muslim owned businesses support account;95566;218;2791;63220;161795
diopadou;L'homme Takanderð¸ð³;AgroÃ©conomiste - 2018 Mandela @WashFellowship - Ag-content curator & creator #AfriAgtiviste #SunuMbay #Fin4Ag #Youth & #Women in Ag Ewpowerment #SunuMbayTalk ð;83564;6519;15296;56363;161742
Yonaa_Ao;Yona;Il suffit que je te regarde pour que ça revienne. Il suffit que je te regarde dans les yeux et je me sou… Je me sens chez moi. #TeamPSG ❤️💙 #Infirmière 💉;102740;492;2948;55456;161636
RL_Patriote;Roland;Homme Politique. Génération Consciente du Congo Kinshasa. Devise: Valeurs, Constance et Convictions.;74244;17372;20403;49468;161487
MTL_AL7;A.;"@ChelseaFC
@HAC_Foot
đ«đ·đšđŠđ·đȘ
ProlĂ©taire bien payĂ©.";39527;101;218;121030;160876
Patria_Ca;Boubou;"Quand nous perdons le droit d'être différent, nous perdons le privilège d'être libre
Charles Evans Hugues";68423;1976;1053;89192;160644
LaCryptoMonnai1;La Crypto Monnaie;Tout l'univers des crypto monnaies, de la blockchain à la DeFi (finance décentralisée) en passant par les exchanges et autres acteurs majeurs.;157030;129;3041;39;160239
CamerounWeb;CamerounWeb;L'actualité du #Cameroun traitée en priorité.;149947;585;9000;236;159768
maitrerenard31;Maître Renard ⓩ;Physicien, docteur de l'Université de Toulouse Modélisation - Micro/Nano systèmes Adhérent de Reconquête - #Z0ZZ Compte de secours : @maitrerenard32;43162;8124;7719;100623;159628
AuxComtesse;la comtesse aux pieds nus;Miscellanea ✨ Curated by a commoner but who cares, it’s Twitter {own pics unless famous or specified or… }   Mastodon : @lacomtesseauxpiedsnus@piaille.fr;48369;2821;8263;100154;159607
ManonAubryFr;Manon Aubry;"PrÃ©sidente groupe de la gauche au Parlement ðªðºâ¢ EurodÃ©putÃ©e LFI-NUPES
Ex porte-parole  d'une ONG contre les inÃ©galitÃ©s & l'Ã©vasion fiscaleâ¢ Toujours activiste";21287;2592;124524;10958;159361
Quatuux;🇺🇦 Quatux 🇺🇦;"Entrepreneur |

🧑‍🔬 science rules the world 🧑‍🔬 |

Slava Ukraini | 

➡️ @arpac_fr ⬅️";26957;1727;231;130403;159318
L1413_;L1413 — Prof d’info STI2D — Leucémique Pfizer💉⁵;"🍓🍓🍓🍓🍓

Ministre de l’Éducation de #TLB ;
Retweeteur compulsif ; 
Vulgarisateur médical en leucémie aigüe.

Mastodon : @L1413_@pouet.chapril.org";44161;1343;627;113078;159209
bonrevons;ETROPAL;ðªðº;44072;661;764;113527;159024
LeVif;Le Vif;Actualité, analyses, opinions et journalisme d’investigation. Soyez malins, osez douter.;81602;24;77098;138;158862
BVoltaire;Boulevard Voltaire;Le quotidien de la đź‡«đź‡· droite et fiĂ¨re !đź“±100% digital, 100% indĂ©pendant. S'abonner Ă  la newsletter : urlz.fr/lpDH | Nos rĂ©seaux : urlz.fr/lpDK;73040;117;84118;1391;158666
fch29421033;fch;ð  IntÃ¨gre âï¸;117594;1381;795;38878;158648
Sochichusi;Shoch⁷🪻FESTA;after all the hardships ⁷ | Mitski cult | single handedly manifested an NF tour | read carrd byf;47891;387;390;109870;158538
mathieugallard;mathieu gallard;"Research director @IpsosFrance

ð³ï¸ð®ð³ð®ð¹ðð³ï¸âðð²ð«ð·ðªð¹ð¿ðºð¸";76654;4581;32651;44629;158515
MagazineCapital;Capital;Le plaisir de comprendre l'économie : enquêtes, immo, votre argent...;78400;1267;78514;185;158366
objectifgard;ObjectifGard;Toute l'actualité du Gard en temps réel : politique, économie, vie en société, culture, sport, Nîmes Olympique, pharmacies de garde, les sorties, ...;129157;6875;17450;4813;158295
bazouzabou;bazou;"""L'humour est la forme la plus saine de lucidité"" Jacques Brel";107789;204;951;49254;158198
Christerak;Houmous Addict;"J'aime les chats.
Mastodon : @christerak@piaille.fr";33316;1061;366;123445;158188
jgalt485;John Galt ⓩ 🇫🇷 cpt secours JohnGalt1 🇳🇱;Dans la vie de chaque homme, il y a un événement qui le détermine tout entier, détermine aussi bien son destin que ses convictions et ses passions (Soljenitsyne;73719;3475;8644;72190;158028
VioletGael;Gaël Violet, Snowflakus Invictus;"Fournisseur en factoïds semi-inutiles en demi-gros et détail, maison fondée en 1974.

Rédacteur sur le blog Zet-éthique Métacritique, là: zet-ethique.fr";45083;724;2387;109741;157935
la1ere;La1ère.fr;Le portail des Outre-mer LIVE 24H/7 • Informer • Interagir • Engager #outremerla1ere un univers à partager sur la1ere.francetvinfo.fr;69830;1582;84962;1468;157842
Antoine0667Best;TonyTruand;Apolitique Bloqué par @RokhayaDiallo @edwyplenel @T_Bouhafs @davduf 🤗 Protestant athée Massive Attack @MassiveAttackUK addiction;112119;331;356;44985;157791
vinceakadiego;FRANCE GAZOUILLE;Député des Français de l'Internet. Ministre du Mot-Dièse. Boss de lui tout seul.;143046;1359;6952;6341;157698
laydgeur;laydgeur;"""Nous y sommes enfin... La grande bataille de notre temps"" — Gandalf le Blanc, après avoir lu le rapport du GIEC // #QuizzEnergieClimat = une question par jour";59598;1634;35900;60393;157525
falias503;Fred;je veux être libre de mes cotisations chômage et retraites. je refuse de participer à la gabegie et supporter tout les cas sociaux cultivés par l'état socialist;124195;915;1022;31260;157392
SartheInfos;Sarthe Infos;Compte qui publie toutes les informations concernant la Sarthe.;154378;422;2427;119;157346
Fred_Connect;Frédéric_Connect;;68587;3380;907;84167;157041
CBeaune;Clement Beaune;Ministre délégué chargé des Transports 🇫🇷🇪🇺 / Député élu de la 7ème circonscription de Paris / Secrétaire général délégué de @Renaissance pour l’Europe;8671;7125;121618;19457;156871
NicoVedrines;Nicolas Védrines;Discours APOCALYPTIQUES sur la pop générale versus SYNDEMIE: « seuls 2,2% des décédés ne présentaient pas de comorbidité et étaient âgés de - de 65 ans. »;14534;3944;8026;130293;156797
GabrielAttal;Gabriel Attal;Ministre délégué aux comptes publics #budget / Conseiller municipal de #Vanves;3764;987;148327;3601;156679
epelboin;Fabrice Epelboin;Creative technologist, serial entrepreneur, teacher #infowar #cyberwar #geopo (ex CELSA, ScPo Paris, IAE Poitiers), Stephen Colbert wannabe. #Team @_Reflets_;105988;5740;31419;13472;156619
djzentao;david zentao;#paradisfiscaux #alternatives #newtech #Ă©cologie flipboard.com/@davidzentao @psyartpsychill #ipadmusic #sciences t.me/anticovruption đź––;139013;4902;1439;11130;156484
pcabrera;El Mostacho Inkómodo.;Se acercan las vacaciones.;142329;297;4229;9608;156463
Shemuel__;Rose of Sharon 🌹🥀🇬🇳🇨🇩;La seule prédication que nous prêchons est Jésus-Christ mort et ressuscité 🙏🏿✨;89515;960;3705;62015;156195
jdavidsonchaput;J Davidson-Chaput;"And I don't know much, But I do know this,
With a golden heart, Comes a rebel fist,
And I can't help agreeing,
With those that would not quit.
-Streetlight";53504;3345;1104;98131;156084
_Hicham_ch;𝑯𝒊𝒄𝒉𝒂𝒎 🦍☤;🇩🇿« Et supporte patiemment la décision de ton Seigneur. Car en vérité, tu es sous Nos yeux» 50.v48, néo D1 à P5 👨🏽‍⚕️;87587;573;3904;63799;155863
MarieMarysienka;Marysieńka;"Auteure . Fiche signalétique :
Détails futiles sur ma petite personne.
Oser c'est l'espérance qui prend vie !";100860;1288;2316;51284;155748
MiddleEastEyeFr;Middle East Eye Fr;Actualités, analyses et opinions sur le Moyen-Orient et l'Afrique du Nord;127173;411;27837;125;155546
DeconinckJason;Deconinck Jason;;35499;1920;1421;116561;155401
braco001;Cecile Braconnier;Documentaliste, passionnée de nouvelles technologies et curieuse de tout;151926;1906;752;669;155253
villecannes;Cannes;Compte officiel de la Ville de Cannes ☀️🌴;52878;1004;52826;48353;155061
RFImag;RFI – Mag;Actualité, débats, santé, culture, sports, tous les programmes et podcasts de @RFI , c'est ici !;103545;293;49356;1850;155044
PompiersFR;Pompiers de France;L'actualité des 252.700 @PompiersFR et de la Fédération nationale des sapeurs-#pompiers de France (#FNSPF) 🚒🇫🇷 En cas d'urgence, ✆112 ou ✆18.;17073;992;109944;26682;154691
JMaillefort;ici pour le sang;disney channel ass niggas;21823;451;154;132196;154624
FBerdougo;François Berdougo 🦄🐻✌️;Quelque part dans la santé publique. Tweets perso. @MdM_France @ADMDFRANCE #VIH #sida #droitsdesmalades #travaildusexe #drogues #findevie #droitshumains;29989;2359;3614;118623;154585
Ellikya;Che Guevara MAGUFULIFICATION;Activiste Panafricain DIOPIEN đšđ©  @KoPAX_Officiel @CdAlternative @stemdrc;50642;698;1678;101427;154445
vellaviens;Dominique;"Ni LFI ni RN, blocage fréquents des jean aymar et autre jean peuplu.
Pas de DM";45744;826;747;107124;154441
frdossant;François Dos Santos;Salarié dans le secteur de l'énergie. Je cause #énergie, #RH, #social et parfois d’autres choses. Mes propos n'engagent que ma binette;38519;2167;10407;103090;154183
SZinguer;Slim Zinguer ð³ðª;#il vaut mieux vivre dans la pauvretÃ© avec dignitÃ© que d'Ãªtre riche sans dignitÃ©. Cherchons le savoir car seul le savoir fera de nous des hommes libres ðªðªðª.;41565;5491;12349;94679;154084
Virgil91130;Virgil 🇷🇴;📍91’🇷🇴 • @MercedesAMG 🇩🇪;22418;368;452;130645;153883
ashiyka;ð;Plaisir Ã©phÃ©mÃ¨re pour regret Ã©ternel | tulip girl ð·& Cat loveuse ðââ¬ | sleeping talent;43219;323;387;109892;153821
TomasHelleberg;Vanliga Tomas;"Don't argue on Twitter, they will never listen.

Blablabla is not an option.
Civilingenjör Arkitektur & Stadsbyggnad.";128122;1279;1351;22669;153421
sarahlefenek;Yo;twittos pro Sahara marocain;54201;1803;2477;94768;153249
FPlaie;Fer Plaie;"Aiguille pour la suture ou lame pour trancher c' est selon... 
In vino veritas  , ou dans la bouche des enfants.
đšđ”";91059;4661;1070;56312;153102
LostElision;Lelision;;152727;133;65;121;153046
rezo_nodwes;RezoNòdwès;Média citoyen;52572;3246;75008;21937;152763
RemDumDum;DumDum #NeRienLaisserPasser;CultivActeur Beauceron, recherche d'une Agriculture Durable sans tabou avec les Nouvelles Technologies, d'une Biodiversité utile et dynamique,...Bordel #FrAgTw;105011;657;12608;34288;152564
Frdouce1;🐟💤🇨🇵j'aime ma France 🇨🇵 💤🐟;Ras le bol de Macron;56110;9774;9174;77499;152557
argotheme;POPULI-SCOOP;#Infos locales & pertinentes d'époque, #cyberpresse fondé en 2006 par @23Tatem. Pour récits & narrations de faits #alternatifs niés par les #médias dominants.;149768;951;1193;561;152473
marcomendicino;Marco Mendicino;MP for Eglinton-Lawrence and Canada’s Minister of Public Safety | Deputé d’Eglinton-Lawrence et Ministre de la Sécurité publique 🇨🇦;14045;984;117070;20281;152380
FakamionKamion;F.K;Expertise en évaluation & conformité environnementale, Développement durable, Agroenvironnement, Mobilisation et participation citoyenne.;45221;5627;30419;70954;152221
Bonanza732;NanabozoRF;"Respect the nations, stop illegal immigration and the expansion of all religions. 
Don't defend those sects which take advantage of human credulity.";28342;398;560;122918;152218
Mycho;Mylène Colmar;Co-fondatrice @foodileslemag · Editrice @TFACaribbean · Caribbean blogger @lbdemc · Journaliste;60437;943;8953;81805;152138
ireneacelor;christine Acelor;;29673;1497;769;120100;152039
Xeno_GOODENOUGH;#MacronOrdure ð£;"Politique, shitpost et spatial ð¦º ð´ð©ðªðºâ 
Pessimisme de la raison, optimisme de la volontÃ© ð«¡
TroposphÃ¨re enjoyer ð
Secondaire = @DeGoodenough1";45962;940;5744;99275;151921
princertitude;Princertitude;Sciences & Techniques. Energies.;96475;669;22610;32109;151863
HansEichbaum;ð®ð© @hans ð¾;"InsurgÃ© paisible, fÃ©liniste, propagandhiste, Â«Je kleiner, desto besser.Â» Î Î¬Î½ÏÎ± á¿¥Îµá¿ ð ð´ââ ï¸ðâµ£ #Alsace #CUEJ
ð : framapiaf.org/@hans - @hans-:matrix.org";82557;983;2673;65595;151808
AEffondrement;Après l'Effondrement;"🟢 #Twitter : Écologie et Politique 🌱
⚫️ #YouTube : Réflexions sur les théories d'effondrements 🗿
⚪️ #Instagram : C'est quoi une vie « bas-carbone » ⚙️";33485;615;33382;84301;151783
RabineDesBois;Nouchka75 ✌️;"y'en a qui font bien, moi j'déconne
pas réussi à traverser la rue

#NUPES

Fachos s'abstenir, merci (#LREM #LR #RN et #Zobistes)";66306;414;238;84707;151665
NBDSkohellNM;Lix 💞❄;She'd laughed, and if he could have bottled the sound and gotten drunk on it every night, he would have. It terrified him;25835;319;57;124985;151196
ViauAlexandre2;Viau Alexandre 🦆;Pilote du samedi, Militaire du dimanche, Ingénieur quand il le faut. Dr400 qui veut être un Fouga Magister. S’emploie à être un as du volant.;34310;1684;1285;113833;151112
lautzig;lautzig;@Lautzig@mastodon.world;79004;784;433;70844;151065
OLecointe;Olivier Lecointe;Sic transit stupor mundi. Aime Brautigan, Toussaint, Echenoz et les huîtres;65659;985;1952;82290;150886
montreal_girl;Woman in tech against the woke ideology;"“Victimism uses the ideology of concern for victims to gain political or economic or spiritual power.”
― René Girard";61323;424;4665;84379;150791
bouisset60;Dominguez Brigitte;;23177;1372;440;125759;150748
neve_2017;Evelyne Dromer;@GenerationsMvt @generation_GPgx @GnrationsSant1 «Je sais d’où je viens et pourquoi je me bats » Collectifs Bosnie pendant la guerre Francis Jeanson;64948;3498;1395;80674;150515
Sunandlaw;ℕ;.;109462;1021;1960;38012;150455
reseaucitadelle;Cyrus Sibert;"Journalist / Research and Consulting. (Follows/RT/MT/LIKE do not mean endorsement.)
marquistopartists.com/2022/0…";60843;4254;55002;30309;150408
jamaislu;Jacques Morissette;"Tant qu'il y a de la vie , il y a de l'espoir! et Il y a toujours un coté positif ;)";143440;1628;4453;852;150373
MoDem;MoDem;Compte du Mouvement Démocrate, parti présidé par François @Bayrou;47988;6999;73414;21775;150176
CharlieBismuth;＼Ｏ／;Cyber-guérillero traqueur d'extrémistes violents – Émir occulte @KatNarvTV – #OSINT #InfoSec #Jihad #HaineEnLigne #Désinformation #Shitpost – Terrien de souche®;49909;776;13356;86118;150159
nattyka32;Yka3.2ðµð¿ð±ð¦ð¦;"Le covid, cet inquiÃ©tant virus de              
  dÃ©s-Humanisation...
Je RT indiffÃ©remment droite et gauche tant que c est opposÃ© Ã  la dictature  sanitaire";119278;669;1115;28928;149990
zeyesnidzeno;zeyesnidzeno;"""L'écologie est une lutte de classes"" Usul (XXIᵉ  siècle)
#GiseleHalimiAuPantheon
mastodon.social/@zeyesnidzen…
Bandeau de @PietDessineux";133890;972;2754;12323;149939
NantesOnline;♡ Nantes Online;🇺🇦  À suivre ! Pour réagir ou poster vos infos, utilisez le hashtag #NantesOnline;120002;2705;12299;14679;149685
mproulx21;prolix;retraité, indépendantiste, le bon vin, la philo, socio, la bourse, le bien du peuple, ex comptable cpa-cma;132239;1143;5020;11090;149492
Vivmedia1;Business Directory, #buyer #Importer #Exporters;#buyer , #Importer , #wholesaler, #Importers , #Exporters Directory. Free Press Release service. Promote your #business or yourself.  viv-media.com/index_zx.php;149123;2;294;0;149419
IndianaJaune51;🥃Un Ricard et Un Pétard🥃;"Patriote🇫🇷🇫🇷🇫🇷
🇷🇺 🇨🇿 🇮🇹 🇮🇩 🇭🇺🇬🇷

Parfois drôle 
Parfois virulent 
Toujours dans le je m'en fous de ce que t'en penses

#TeamMoiMême";46929;5499;5255;91690;149373
Flawless_ff;🌊;o b l o m o v i s t e;40174;401;294;108504;149373
wil75;Wil;#NeverGiveUp #JamaisTropTard #NeLacheRien Ex #Entrepreneur, passionné d'éco et d'info. @CigarSocialClub;146711;443;1514;679;149347
BlondinTuco;Blondin Tuco;"La souveraineté nationale appartient au peuple qui l'exerce par ses représentants et par la voie du référendum.
Art. 3 de la Constitution

Good, Bad and Ugly";17042;1544;769;129966;149321
dombouissou;dominique bouissou;"""Beaugency Béton et Camions ça suffit !Un développement alternatif, c'est possible!""
facebook.com/StopBetonCamion…
@dominiquebouissou@piaille.fr";50017;2269;8449;88509;149244
BusinessBourse;BusinessBourse;Développez votre esprit critique et cultivez la manière dont vous devez comprendre et vous servir de l'information. Telegram: t.me/BusinessBourse_BB;124914;1406;11760;10969;149049
_Korentin;đ. đđ§Č;Pas grand chose mais #NoirEtTrader. @_nlgrp;34906;238;5228;108393;148765
audouinc;Christophe AUDOUIN ðð¿;"ð§â»ï¸ #eau #rÃ©silience #transition #Ã©cologique #intelligenceÃconomique #RSE #strategie @suez #Toulouse #Occitanie
 Administrateur @AquaValley & @La_melee";78379;997;4975;63640;147991
SilkysilkK;GREVE ๐๐๐๐๐๐ค๐ฅ ๐ฅ๐๐ ๐๐๐๐ฃ๐ ๐๐ข;"in girum imus nocte et consumimur igni.
Festina Lente.
#GreveGenerale";60937;11122;12067;63658;147784
LeoQuiTwitte;Léonard;Social media ambassador @SciencesPo – ex-@cvl_llg (et donc nécessairement bourgeois) – plus fun que cette bio insipide;13871;4655;415;128740;147681
adsaum;Adrien Saumier;đŒ CĂŽtĂ© pro : formateur et consultant @IReseaux, associĂ© @GestionsLoc_ | đ Podcast politique : shows.acast.com/adrien-parleâŠâŠ | @eelv6_8;111344;1477;5947;28349;147117
CoachDeVente;ππ ππππππ;Dirigeant de coachdeventeconseil.com et de : Inbassadeurs #techniquedevente π#nΓ©gociationπ°#SocialSellingπ₯ #influence;141305;186;3681;1899;147071
escaledenuit;@escaledenuit;Le site des voyages insolites et secrets #travelblogger #bzh #voyage #photographe;15732;26641;63035;41554;146962
xico_alexandre;Prof Xico ­čçž­čçĚ­čîÁ­čîů­čĽŐ´ŞĆ;"Francisco Alexandre da Costa. Professor at UFRN.
PhD in Physics @ IFUSP.  Complexico.";56830;4642;4558;80358;146388
virginie2000;virginie;"En rémission du cancer du sein, winner!

Personne n'est si pauvre qu'il ne puisse rien donner, Personne n'est si riche qu'il ne puisse rien recevoir.";53824;2794;304;89254;146176
lamarsweb;La Marseillaise;Engagée au cœur du quotidien depuis 1943 #BalanceTonTaudis #UrgenceJeunes #LeVivantSurpend #EuropeOuvreTesPorts #AjamaisPapeDiouf;93491;492;48303;3798;146084
legavric;Charlotte LE GAVRIAN;"#CloudSpotting
cloudspotting.paris
piped.video/-UqFreTGyyU";62054;889;769;82190;145902
BayaCiamala;Moteki Ndulé;En train de construire 🚧 @BaziksApp streaming musical 🎶 et podcasts 🎙, 💯 made in Africa basé à #Kinshasa to global 🌍;71830;612;8055;65212;145709
Olivancalderone;Olivier Antoine Cald;Politique, Laïcité, Polémique, Géopolitique, Cinéma, Société, Diplomatie, triompher mais par des voies étroites. 2RM et humaniste:.tutoiement de rigueur. RHIS;47501;2278;1004;94837;145620
boubeshartes;DanZig;"Liberté !

Au comptoir du bar, comme vous.

 🤮 les gauchistes 🤮

Pour un avenir meilleur = sans écologistes

#DelendaLutetia";135723;1647;608;7449;145427
Amoklaufer;Amoklaufer;đ Militant Ă©cologiste | đ Data-addict | đ« RN-RNaissance;41787;1138;970;101488;145383
ReseauAntiSpin;RAS HD: le Réseau Anti Spin;"RAS HD: Nous sommes l'information maintenant.
Mediawatch caustique et humoristique en continue.
Le 3e côté de la médaille de l'actualité.
Émission Le Narratif.";142898;605;1562;0;145065
Spynozette1;Spynozette 1;"Comme tout est politique .. Je m'informe et vous partage ..
""Savoir est à la portée de n'importe quel imbécile. Comprendre est l'important "" Einstein .";67957;287;875;75826;144945
hautsdefrance;Région Hauts-de-France;Compte officiel de la Région Hauts-de-France #hautsdefrance #HDF;43419;2578;85815;12695;144507
Bookee0;Bookee;"21y /  / đâȘ
secondaire :@gaetanpoussin";43586;903;4817;95109;144415
ArakasiAcoma;Aarakasi;"Étudiant vétérinaire en Espagne

#NoFakeScience

Longue vie à Heroes of the Storm & SC2";12525;914;273;130663;144375
MySter_Brun_s;MySter Brun's - MousqueTerre;« Celui qui se sera étudié lui-même sera bien avancé dans la connaissance des autres. » Diderot;116808;4705;870;21846;144229
MSNFrance;MSN France;#Actualité #Divertissement : toute l’#information qui vous intéresse avec MSN !  Retrouvez-nous également sur Facebook : facebook.com/msn.fr;117617;345;26115;77;144154
erictempoperio1;Éric TEMPO new compte;Républicain athée lgtbqui  bénévole au Refuge 🏳️‍🌈🇪🇺🇫🇷;33474;1205;696;108363;143738
Naboleon_3;Naboléon 🇫🇷🇪🇺 Хуй войне!;La valeur d'un homme ne se mesure pas en nombre de followers - Abraham Lincoln. Toujours En Marche malgré l'arrêt absurde de #NDDL Troll préféré d’Alexis Poutin;91183;861;751;50816;143611
CarolineLessar8;MADAME Caroline Lessard;Truth: truthsocial.com/@carolineles…… 👀 2+2=4 🧐 1984 pour mes déplacement: paypal.me/infocaro?local…… Alexis² Radio-Québec♥️🇧🇷;71422;1879;16228;53958;143487
LP_Affaires;La Presse Affaires;Les dernières nouvelles sur l'économie, la finance et le monde des affaires.;96472;33;46840;0;143345
_GaLaK_;Nicolas ‘GaLaK’;Ingénieur Télécom & Réseaux. Gamer (@BF_Somua / @BF_Nation). #ITWT (galak@mastodon.social);137093;924;3983;1195;143195
7Milx1;Mila 🖤 SPEAK NOW TV (Taylor's Version);the sun 🌞 ~ STAYTINY 🫰🏻  Dragons 🖤 ciel's wife;107626;457;402;34439;142924
bobby38_bcn;bobby38_bcn;;27569;55;230;115068;142922
charaf_yarou;YAROU charaf;"ðð Make education a means of adapting to climate change
Working with rural women to adapt to the effects of climate change.";68902;949;1504;71567;142922
namisaywhat;Lalla Nébuleuse;dramaturge;135270;285;582;6653;142790
63Micronde;⚽️ 🐢 🏳️‍🌈 ǝpuoɹɔıɯ-micronde 🏳️‍🌈 🐢 ⚽️;"Avec la #Nupes, redonnons le pouvoir au peuple
Partiellement occupé à refaire le Monde
Certifié gratuit 🩴

À l'âge de l'internet, l'ignorance est un choix 😌🙄";21115;2617;2079;116749;142560
TraduisonsLes;Traduisons Les ð¥ð³;Compte Onlyfans non-officiel de Stanislas GuÃ©rini;35817;1341;91060;14212;142430
VQPresse;VQUALITEPRESSE;Une revue de presse 2.0 pertinente actualisée en temps réel, mais aussi un service de portage à domicile de votre quotidien préféré. Sud Ouest / Le Parisien;140612;438;657;401;142108
bahoro09;Amadou Tidiane BAH;Mari et Père. Responsable Communication et Marketing @mouna_group. Ex Chef Cellule Com au @mtp_gn, @mjejguinee, @fonijguinee /DG @Tibacomm #TweetComMoustapha.;48095;1648;69310;23005;142058
JeanRobinMedia;Jean Robin;Diplômé d'un master en Intelligence Economique à l'EGE en 2006, journaliste indépendant depuis 2005. Un de mes livres : tinyurl.com/4rcc4kam;59251;88;30312;52351;142002
Argotorm12;ք հ ճ կ լ մ ւ ց #🐀dicalisé #grève06Juin🦉🌏🐢...;En cours d'existence, aucune idée de ce que j'étais avant...;42334;4316;4633;90327;141610
jl_proulx;Jean-Luc Proulx - Avec les agriculteurs hollandais;Politiquement incorrect. Pro-Tibet, pro-Kurdistan, pro-Israël, pro-Québec. Catholique. Occidental. Anti-islamiste. Pro-laïcité. Mais contre l'extrême-droite.;132912;4152;4254;11;141329
GinetteLeclair3;Madame Ginette Leclair;;43428;473;518;96883;141302
Aldysheky;Shekomba Okendhe;;29495;713;87262;23793;141263
lagrossefouine1;lagrossefouine;Nier les violences policières, nier la pénibilité du travail, nier les conflits d’intérêt, un gouvernement de niais!;68165;26;641;72351;141183
penelop25721098;đ«đ·đ”đ±peneloppe đ«đ·đ”đ±;PionniĂšre et fiĂšre de lâĂȘtre la France nâa pas dit son dernier mot #Reconquete;59606;4161;3208;74114;141089
S_Netchaiev;netchaïev;"Diffuser la culture Ukrainienne

nafoslavaukraini.myspreadsho… (bénéfices reversés à U24)";48005;3410;2989;86530;140934
Laijhands;o fofana;En route pour l'emergence !!;55423;679;3698;80782;140582
LeQuotidien_Cyb;Le Quotidien;Leader de l'information régionale au Saguenay-Lac-Saint-Jean. Pour nous contacter: redaction@lequotidien.com ou 418-690-8800;135265;18;5084;4;140371
Openstreets1;Openstreets ð¿;Souverainiste de gauche refuse le pass reco faciale norme CovidisISO2021 stop commission UE Sujet dÃ©sobÃ©issant rÃ©cidiviste team rÃ©tablis  . Stop anathÃ¨mes;69666;170;906;69578;140320
FlorentRouen;Florent de Rouen;;24222;2766;912;112329;140229
galularoma;GalulaRoma;Translator - collab d'élu•es 🌹 et 🌻 - féminisme et intersectionnalité - un passé latiniste;16010;1121;738;122331;140200
HistoireSecrete;#NotrePays;ℹ️ Fil d'informations et 💭réflexions libres et citoyennes concernant nos sociétés actuelles et anciennes;121165;947;3586;14488;140186
Alice07788382;Alice ð¨ð¦âï¸;;28238;761;1562;109529;140090
Kyoi13u;jeune blavan;j’aime les fleurs et la drill;22334;390;103;116997;139824
JulHis2;Jul His;đšđ”đąđł;59003;783;494;79266;139546
BPartisans;Brainless Partisans ð´ââ ï¸â¢ï¸â£ï¸ðª;"Ne soyez pas victimes de lâignoranceâ¼ï¸
/ Suivez-nous sur Telegram t.me/BrainlessChanel";51297;35076;38210;14872;139455
keepithalal00;Othman ððð¥ð©ðð«ð ð¤ð ð©ððð¨ ððªð£ð®ð;"Islamo-grappleurð¥ÙÙØ¯ Ø³Ø¦ÙØª ÙÙ Ø§ÙÙØªØ§Ù Ø¶Ø¯ Ø±ØºØ¨Ø§ØªÙ ÙØ´ØºÙÙ. ÙØ£ÙØ§ Ø£Ø¹ÙÙ Ø£Ù Ø§ÙØ·Ø±ÙÙØ© Ø§ÙÙØ­ÙØ¯Ø© ÙØ¥ÙØ­Ø§Ù Ø§ÙÙØ²ÙÙØ© Ø¨ÙÙ ÙÙ Ø§ÙÙØ¬ÙØ¡ Ø¥ÙÙÙ. "" - Ø§Ø¨Ù Ø§ÙÙÙÙÙ";44572;333;423;94091;139419
Schyzoidd;Schyzoidd;ð´ó §ó ¢ó ³ó £ó ´ó ¿  ð«ð·  - Se prÃ©parer au pire, espÃ©rer le meilleur. // La FFF couvre les violeurs : josimarfootball.com/40-yearsâ¦;49816;405;147;88802;139170
ereical;ð¸ï¸;|| @arsenal @realmadrid @raptors stan account ||ðª¸;135435;219;805;2560;139019
logan_bzh;Logan Gourenez 🏴󠁧󠁢󠁷󠁬󠁳󠁿😼;"Emsaver ha brezhoneger.

Nationalisme breton, lutte des peuples et unité européenne.";53886;946;2512;81524;138868
Mounredeme62;Mounredeme ⭐️⭐️;Fan de jeux vidéos, d'eSport et de sport (en particulier le foot néerlandais et italien & la F1);119173;4977;384;14278;138812
LezineauM;Lézineau Jean-Marc 🐢;"Mélenchon aux 4 tours.
#Nupes
Aux arbres Citoyens! Désobéissant civil.
Vert toujours donc LFI-AeC!
LRNEM et autres Droites-Extrêmes: ⛔️
Je propose, tu disposes.";61521;2662;2035;72500;138718
ivarsigurdson;La France Libre;une seul idée, La France éternelle, un phare pour le monde ,pas la bougie actuelle éteinte par un fou qui n'a rien de Jupiter, mais d'Hubris .;42962;253;7775;87544;138534
Emarketing_fr;Emarketing.fr;Le site des professionnels du marketing par @CosteaIxia @MartineFuxa @FloSalgues et @MatisDemazeau.;28698;2953;102611;4093;138355
z_fighterr;La Promesse ! ☝🏾;i choose to walk by faith not by sight ❤️🤲🏾 @arbreard / Graphic Designer également @\bymosali sur insta;70692;524;602;66372;138190
MtlYlavoie;Yves Lavoie;Globe Trotteur. Conseiller en Voyages détenteur permis OPC.  Destinations Exotiques. Croisières.  Partage ma vie entre ville et région. Chats et Musique;68547;936;2967;65577;138027
ItSHumaNatur;GettinToThePapRLike;;92688;991;2112;42058;137849
CalatravaCH;Vespasien (PNO);Non Inultus Premor;57757;389;853;78836;137835
le_nouvelliste;Le Nouvelliste;Le Nouvelliste, votre quotidien en Mauricie et au Centre-du-Québec depuis 1920. Coopérative membre de la Coopérative nationale de l'information indépendante.;131818;22;5843;3;137686
Tanguy_Cornec;Ⓜ️ tanguycornec;ancien Conseiller municipal Rassemblement National Antibes;85159;2813;3600;46105;137677
LT_LaTribune;La Tribune;La Tribune, votre quotidien à Sherbrooke depuis plus de 100 ans! Membre de la Coopérative nationale d'information indépendante.;129472;65;8101;5;137643
CharlesPrats;Charles Prats APM đ«đ·âïž;đŽ Ex magistrat de la dĂ©lĂ©gation nationale Ă  la lutte contre la fraude fiscale sociale & douane au ministĂšre des finances - DG stĂ© KYC/fraude documentaire â„Ùđ;31183;2344;54490;49586;137603
Quinosolo;Quino solo✌;"Les pensées profondes sont sous la surface, cessez de buzzer, creusez!
@quinosolo@mastodon.social 18/11/2022";85940;1524;1472;48484;137420
IlonkyC;Elikya;Époux, père, et accessoirement Ingénieur spécialisé en Travaux et maintenance des infrastructures ferroviaires.;21593;840;1895;112975;137303
Fred4Bonnet;Fred BONNET;▪️Sociétaire des Arts Sciences Belles Lettres #Tarn ▪️Conseiller National @oserlafrance ▪️@Nouv_Energie▪️Homme ouvert d'esprit 🌈 #NouvelleEnergie 🕊🇫🇷;35181;1176;3664;97047;137068
Yomartel7;Yomartel7;;86149;2726;1982;46175;137032
TheKeeper46;The Keepers;Force et Honneur - Altruistes discrets de l’humanité au service de la Justice et la Vérité - Patriotes - Nous avons CHOISI le Peuple / Êtes-vous prêts ? 💊👀;77539;133;7395;51920;136987
Figaro_Economie;Le Figaro Économie;Toute l'actu économique est à retrouver sur notre fil Éco.;75103;69;61125;605;136902
JeanneNeymar;Jeanne Neymar;"Vers un vrai nouveau monde...
mastodon @tiossane@pouet.chapril.org";60511;753;575;75044;136883
Val_Plante;Valérie Plante;Mairesse de Montréal, cheffe de @projetmontreal, amoureuse de Montréal #polmtl Compte géré par mon équipe et moi-même.;10708;1759;114356;9965;136788
Trunkhanwow;Trunkhan;"Mangeons les riches
twitch.tv/trunkhanfr
piped.video/TrunkhanVideos
piped.video/TrunkhanLive";112079;562;364;23453;136458
NicolasBay_;Nicolas Bay;Député européen / Président de groupe au Conseil régional de Normandie / Vice-président exécutif de Reconquête! / Avec @ZemmourEric;20763;939;110612;3866;136180
littlebigfred;LittleBigFred;;103126;178;1603;31201;136108
marronnage;Association Marronnage;Ne plus rien laissez passer;66788;436;238;68370;135832
lavoixdelest;La Voix de l'Est;Les nouvelles de la région de Granby directement de la salle de rédaction du quotidien La Voix de l'Est.;131597;72;4054;3;135726
JphTanguy;Jean-Philippe Tanguy Ⓜ️;Député et Conseiller régional mariniste de la Somme (4e) - Membre Bureau National RN et Coordinateur du mouvement gaulliste @avenir_francais avec @MLP_officiel.;38892;1176;42441;53098;135607
louvrepourtous;Louvre pour tou·te·s;MUSÉES, PATRIMOINE & CULTURE / géré par @BHasquenoph journaliste :: auteur :: blogueur / Culture = ouverture d'esprit (normalement) / contact@louvrepourtous.fr;45814;2629;48756;38232;135431
VanityFairFR;Vanity Fair France;Compte officiel de Vanity Fair France.;79079;227;55482;603;135391
FredericSays;Frédéric Says;"Journaliste.

📻 Radio France, rédaction internationale.

📺 @28minutes sur Arte.

📚 @LenferdeBercy (Éd. Lattès) et Billets politiques (Bouquins/Radio France).";30813;10911;49439;44202;135365
PFaouet;Penhouet Faouet;"Parce que  je bous depuis un moment ... mais encore plus depuis le 12 juillet 2021 !
Bloque korrigans et trolls.";35279;619;1186;98215;135299
djidane78;djidane;"La nature fait les hommes, la vie les rend différents... , peace and ❤️ 
🇸🇳🦁 ✊🏾✊🏽✊🏾✊🏿
instagram.com/djidanemanolo?…";70074;484;383;64144;135085
Dn641608671;1984;"""Le fascisme n'est pas le contraire de la démocratie,mais son évolution par temps de crise"" Bertolt Brecht";35705;658;1282;97376;135021
FrancePrimexbt;PrimeXBT France;"Votre plateforme favorite pour trader des Crypto, Indices, Devises et Matières premières débarque en France 

Telegram: t.me/PrimeXBT_France";1042;73;133406;356;134877
PascalBerube;Pascal Bérubé;Député du @PartiQuebecois dans #MataneMatapédia | Ex-ministre du @GouvQc et ex-chef parlementaire | Indépendantiste pratiquant | ⚜️;52714;5382;59177;17317;134590
UCI_ICU_media;Internationalist Communist Union (ICU);All publications by Internationalist Communist Union Member Groups (unofficial);132713;345;1325;13;134396
LeChat84;Nicolas Colin;"Théâtre, chant, permaculture, agroécologie, zéro déchet,🌱
L'urgence c'est les émissions de CO₂
Ne faites pas d'attaques personnelles
mastodon.social/@lechat84";31457;2362;545;99954;134318
DoussietClaude;Claude Doussiet;Ancien haut-fonctionnaire, révolté par tous ceux qui prennent les Français pour des imbéciles et qui en la matière a eu la chance de pouvoir voir de près!!!;122310;560;4828;6545;134243
JMJancovici;Jean-Marc Jancovici;"Compte non officiel de Jean-Marc Jancovici
Posts relayés automatiquement depuis la page Facebook : facebook.com/jeanmarc.janco…";8448;256;124861;672;134237
Intel185;Tomato;Je suis informaticien expert dans mon domaine et membre de la Commission des transports du futur d'Olonne Sur Mer;89892;1257;407;42307;133863
Cdanslair;C dans l'air;Compte officiel de l'émission présentée par @Caroline_Roux et @AxeldeTarle du lundi au samedi à 17.30 sur @France5tv ➡️Pour réagir : #cdanslair;30426;867;101336;1111;133740
sbecqndiaye;BECQ;"Retraité par répartition pas par points
Héritier de Robespierre. Libre esprit rebelle. Infatigable curieux, discuteur, lecteur et rêveur. Artiste autodidacte";79999;4993;3244;45448;133684
ScornDes;sKørn 🌐☢️;"Promethean Scifi-loving Gamer | Techno-solutionniste & plutôt Libéral | ""Pour chaque pb complexe, il existe une solution simple, claire et fausse"" ~ H.L Mencken";42031;742;1205;89676;133654
EricDrevon;Eric Drevon;;26761;1570;595;104597;133523
infofrance2;Info France 2;"đŽ Bienvenue sur le compte de l'information de @france2tv.
đČ #Les4V, #JT8H, #JT13H, #JT20H et les magazines.";50687;891;78649;3004;133231
BzhClair;Manu;"Unknown affiliation 

Acoustic cyclist ‽

⸘ Walked Ben Nevis

Homme de faible conviction, cherche ligne éditoriale";56686;1888;2688;71690;132952
NAPOLEON35170;🇫🇷🇫🇷🐈🐈NAPOLEON🇫🇷🇫🇷😀😎;⛔️PAS DM⛔️Passionnée des 🐕😻🐈‍⬛ ET NE supporte pas la maltraitance animale ❤ - fière de mon pays 🇫🇷 🏌️‍♀️⚓️✝️🔯🧸😃 ☀️🔴⚫️⚽️🏆 - mariée 👰 ❤️🚫PAS DM;77023;4793;2153;48872;132841
rabah_larabi;لعرابي عادل رابح ⚡️⚡️⚡️;"Who's to say what's fair to say and what not to say? 

Mon pire ennemi c'est le calendrier";53654;751;484;77488;132377
obamarianne;Marianne, stagiaire;J'aime les croissants 🥐, bientôt au chômage ✈️;47152;421;843;83602;132018
NGATCHOU;Ngatchou;Personne n'aime l'Afrique plus que les africains#A bas l'impérialisme#Vive l Afrique libre et indépendante. J'ai un autre regard sur le monde actuel.;77649;1461;1377;51326;131813
PJDyonis;PierreJN đ»Ïđąđ»đ«đ·đ;Informaticien aimant la politique et changer de regard et de continent, avec un tropisme vers le sud et l'ouest;16796;1266;898;112703;131663
RolandLescure;Roland Lescure;Ministre délégué chargé de l’Industrie ⭐️ ⭐️;11161;5226;38422;76759;131568
belou03;Pasclair 2 . Compte secours de @Pasclair bloqué;"NON à la censure: 3 500 à moins de 1000 abonnés 
Ils veulent nous faire taire.
t.me/Tpasclair";71381;596;1052;58531;131560
communiquaction;Frédéric Lohbrunner;Apprenant permanent.;124837;3245;2552;724;131358
rfemassala;Fenelon MASSALA;Grand Reporter à Financial Afrik/& à l'hebdo Les Afriques Ancien pigiste à l'humanité & à Afrique Agriculture.Detenteur d'un Master 2 de  L' ESJ/Univ de  Lille;22158;11390;93913;3562;131023
taquinepasmamie;​​​​​​​​𝖙𝖆𝖖𝖚𝖎𝖓𝖊𝖕𝖆𝖘𝖒𝖊́𝖒𝖊́06 ✿◕‿◕ 💤🌿;"尺🝗⼕ㄖ𝓝Ɋㄩ🝗̂七🝗 

Il y a pire que le bruit des bottes, le silence des pantoufles (Max Frisch) 

🐾 animaux  ❤
Pink Floyd ♪♫♪♫ 🎸";58053;4410;4107;64440;131010
HERONNES;Ⓜ️FRANCELIBREⓂ️;;36802;1507;1206;91351;130866
sergeKay4;Sergio K 🇨🇩;Étudiant;21827;3615;4474;100946;130862
NicolasLoubet;Nicolas Loubet;Chercheur-cueilleur avec la @CoopMilieux. Actif dans @Manucoop_fr @Oxamyne @CatalystMEL @CoopdesCommuns @FabEnergies @Fab_Peda.;55869;12661;12669;49649;130848
MetropoliticBot;Metropolitic Nantes ð Robot de retweet;Notre ð¤ partage la com des politiques, militants et citoyens engagÃ©s de #Nantes (compte principal @Metropolitic_44);129484;669;660;15;130828
llebou;llebou;contre les totalitarismes, les fascistes - Pour la France et les Français. pas xénophobe mais pour les visas - ARPAC - Laïque. pour un gaullisme social.;52105;2059;1229;75371;130764
grams_marcus;Mwana Mayi ☥ 🇨🇩;☥ Une Afrique sans Tribus 🇨🇩 ☥ Aimez-vous vivant ! Me, Myself and I;17206;423;636;112473;130738
CalamyJane;Calamity Jane;"Compte Telegram :
t.me/fucklenouvelor…
Deuxième compte : @calamyJane2
2me compte Telegram pour l'univers de l'étrange : t.me/fJ3ktIuvL_tkYzA0";65185;1789;9164;54538;130676
BX1_Actu;BX1 - Actu;"Suivez l'actu de Bruxelles

đź“şBX1 en TV âžˇď¸Ź bx1.be/lives/direct-tâ€¦
đźŽ™BX1 en radio âžˇď¸Ź BX1.be/radio/
đźŤŽ iOS âžˇď¸Źapple.co/2BNVY4I  
đź“± Android âžˇď¸Ź bit.ly/2rfWQvB";94136;1658;34508;247;130549
Bakigrappler10;Baki Hanma;kick.com/Bakihanma10 @josephjoestar;19758;343;68;110313;130482
OpexNews;OpexNews;đ° MĂ©dia qui donne la parole Ă  l'industrie de #dĂ©fense | Veille NÂ°1 sur les enjeux #militaire #BITD #SouverainetĂ© #Rens Diplo | Activez les notifications đ;68067;1933;59522;908;130430
capt_skellen;Capt_skellen;;52229;3894;1949;72353;130425
Irvin_Winny;Winny;Ingénieur QSE/P2S || Basketball lover || Anime fan 🎌|| 🇨🇲 || #NetsWorld;120967;672;2776;5914;130329
jmvittori;Jean-Marc Vittori;Editorialiste, Les Echos. Comprendre et faire comprendre,  l'économie et au-delà. Débattre, aussi. Curious forever. Think & laugh, if possible.;13209;957;113367;2267;129800
Enricosk5;Enrico 🇨🇵;@ESA /@CNES enjoyer. Souverainiste et anticapitaliste. Vae Victis. Paris ♥️💙.;41555;2564;452;85130;129701
i__aln;Φ اسلام 🇩🇿;🦦;23918;424;406;104905;129653
FarafinaW;Farafina Wamy;Ma bouche sera la bouche des malheurs qui n’ont point de bouche, ma voix, la liberté de celles qui s’affaissent au cachot du désespoir.;37091;3850;25689;62773;129403
SmartCityFrance;Smart City en France;Toute l'actualité des villes numériques #AmenagementNumerique #SmartCity #eAdministration #VilleNumérique #HautDébit #FabLab #OpenData #Fibre;128722;0;595;0;129317
daily_research;Daily Research @SurveyCircle;Your daily dose of new online #research on surveycircle.com. Join @SurveyCircle to recruit #survey participants and to support exciting research.;74734;2982;1544;49930;129190
chirpichirp;chirpichirp;Analyse y compris outillée. Suivi de l'influence. Repérage du faux, de l'incohérent, du manipulatoire. Vaste rayon d'action. Humour épigrammatique.;91551;1573;865;35100;129089
France61224153;France 馃嚝馃嚪馃嚝馃嚪;"Continuons le combat contre Macron !
#patriote RECONQU脢TE馃嚚馃嚨馃嚚馃嚨
suivie par #TeamPatriote et beaucoup de patriotes 馃嚚馃嚨馃嚚馃嚨馃嚚馃嚨馃嚚馃嚨馃嚚馃嚨";38014;9627;10950;70381;128972
NicolNogent;DUBOIS Nicole;Pas parfaite peut être mais pour la discussion dans le respect. Je bloque ceux qui insulte, sans aucun état d'âme.;34171;186;233;94374;128964
PieuvreSympath1;Pieuvre Sympathique 67;⚜️🇫🇷⚔️ 🥕🍗Z0ZZ Q ZZZ  Frexit;41619;1700;1311;84111;128741
Mediasinfos;@Médiasinfos;Retrouvez toute l'actu des médias (Télé, Radio, People, Presse...) sur notre site internet: mediasinfosblog.wordpress.co…;83180;1270;20608;23677;128735
HelliaFax;Laurelia đ«đ· matricule 2652 đ·đș;On apprend seul mais jamais sans les autres et si tu n'as autour de toi que des gens qui sont de ton avis, cela ne te sert Ă  rien. Pro-Russe et souverainiste đ;83205;1834;1570;42020;128629
Chronopost;Chronopost;"Suivez-nous pour découvrir toute notre expertise et nos actualités ! 📦
📣 #Logistique #RSE #eCommerce
💬 Service Client en DM sur le compte @ChronopostSAV";93494;213;33142;1780;128629
abdou_444r;FZ.;"444 🕊
❤️ R";10578;176;109;117428;128291
saintbernardin;S. Bernard;;33975;281;487;93460;128203
_DreamingCat;•Heartless•;Utopiste;44097;592;392;82931;128012
D_cence;Dsens;"— J'avais raison de mon point de vue ! 
— Cultiver les sciences et ne pas aimer les hommes, c'est allumer un flambeau et fermer les yeux
✨
@D_cence@Mastodon.top";89214;204;574;37887;127879
DarkPhoenix9666;Dark;;51298;397;450;75618;127763
loutro1990;Martine Le Jossec ­čÄł #VivaTech #FeelGood ­čÖĆ­čĆ╝;"Agence Conseil & Formation 
#Communication #Digital #SocialMedia
#RSE #FeelGood
#Speaker 
Membre de @LaBrigadeDuWeb 
Pdte @FeminismeAsso
#ExpertesDuNum├ęrique";53212;5178;12882;56376;127648
PresidenceGA;Présidence de la République Gabonaise;Bienvenue sur le compte officiel de la Présidence de la République du #Gabon🇬🇦.;5223;7;122005;344;127579
CarminDj;Carmin.D;C'est ici qu'on doit mettre une description ?;88271;624;1077;37551;127523
paule40673239;paule;Creative;27635;120;283;99063;127101
bayernluck;david;"fc bayern munich
ux/ui designer, graphiste & dev.";58186;907;3702;64018;126813
DavidDulin16;Davidđšđ”đšđ”đšđ” reconquĂȘte;;58805;2005;1536;64421;126767
Thomas_H78;Thomas H.;ð¨ðµð¨ð¿ â¢ Ãlu Ã  @Ville_Mezieres (Yvelines) â¢ ð@SciencesPoSGL â¢ SG @PartiRadical78 / BN @JeunesRadicaux â¢ Poltq locale, parlementarisme, progrÃ¨s â¢ â½ï¸ Fan @OL;24163;3567;2154;96731;126615
lemonde_planete;Le Monde Planète;Bienvenue sur le compte officiel du service Planète du @lemondefr;41771;91;84513;99;126474
monde_agricole;MONDE AGRICOLE;#MondeAgricole #agroéquipement #agriculture #viticulture #éleveurs #lait #viande #coop #céréales #fruits #légumes #Engrais #vignobles;62065;1329;1447;61607;126448
filbiniou;Philippe MÉTAIS 👨‍💻;#Gazier Territoire #Clermont & #auvergne, #Innovation & couteau suisse #GRDF | #Nîmes addict | #Cello | #LoveWins🏳️‍🌈 | #TEDxFamily | je tweete comme je vis;45051;2154;4328;74695;126228
RevPermanente;Révolution Permanente;L'info du bon côté de la barricade depuis 2015. Nous avons besoin de votre aide, faites un don : revolutionpermanente.fr/fair…;45675;943;74870;4587;126075
fabricepelosi;Fabrice Pelosi;Conseil en communication start-up, scale-up, licornes, centaures, chimères. Mes tweets n'engagent que 10 points de croissance. former blue check;82834;3666;20526;18854;125880
LadyL62272434;Lady L l'union fait la force libertĂ© đšđ”;"Je ne marchande pas ma libertĂ© !
Ma libertĂ© n'a pas de prix !
Mes grand-parents ont donnĂ© l'exemple en rĂ©sistant Ă  l'ennemi.
Pas de message privĂ©.";73144;991;986;50723;125844
TABACS9;MOI .... DRUIDE ...... EHGULF .....;POUR TUER LE CAPITALISME CRIMINEL !;109767;4240;1834;9910;125751
ThierryBreton;Thierry Breton;Together, taking Europe forward đź‡Şđź‡ş Commissaire europĂ©en | EuropĂ¤ischer Kommissar | #industry #services #digital #tourism #audiovisual #space #defence;2579;97;121154;1898;125728
SolidiaresNord;SølidaireNørd φ #JLM2022 💧🐝🔻 🐦 3 🐘;Glane des information des médias qui me semble pertinant et les partages FollowMe où ❤️ RT Appreciez sinon transmet les intervention de la #FranceInsoumise;45387;1553;915;77609;125464
petitebitch;Humph;Diseuse de bonne aventure;53922;2429;2827;66221;125399
Claude_LS_COM;Claude C.;"N'ayez pas peur!
- Jacques Parizeau";20109;318;606;104227;125260
lexpressmaurice;l'express;Suivez toute l'actu sur #Maurice et #Rodrigues avec le No1 des quotidiens de l'île.;108301;270;15866;776;125213
Overhea10483578;Overhead;Les sondages m’ont pris toute mon espérance de vie.      #teamOM 🇫🇷🇵🇸;14022;1067;230;109885;125204
Shadynosaure;BMS | Shady 🦖;Métisse Mystère et ennemi de la race humaine - Esport & Pop Culture enjoyer🍿 - Graphic Designer - @BMS_CREW #43 - 🇸🇷🇮🇹🇵🇱 - Mii Gunner Main 🍯;55020;669;1832;67672;125193
zinfoslive;zinfos974;"Le journal d'information de l'ile de La RĂ©unionđź‡·đź‡Ş
Retrouvez lâ€™actualitĂ© politique, Ă©conomique, le blog de Pierrot, faits-divers, sportive, natio. I pouak !đźŚ¶";104887;314;19194;528;124923
SraMYaguchi;SraM 🔋;;40099;575;765;83301;124740
MathieuMf;MathieuMa;;14168;661;162;109367;124358
Alya__O;Sarangš§”šøš³;socially awkward and cringe.           (I solemnly swear that Iām up to no good ā”ļø);68010;1072;3418;51736;124236
Juniad_Khan;juniđąđ§đ»ÏreeJulianAssange;#AvenirCommun #FranceInsoumise #JLM2022 #ContreUEduFric #UnionPopulaire bilan-ps.fr;72142;1418;1671;48972;124203
Montifringilla5;Niverolle des Aravis;“Le pire dérèglement de l'esprit est de voir les choses comme on veut qu'elles soient, au lieu de les voir telles qu'elles sont.“ Bossuet;26787;3128;3305;90826;124046
LADN_EU;L'ADN ð§¬;"Les tendances de demain, aujourd'hui. 
ð News - bit.ly/ladn-news
â¨ Revue - bit.ly/ladn32-tous-chamanes
ð§  Livre des Tendances - bit.ly/livre-tendanceâ¦";35735;1438;60664;26158;123995
turgeonclaude;Claude Turgeon ⚡️⚡️;Vaut mieux mourir incompris que de passer sa vie à s’ expliquer! 🤷🏻‍♂️;52477;1301;1306;68865;123949
christiangeraud;C.Géraud Neema;China-Africa Analyst|Francophone Editor of the China-Africa Project| CSIC Africa Senior Associate|Tweet Political Economy of Natural resources, and DRC politics;39023;1232;5508;78089;123852
bazoche2;bazoches;échangeons idées et informations sur les questions d'intérêt général (dans un monde complexe, améliorer certains détails peut contribuer à l'harmonie du tout..);64198;2520;530;56598;123846
AutoPlusMag;AutoPlus;"Twitter officiel du magazine Auto Plus, le 1er journal qui se met à la place du conducteur !
Notre chaîne TV : autoplus.fr/tv 🎥";74100;156;47636;1924;123816
YvanDutil;Yvan Dutil;Astrophysicien, énergie, développement durable, radioprotection, systèmes spatiaux, mode de scrutin. @YvanDutil@mstdn.science;67300;2527;2095;51846;123768
metropolerennes;Rennes Ville et Métropole;Compte de la Ville de Rennes et de Rennes Métropole. #Rennes #ICIRennes #infospratiques #actus #agenda #politiquespubliques;36049;762;83053;3893;123757
DidierKissode;Didier KISSODE;Entrepreneur & Consultant en stratégies digitales|Social Actor & influencer for @unicef_togo, @cicr_afrique, @UNFPA_TOGO, @heforsheTogo| Build & Dev Community🌐;56216;1277;11688;54564;123745
Meunial;Meunial;RealLife, Relational - Medias - Montres - Technologies - Automotive - RoadTrip - MotorSports Formula One GTWorld WTCR WEC MotoGP - StartEngine đ;121878;1099;521;168;123666
FdeRugy;François de Rugy;Ancien ministre de l’écologie - Ancien Président de l’Assemblée nationale - Pdt groupe amitié France-Taiwan 2020-2022 - Conseiller régional;28522;1671;79205;14067;123465
gouvbenin;Gouvernement du Bénin 🇧🇯;Compte officiel du Gouvernement du Bénin | @Presidencebenin;15777;43;106839;515;123174
MacLesggy;MacLesggy;ingénieur agronome AgroParisTech - animateur-producteur e=m6 #em6 sur @M6 - #em6aucarré sur @RTLFrance - science/écologie/biodiversité/stop CO2;17330;798;79199;25794;123121
HECParis;HEC Paris Business School;Having an IMPACT on business & society as a whole. @HECParisMasters @HECParisMBA @HECParisExecEd @HECParisPhD @HECKnowledge @HECParisSnO @HECParisEnt;37368;1846;72693;11115;123022
DudFranz;franz dud;Compte principal;52922;666;382;68994;122964
OL__Plus;OL+;"Depuis le 11/08/2000, revue de presse permanente et indépendante autour de l'@OL. 
♀️:@fenottes
Tous nos réseaux sociaux : olplus.fr";62892;97;59962;7;122958
mfrancois69;Matéo;Compte personnel;59862;807;379;61909;122957
Ali_BFTSS;ðð¥ð¢ðð ðððâï¸ð§¡ð²ð¦;ï·½  ðð¨ð®ð§ð  ðð¨ð§ð¬ðð«ð¯ðð­ð¢ð¯ð ð¬ð­ð®ððð§ð­ ð°ð¡ð¨ ð¥ð¨ð¯ðð¬ ð¡ð¢ð¬ð­ð¨ð«ð² & ð©ð¨ð¥ð¢ð­ð¢ðð¬ ð²ð¦Ûâµ£ @rcaofficiel @realmadrid;11213;852;382;110446;122893
peterkeates;Peter Keates;Founder Onopia & Big Idea #BusinessModel #BMGEN #NoCode #JobsToBeDone #innovation #CircularEconomy #Marketplace Linkedin : linkedin.com/in/peterkeates;117809;14;4255;728;122806
stanley_kub;Stanley_kub✌️;wokiste, pro cancel culture, je suis le pire cauchemar de LREM/LR/RN - Mes tweet n'engagent que moi. @JLMelenchon 2027;20456;845;489;100712;122502
MoreauGabarain;Laetitia Moreau-Gabarain MS MBA;"ing @AgroParisTech interested in #Sleep #Health #Climate
#naturaltimezonesforclimate #undodst @ACHEDFR @EQUITHR @NaturalTime365 #equity #sustainability #energy";31381;4998;1487;84601;122467
VOLLMERmarc;VOLLMER Marc;cartésien , epicurien, j'aime la montagne, les volcans ,les voyages ,les avions, la musique baroque et le folk ,les bouquins,l'économie, la politique....;53189;5002;1380;62836;122407
la_lesaffaires;Les Affaires;Actualité économique, de la Bourse et des finances personnelles. Plus de 50 événements destinés aux professionnels et aux gens d'affaires du Québec #lesaffaires;63481;1150;51288;6374;122293
USAenFrancais;USA en Français;Compte officiel du département d’État des États-Unis en français. CGU : state.gov/social-media-terms…;26891;3156;73374;18180;121601
souhi999;sou HI;"đą
#Follobackinsoumis
#UnionPopulaire
#Fairebloc";26326;1215;424;93622;121587
BMeninist2;BlackMeninist2;Piano, Drawing, | Oligarch. 🇨🇲;38077;2595;647;80264;121583
LAbdullayevaMFA;Leyla Abdullayeva;Ambassador of the Republic of Azerbaijan to the French Republic;2890;779;98236;19669;121574
tinynews_be;ⒷⒺⓇⓉ 🇧🇪;Chef de cuisine à la maison / Casimir de l'IT / Capitaine de Tinynews.be / Je tweete comme je suis / Émotif sensible et idéaliste naïf #ISFJ;46522;1715;4067;69242;121546
thierrylfronde;Thierry La Fronde đ«đ·;"IndĂ©pendant, patriote, libre pensĂ©e, gauchiste repenti #Frexit #JusticepourLola

ma page VK pour Ă©viter la censure https://nitter.net/t.co/n5B8s6zL";59578;3504;2646;55757;121485
LeCNC;Le CNC;"Centre national du cinéma et de l'image animée  
Soutien à la création cinéma, séries, TV, jeu vidéo.
facebook.com/centre.nationa…
instagram.com/le_cnc/";13034;1595;97923;8739;121291
UNDPAfrica;UNDP Africa;Advancing sustainable human development in 46 sub-Saharan African countries. Director: @AhunnaEziakonwa;23050;1823;80786;15605;121264
Qraaal;Batounet de Poisson 🌐;Ingégé R&D et Maître du Jeu | électrons et biberons | Lyon et Velay | Quand j'étais petit je voulais être chevalier, astronaute ou inventeur | #d100;56621;1017;6346;57160;121144
elspirito1;el spirito;Gourou au chômage technique;11495;301;401;108919;121116
patrickmutambay;Patrick Kabuya;"1. Chargé de communication de L'ADPI-RDC/projet Grand Inga (Inga3, Inga4, Inga5,Inga6,Inga7 & Inga8)

2. Représentant pays🇨🇩 de ametrade.org";47042;3265;42125;28621;121053
Aubl_Bru;Bruce;Compte perso. Travaillant dans l’INB 127 et 128, de la génération 420. Mes tweets n’engagent que moi et ceux qui les lisent. #TerraWater;34051;2472;1029;83230;120782
IncontournableJ;AGBETIAFAN KOSSI JEAN;"HISTORIEN CONTEMPORAIN,HUMANISTE 
+22893708687";4950;8;353;115381;120692
FCGeopolitics;FC Geopolitics ð;ð Analyses pour mieux comprendre les enjeux internationaux grÃ¢ce au sport ð bit.ly/LivresFCGeo ð§ fcgeopolitics@gmail.com âï¸Fondateur @KeV_Veyss;22838;1865;67995;27956;120654
KhanNRachel;Rachel KHAN®️;« Qu’un sang impur abreuve nos sillons »;14208;3728;61385;41045;120366
ChantalCornet;Chantal Cornet;;48563;202;403;71147;120315
MArakHay75;MARAK - ð¨ðµð¦ð²;Le meilleur endroit pour continuer Ã  rÃªver, le meilleur club pour continuer Ã  gagner - #TeamPSG - SpÃ©cialiste de tout - #Pastoriste #Rugby;81086;953;1865;36365;120269
mmtchi;Momotchi;"""Leur propagande est marquée par un mépris extrême des faits"" H.Arendt. Ingénieur élec, analyses Covid théories & médias, bannie par Twitter en 2021 @momotchiii";6572;726;51577;61342;120217
AgnesRunacher;Agnès Pannier-Runacher 🇫🇷🇪🇺;Citoyenne engagée – Égalité des chances – Féministe – Ministre de la Transition Énergétique #Sobriété #BassinMinier #FabriquéEnFrance;10906;1358;95945;11848;120057
LaBourseEtLaVie;LA BOURSE ET LA VIE TV ⭐️⭐️;#Media indépendant 100% Actu #Bourse #Eco #Dirigeants L'éco. avec ceux qui la font. Animé par @DidierTestot journaliste et producteur audiovisuel solutions 🇫🇷;105119;3859;6019;4936;119933
mclucal;LucAl;Prof de sciences sociales;41921;177;4494;73305;119897
JeanForys;Jean Fory;For sure they'll fight U but they'll never defeat U.;48972;618;1710;68557;119857
FabienCazenave;Fabien Cazenave;journaliste, anime la page @OuestFrance /Europe - Passé par @touteleurope @ceuropeens @EurActiv_FR @EuranetPlus @Taurillon @JeunesEuropeens;77667;8622;11751;21730;119770
IziBook;IziBook;Solution E-commerce pour maison d'édition;107115;1264;609;10738;119726
SylvieAliasDory;Sylvie P. #NousSachons;RNupes, escrologistes, néofeministes, complotistes, antivax, proRusses, wokisme. Je bloque facilement ! #NousSachons;11264;191;497;107564;119516
HazukiC72903092;Hazuki CHANð¨ðµð®ð±ð¿;"Qui boit l'eau d'une terre Ã©trangÃ¨re doit en suivre les coutumes. 
Proverbe mongol

Les promesses n'engagent que ceux qui y croient (Chirac)

Z comme Z0Z7";44141;1471;1756;72122;119490
MissSocksPlease;MissSocksPlease;Roselyneđ„(Socks)đĂ  venir,deđ€ Bienvenue aux bonnes volontĂ©s Iâ€ïžđ,FerrĂ© Blues jazz Classicđ”đ Democratđșđž đž:Moi(01/06) Fille Gendre #COP28 #UkraineđșđŠđđ;55387;395;791;62565;119138
CarpentierLulu;Carpentier Lulu;docteur en droit international public, maître de conférences retraitée.;63147;884;2271;52493;118795
NvelleAquitaine;Nouvelle-Aquitaine;"Bienvenue sur le compte officiel de la Région Nouvelle-Aquitaine
#NouvelleAquitaine";21956;2937;84134;9600;118627
rougesgorges;rouge-gorge;#cosmopolite #diversité #nonsectaire  Ma radio de l'aube à l'aube ...;74547;4644;1124;38181;118496
Patspecial3;Pat;;14352;442;968;102622;118384
JCEV15;JCEV;;35765;1409;222;80804;118200
julienbayou;Julien Bayou;"Député écologiste #EELV des 3e et 10e arrondissements de Paris · Avocat
(Bannière @Encoreunestp)";26610;4797;76041;10732;118180
petitscarabe205;petit scarabée (Ladybug)🐞🪷💜;Maman vintage.Adore potichats et potichiens. Fan de séries. Marchande de bisous… #LGBTFriendly ❤️🧡💛💚💙💜🌈🌈PAS DE LISTE !!! Épicétout !;53506;138;218;64292;118154
Gemenne;François Gemenne;Migration and climate change. Director @Hugo_Obs & lead author @IPCC_ch. Also at @climate_voices and @fondationnh. Unlike most users, I approve what I retweet.;32297;1176;58233;26371;118077
uzumakimin_;Ley💌;i’m obsessed with Côme King ⋆ ˚ ｡⋆📖 ⋆୨୧ ˚｡;39720;902;945;76227;117794
HugCharbonneau;hugues charbonneau;Autrefois je produisais des films (120 battements par minute, Eastern Boys, L’armée du salut, J’aime regarder les filles…), aujourd’hui j’écolo-évangelise.;15534;3165;7883;91077;117659
novytweety;Libertarian Friend;Minarchist ð½ Statism observer ð Engineering. Cyber ð´ââ ï¸ Atheist. Business Wizard ð§ââï¸ Sport shooter. RT & Like â  Endorsement. FR/EN (NL/RU/LU);65828;1575;1592;48638;117633
MaixSOME;Maix SOME;Actus économiques et politiques;49686;1451;26855;39632;117624
bierun;Bierun ⓩ;Après des années de pause … réinscrite sur Twitter pour soutenir Éric Zemmour face à l’énorme manipulation médiatique @LiensZemmour;78335;4962;3518;30641;117456
Arthefran;La bête du Grévaudan;Doctorant en contempo (histoire sociale et culturelle de la 2e GM et de la sortie de guerre). Chicon, Milou, Poirot, shitpost. ❤️🖤 @arthefran@piaille.fr;34992;4813;2848;74734;117387
JeunesMacron;Les Jeunes avec Macron;Le mouvement de la jeunesse qui s'émancipe et qui s'engage ! | @Renaissance 🇪🇺🇫🇷 | contact@lesjam.fr;22536;883;68264;25652;117335
metoscm;METOS CM;;99738;828;889;15590;117045
IlannTrax;Pessi_Actimel (Ilann)🇫🇷☦︎;Joueur au @Peville_Fc;66928;6454;10294;33338;117014
SecretaireduBat;lasecrétaireduBâtonnier;"La secrétaire du Bâtonnier. Tweets non contractuels. ""Nous n'attendons pas de grands soirs, mais des petits matins d'hiver constructifs""";35243;1785;6442;73444;116914
Moustap305;Moustapha;Transporteur, Négociateur, justicier de Dieu;114060;1561;1084;50;116755
EmmaBavarde;EmmaBavarde;Professionnelle passionnée de l'industrie des parfums et cosmétiques. Sujets de prédilection #Parfum #Digital #Discriminations #Politique;43606;762;2304;70030;116702
M_Tinaud;Tinaud ūüíČ ūüíČ;Responsable RH ŔÜ #jesuischarlie;90531;986;1006;24010;116533
RennesOnline;Rennes Online;;109996;1701;4368;454;116519
JJBolzan;JJBOLZAN;Page personnelle-Conseiller regional 2015-2021,Pdt du @MvtRadical31,Adjoint au Maire de @Toulouse en charge du Bien Manger.,Pdt fédération marchés de gros;31518;5102;7140;72670;116430
kalonbuntu33;Nicolas Wolfhood @kalon33@social.badabam.net;"Biology, Genetics, Bioinformatics, Informatics and Opendata. A loving continuum!
social.badabam.net/profile/k…";22899;1302;232;91923;116356
josephlunieOFF;LUNIE JOSEPH ð­ð¹;Journaliste. Etudiante Memorante en Diplomatie et Relations Internationales au CEDI. Citoyenne engagÃ©e. Mes tweets nâengagent que moi.;9967;832;104335;1037;116171
Renaissance7_95;7e circonscription Val d’Oise #Renaissance;Responsable Départementale Transition Ecologique du 95 @EmmanuelMacron @Renaissance @Elisabeth_Borne @MarleneSchiappa @olivierdussopt @StanGuerini @LauStmartin;71834;2267;2264;39544;115909
WaffleCarpet;Omelette AU fromage (Mhhh);"Je travaille à être heureux
22";40974;630;176;73975;115755
RTNBurundi;RTNB;Radio Télévision Nationale du Burundi - Suivez le fil info de la rédaction web.;30236;528;84521;101;115386
JeanConnery12;Jean Connery;Masochiste supporter du #RCLens ... #Mug detractor...;55170;1753;1322;57114;115359
rgr20684835;rgr;ð®ð¹ð«ð·patriote avant tout. marre de subir de payer pour rien d Ãªtre humiliÃ© par nos dirigeants â¦;54531;1519;1329;57977;115356
JeanBamanisa;Jean Bamanisa;"la perseverance est la noblesse de l'obstination ; Ma vision est tjrs tournée vers un avenir lointain, j’anticipe et ne recule pas; à certains de rattraper";7985;1240;97501;8580;115306
MureIsabelle;Mure Isabelle;;1861;579;288;112516;115244
allmageddon;Eric Allmendinger;macron et MLP complices pour le pire. Mélenchon ou crève !;57788;808;601;55850;115047
JeanneLaJungle;✊ Jeanne de la Trêve Générale ✊;"Se balade de liane en liane dans la jungle urbaine depuis bien trop longtemps pour être totalement indemne.

#BurnOutDown 🥳
#NousToutes
#MonCorpsTaGueule ✊";22639;1998;1044;89204;114885
_Bens_M;pǝɯɯɐɥoɯ;La fatalité existe que pour ceux qui l’acceptent;92281;1844;3321;17235;114681
A_de_Faletans;Amaury de Faletans;agri,♿ depuis 06/19,  chasseur convaincu et nomade ,breveté GG.Anti woke et extrêmes de tout bord. ⚠️ cpte perso parfois brut  #ChassePartage  🇺🇦;11981;611;1185;100869;114646
king_buggery;nσαh ❀;Fatigué d’être fatigué • L3 droit @UParisNanterre;48189;515;4801;61050;114555
D_MailletPraud;Doriann Maillet-Praud;Professionnel de l'engagement. Démocratie, droits humains,francophonie et universalisme. Production poitevine/acadienne, implantation nordiste.;70013;2686;1711;40049;114459
LaBanquePostale;La Banque Postale;La Banque Postale simplifie la vie de ses clients. Nous répondons en DM 7j/7 de 9h à minuit. Notre charte : bit.ly/3D1IWlJ;50585;592;56252;7018;114447
beruriernoir007;beruriernoir ð´ââ ï¸;humaniste dÃ©sabusÃ©...;41946;9604;9409;53439;114398
KTOTV;KTOTV;Télévision catholique francophone.;42819;583;66907;4075;114384
JulienGossa;Julien Gossa;"Veille et recherche sur l'ESR.

Ne me faites pas confiance, vérifiez par vous-même.

#VeilleESR #HelpESR #DataESR
@juliengossa@social.sciences.re";68187;3484;10934;31721;114326
MShabani4;Ambassador for Peace -Liaison Office to the UN;"Ambassador for Peace UPF- UN.org
Political, Economic and Social Affairs Officer Prof of Balkans History and Geopolitics at Higher lnstitute of ISMTS";32023;5002;1533;75688;114246
Tucciii;Fernando;Não nascemos com uma função pré-definida, como uma tesoura, que foi feita para cortar, por exemplo. autor do Romance “A meia Luz do Armário” editora Telha;40424;1782;771;71074;114051
ansomilo;Antonio S. M. Lopes;Tenho 65 anos, casado, reformado, Ensino Secundário, Português, 1,65 altura.;92053;2913;1461;17552;113979
KARLOLIVE;KARL OLIVE Député;Député des Yvelines - Maire de #Poissy (2014-2022) - Conseil départemental @Les_Yvelines - Président @GeneTerrain - Pdt #VCF - Chevalier de la Légion d’Honneur;52128;9818;36989;14898;113833
Trucdeouf12;Trucdeouf đšđ” đšđ”đ€;Blanc soit disant privilĂ©giĂ© - mes privilĂšges (un emploi, un toit, payer des impĂŽts) ne sont pas hĂ©ritĂ©s, ils sont le fruit dâune Ă©ducation  et de travail đ«đ·;13416;4794;4181;91248;113639
EmmanuelPgd;Pgd - Μηδὲν ἄγαν (rien de trop);"Economie & finance au service de l'écologie. 
République universaliste. 
Doctorat sociologie EHESS
Directeur ESMS";36411;834;961;75295;113501
JKanyoni;John Nsana Kanyoni;Juriste| Entrepreneur | Époux et Père de 3 merveilleux enfants | Fervent croyant en un futur émergent de la R.D. Congo | Mines,Infrastructures & Énergie.;23171;4693;51455;33579;112898
DamienERNST1;Damien ERNST;Prof. ULiège, Visiting Prof. Télécom Paris and Chief Scientific Officer at Haulogy. Tweets about energy, artificial intelligence and engineering.;39993;2459;19191;51097;112740
ccastanette;Christophe Castagnette               ᵖᵃʳᵒᵈᶦᵉ;"Ancien Ministre de l'inferieur. Accepte tout emploi pourvu d'une buvette.
COMPTE PARODIQUE. Mes tweets sont faux et n'engagent pas la personne parodiée";29962;741;38908;43044;112655
pabouger;LaForceG;Mahatma Gandhi - A sign of a good leader is not how many followers you have but how many leaders you create.;79654;470;1194;31234;112552
S_EFortin;S. E. Fortin;Chroniques et radio (QUB/R-C/HuffPost/2V), ex-candidat electionsQc, UOttawa, comms stratégiques, mélomane, bd, vélo de montagne. Opinions personnelles.;72724;1376;11989;26413;112502
Crislor94;Chris Lorrain;;53904;2349;2263;53853;112369
reseau_canope;Réseau Canopé;Réseau national de #formation tout au long de la vie des #enseignants. #NumériqueEducatif #proximité #pédagogie #Education #Numérique #Innovation #médiation;22877;1488;72362;15625;112352
FP_Champagne;François-Philippe Champagne (FPC) 🇨🇦;Député fédéral de Saint-Maurice—Champlain. Ministre de l’Innovation, des Sciences et de l’Industrie l Minister of Innovation, Science and Industry 🇨🇦;25837;3502;61755;21219;112313
Jerome31_FR;HappyPeopleOnly.eth đ«đ·đȘđžđȘđș đđŠ;Â«Si vous avez compris ce que je viens de vous dire, câest que je me suis probablement mal exprimĂ©Â» Alan G. -Probably nothing- $ETH â  -Stade Toulousain- đ€·đ»ââïž;52708;717;1327;57557;112309
sa_illie;M&M's rose off 🇫🇷;"Tant qu'il y a de l'humour il y a de l'esprit !
Je dis atchoumer au lieu d'éternuer et j'assume.

#Zemmour2022
STOP délinquance, agressions, et impunité";37922;4392;2777;67140;112231
LeGlaude69;Le Glaude;Cartésien, ingénieur chimiste, prévention des risques naturels, industriels et domestiques, climatoréaliste, Matricule 10319;73600;788;621;37214;112223
VirusWar;VirusWar;Stop à la #DictatureSanitaire, arrêtons d'avoir peur du #CoronaVirus : Prévention (vitamines, #Zn...), traitement précoce (#Raoult #HCQ+#AZ+#Zn, ivermectine);31785;388;33170;46855;112198
juliendossier;juliendossier;Author of #RenaissanceEcologique, Founder of Quattrolibri, co-author of the #carbonNeutrality strategy of #Paris, @renaissanceEco juliendossier at piaille fr;29038;5090;4625;73311;112064
SuruZinsou;Suru-Lere ð§ð¯ð³ð¬;Aje ogungun niso fi lÃ© mi she ibunpe;45977;3253;1414;61323;111967
atletizer;مسلم 🇹🇳;COLCHO 🫀@ol @atleti;24038;389;155;87276;111858
Actuenviro;Actu Environnement;"Le quotidien indépendant de référence sur les thématiques de l'environnement et du développement durable, depuis 2003. 
Les offres d'emploi : @emploienviro";36787;492;69876;4417;111572
DNarvali;La Daronne Narvali 😎🦔;Qui vole un oeuf vole ma poule.#MoukavScoop;11240;190;824;99115;111369
hydroquebec;Hydro-Québec;Compte officiel. Suivez-nous pour en savoir plus sur l’actualité de l’entreprise. Questions sur votre compte ? @client_hydro et @hydro_customer #HydroQuébec;20849;1239;83903;4929;110920
blackbeautybag;BlackBeautyBag;•Beauty, Hair & Skin Expert Blogger since 2007 •Content Creator in Beauty, Travel, Fashion and Lifestyle.;60964;1742;23705;24438;110849
BenjaminBak1;Benjamin Bak;Militant @SetP_officiel depuis fin 2007. Regardez la vidéo épinglée;58774;1997;1113;48913;110797
DaddyTheBeat;Daddy The Beat;Artiste à découvrir. Engage-moi pour mes tweets.;63621;973;2732;43410;110736
CPolF5;C Politique;Tous les dimanches C Politique à partir de 18h30 avec @thomassnegaroff @ygoosz @Camille_Vigogne @gallaghereport;10990;709;97801;1233;110733
_batou_;Benoît;"Rédacteur web spécialisé 3D/VFX/Animation chez @3DVF.
Compte personnel.
Migration vers @batou_@mastodon.social si le Titanic coule.";86705;3143;3583;17266;110697
CNNum;CNNum;Conseil national du numérique | Commission indépendante chargée d'interroger la relation des humains au numérique | Co-présidents @FMDelasalles & @babgi;16678;22621;64269;7081;110649
myMetropolitain;MÉTROPOLITAIN;L’info en premier dans l'Hérault sur le site web ou sur l'application, disponible sur iOS et Android.;79132;636;29953;890;110611
BNPParibas;BNP Paribas Group;Si vous souhaitez joindre le service client, nos conseillers sont dispo en DM sur le compte Twitter @mabanque_bnpp.;19192;3526;75127;12698;110543
LIBERTE1311;eddy;;90381;114;244;19719;110458
Concordia;Concordia University;Located in the vibrant and cosmopolitan city of #Montreal, #Concordia University is one of Canada’s most innovative and diverse comprehensive universities.;21311;1337;79113;8615;110376
alexboulerice;Alexandre Boulerice;Député de Rosemont--La Petite-Patrie // Chef adjoint du NPD;26550;22405;26138;35174;110267
livreshebdo;Livres Hebdo đ;MĂ©dia professionnel du monde du livre crĂ©Ă© en 1979.;40154;4434;63685;1961;110234
amisdelaterre;Les Amis de la Terre FR;"đą 50 ans de lutte pour changer radicalement le systĂšme

#Climat #Multinationales #Surproduction #Finance #TransitionJuste 
đ amisdelaterre.org/nous-connaâŠ";22849;2757;68747;15847;110200
Aredius44;Aredius;"Blogs sur Saint-Yrieix-la-Perche lefenetrou.blogspot.com
saintyrieixlaperche.wordpres…, etc et un ouebzine  incroyable
leplatusseur.wordpress.com";93646;282;319;15936;110183
mflalonde;Marie-France Lalonde;Member of Parliament for #Orléans | Députée fédérale pour #Orléans Parliamentary Secretary of Immigration, Refugees and Citizenship.;13533;2894;10053;83612;110092
tanguy_france;Tanguy David;Politique et militantisme. đź‡«đź‡·;39804;2721;43024;24491;110040
DD75007;Danièle Deschamps;Ex Dircom filiale Cie Bancaire (Paribas) et Cabinet ministériel;49044;337;8399;52199;109979
studioandydna;Andy Ender;contemporary artist and visual artist of Swiss nationality #art #artmarket;26855;173;609;82144;109781
JeanMichChatain;Jean-Michel Chatain;gettr.com/user/alainsoap;42332;844;929;65625;109730
GuayElouan;Elouan74;"Adepte de la langue franĂ§aise đ«đ·
Joueur du jeu Affrontement Des Clans, j'y construit des bases dĂ©fensives";2303;322;69;106828;109522
RIMEmplois;RIM Emplois;"Retrouvez ici tous les emplois disponibles dans les organisations municipales du Québec! 

Suivez-nous aussi sur Facebook: facebook.com/RIMemplois";106359;871;1442;781;109453
bernardyellohc;bernard yelloh Z0Z7;GAULOIS REFRACTAIRE ANTIGAUCHIASSE ANTIMACRON / Non vacciné toujours vivant / GAULOIS PRO Z / anti OTAN / Ceux qui ont un drapeau Ukrainien poubelle de suite.;19868;4728;4187;80562;109345
jean_phi1;JPM;Reconquête 🇫🇷 sa culture, toute son Histoire ! STOP aux : woke, à la cancel culture, à la déconstruction ! la vraie droite la seule #stopMacron;65412;55;245;43551;109263
gampsonfranck;CameroonRoadsUntraveled;"Cameroon Roads Untraveled 
Présenter  le meilleur du  Cameroun";78466;5037;16586;9146;109235
Theydoronrons;Couve Flore;;39695;155;304;69065;109219
AirMilarsky;⭐⭐Milarsky👸🌌;J'ai sûrement été une Princesse intergalactique dans une vie antérieure^^;85874;4718;312;18145;109049
Gaspard_Skoda;Gaspard Skoda;Français - Québécois - Tchèque - Indépendance - Souveraineté - Démocratie - Francophonie - #Frexit 🕊️🇺🇳 - Mon propos = Moi (n'aime pas les extrêmes, les 2);52100;3896;5284;47735;109015
EmudyMoody;EmNodi/Waaqa እምኖዲ/ዋቃ (በግዕዝ አምላክ በኦሮምኛ ፈጣሪ);🇪🇹 ለሁሉም እኩል የሆነች ኢትዮጵያ ለዘለዓለም ትኑር 🇪🇹;46848;1518;1778;58805;108949
streetpress;StreetPress;"đź—¨ď¸Ź Des histoires, des enquĂŞtes et de l'impact. 

â¬‡ď¸Ź Soutenez notre travail en faisant un don";28531;895;75766;3411;108603
yvesdamecourt;Yves d'Amécourt 🇫🇷;Père de 👫👫👫 📚 @IMTMinesAles 🍇@vignesdamecourt 🇫🇷 élu de #Gironde 2004-2021 : Conseiller Général, Maire, Conseiller Régional. @TerritoiresT @Nouv_Energie;83142;5680;15153;4574;108549
PresseTheatre;RevueDePresseThéâtre;Ce compte est associé au blog «Revue de presse Théâtre» : scoop.it/topic/revue-de-pres… Ce blog ne reprend pas tout, c'est une sélection.;47918;1797;3813;54946;108474
QuilesThomas;Tom;;30224;1206;485;76533;108448
SoonPlanet;Lise7;"Le but des Rockefeller et de leurs alliés est de créer un gouvernement mondial unique combinant le supercapitalisme et le communisme...
Lawrence Patton McDonald";48008;2841;1743;55678;108270
Helge_001;Helge;Everything worth doing is worth doing well.;75653;236;816;31457;108162
fmomboisse;François Momboisse;Tweets perso sur commerce, internet, & others. Pro-vaccins, pro-nucléaire, pro-OGM, etc. Président fevad.com #ecommerce;67813;1096;28636;10561;108106
CStrateges;CourrierDesStratèges;Ensemble, défendons nos libertés. Media indépendant et fier d'être auto-financé. Pertinent dans son impertinence. Canal Telegram : t.me/resterlibre;17596;187;63763;26553;108099
Aurelien_Gohier;Aurélien Gohier;DirCom @OPEOConseil • J’écris et crie ma passion d'industrie sur @industry4good @circular4good 🎙️📝 • Modérateur trilingue, intervenant • PhD in Papapouling;10307;5632;9534;82615;108088
_Hisok4_;KC Hiso;"Faut pas qu'on oublie la magie qu'il y a dans nos iris
																						ð¥ #HeatWin ð¥";42473;380;200;64907;107960
THEVENONPierri1;Pierrick THEVENON;"đAnimateur : piped.video/@pierricktheveâŠ
đșAgit avec @MamansLouves @union_enfants
âïžAnime Justice citoyenne avec @DavidGuyon3
đ„Formateur Ă  @FormaPrev";14268;880;53393;39368;107909
techandco;Tech & Co;Toute l'actualité de la Tech sur tous les écrans;18439;47;88566;824;107876
TibsHuv;Sgt. Tibs đšđ”;C'est nous les gentils.;8109;476;337;98923;107845
Nabehe_Soro;NABEHE SORO;Économiste / Entrepreneur social / Consultant. #Education #nutrition #pauvreté #MarchéDuTravail #capitalhumain #leadership;31042;569;2808;73235;107654
SinedWarrior;đSined Warriorđ­đ;Euskal herria - baiona;28034;3910;15376;60265;107585
learningcode;Canada Learning Code;We design, deliver & partner on computer science education for people in Canada and run programs for #Ladies #Kids #Girls #Teens #Teachers Joignez-vous à nous.;29588;1894;64086;11974;107542
EPOCNEWS;ELECTION POLITIQUE CITOYEN;L'encyclopédie politique du net;102255;2216;2370;660;107501
IgorDosgort;Igor Dosgort;"#JusticePourLesSuspendus
#100joursdezbeul
#OuiAuScratch
#NoPass
#UForUnity
#bahjned
 ðð¥ð¥ð¥ð¥ð¦ 
groupe tÃ©moin, en rÃ©sistance depuis le 12 juillet 2021
-No MP";29898;4204;2206;71121;107429
LeV_tjr;Le V ๐ฉ๐ฟ๐ต๐ฑ;@FCBarcelona;38488;1679;1966;65217;107350
Davit_arm;Դավիթ;"Erdoğan İktisat Okulu'ndan.

PhD in Hudson Pro-institute";64838;841;1696;39889;107264
LeDL737401;Le Dauphiné Libéré Savoie, Haute-Savoie et Ain;Toute l'info locale en Savoie, Haute-Savoie et dans l'Ain.;95869;11;11356;27;107263
Kiara_Disney;Kiara Disney;"Je suis la princesse Kiara du roi lion 2.

Fan de Disney, Pat Patrouille, DreamWorks, Films & Séries, Playstation, Apple, Lions, Loups, Animation & Dessin.";40233;1854;1594;63413;107094
phil_gaulois;🇫🇷Philippe L 🇫🇷;;68344;8530;8166;21881;106921
mathieu_d123456;MaTh.d (2B);"Avec le laser, On peut réduire la radioactivité d'un million d'années à 30 minutes... Gérard Mourou, prix Nobel de physique
Alors vive l'eolienne 😂";45097;2490;1951;57353;106891
mat_augmente;Gratin Dauphinois ð¥;Grenoblisme mental;51501;565;1689;53104;106859
covid_ch;Stop Covid CH;la force de la communauté se mesure au bien-être du plus faible de ses membres (préambule de la constitution Suisse);39099;503;1414;65554;106570
cauchiphilippe;Philippe Cauchi;;58438;666;182;47234;106520
JSoukpo;JeremyG;"Africain et béninois , fier et patriote, drôle et sans complexe, curieux et surtout , Madridista | Alter-égo psychique. 
Ma mission ? Vous informer.";104904;413;1023;114;106454
andors75;Perriquet Françoise;Consultant Telecom passionnée NTIC AU SECOURS Macron est revenu 🇫🇷 + Anne Hidalgo saccage Paris ! mal pour ma ville natale un désastre annoncé !;83215;2059;1810;19292;106376
essec;ESSEC Business School;Leading International Business School | ð¿ Enlighten. Lead. Change. | ð Cergy, Paris-La DÃ©fense, Rabat, Singapore;39753;2416;53388;10694;106251
MitchFMY;Velocipediste alpin;Entrepreneur, rameur et membre du puissant lobby #vélo;12371;846;584;92298;106099
PanettonePazzo;Ultimes scories;Qu’est l’homme, sinon une petite âme qui maintient debout un cadavre ? -M.Lowry-;2536;2093;81475;19972;106076
jlvidal;Jean-Laurent Vidal;Tweets personnels (Si omnes, ego non).;57068;2582;581;45738;105969
AlphaWhisky67;Alpha Whisky;"Râleur impénitent et allergique aux populistes et autres démagos.

Compte de secours d'AndréW (avec son orang outang) en carafe";39732;383;677;65056;105848
nave_va;Elanaveva;FESTINA LENTE ! (Hâte-toi lentement !) Tacite;26147;1196;531;77815;105689
ChakTarSan;Tarpin_Serrant;Otage de Mme Hidalgo et de sa majorité ecolo inclusive;32369;1383;2592;69285;105629
camille1948;marie;đżDroiteForte #Wauquiez #FXB #DL #BR #JA #liberte #responsabilite đż  âM@cr@n;92194;2237;1521;9653;105605
Domusignis;Domusignis đź‡«đź‡·;Â« Le courage est la premiĂ¨re des qualitĂ©s humaines car elle garantit toutes les autres Â». Aristote.;34422;873;647;69620;105562
MDelafosse;Michaël Delafosse;"Maire de Montpellier - Président de la Métropole. 
Professeur d’histoire et géographie - met en œuvre la gratuité des transports - cycliste - jeune papa";20947;2159;31414;51010;105530
CFDT;CFDT;1er syndicat de France dans le privé et le public confondus / Secrétaire Général : @CfdtBerger / La rédac #CFDT : @SH_CFDT;38409;1037;58309;7707;105462
Lozre2;Alliance pour la France;Europe Presse politique Défense & sécurité Religions & spiritualité Pouvoirs publics Élus & partis politiques Relations internationales Sondeurs & think tanks;52121;2603;1745;48915;105384
NextStep_Sante;NextStep Santé;"Accompagnement des institutions et des entreprises dans les domaines
de la E santé, maladies chroniques et 
de la Prestation de santé à domicile";57820;4688;1988;40866;105362
StanGuerini;Stanislas Guerini;Ministre de la Transformation et de la Fonction Publiques. đź‡«đź‡· Ă‰lu de Paris.;7378;1517;80749;15578;105222
french_renmin;Quotidien du Peuple;Ici les politiques et points de vue des autorités chinoises + l’actualité et le positionnement du pays liés aux enjeux internationaux. J'aime et partage !;22455;82;82528;138;105203
Humans_DoBetter;🌻🕊️ Will Humanity Do Better 🌻;Humans can do better. Let's try more.;6114;269;91;98590;105064
valmasdel;Dr Valérie Masson-Delmotte;"PhD, climate scientist @CEAParisSaclay @IPSL_outreach; co-chair of @IPCC_CH WG1. Tweets are my own. I like birds, books, e-bike commuting. Vegetarian.";14180;6785;75999;7991;104955
jp_jabot;Jabot Jean-Pierre;"Cynique et révolté... parfois
Pas de messagerie privée SVP! Merci";53444;146;370;50987;104947
YoussefDoghmane;Youssef Doghmane;"Enseignant 

#Paris20
.
""L'éducation est l'arme la plus puissante que vous pouvez utiliser pour changer le monde"" (Nelson Mandela)
.";47775;677;2027;54373;104852
Mouhamadaminee;Optimiste;ronronne;32721;997;2238;68691;104647
irukanji_invest;Philippe J. Bourcier;"Business Angel / CTO Freelance / Maker / Fondateur #FRnOG + #MAM
VendÃ©en ð Ãpicurien 4xð
Pro-* : #Internet #IoT #SSI #science #santÃ© #agri #â¢ï¸ #Art #ironie";35824;1948;2136;64654;104562
crac221;Dr Pinky Blinders Phd 👨💉🇺🇦 🦗 📐✊🏿 🇪🇺🌈🕊 ⚧;Témoin de Jéhovax. Culte à but humoristique et subventionnaire. Coïncidologue. Si c'est très grave, c'est sûrement très vrai. 🕊 . 🌈;53177;1607;963;48684;104431
manu44700;manuella Bertin / Épicentretour2023 ❤️😇;"N'abandonne jamais mes rêves mes objectifs
mes passions.😉
@MPokora soutien son  actualités mon ange Matt depuis 2003 et aussi également les autres artistes ❤️";43429;699;489;59773;104390
Kellian83719913;Kellian;etre moi;33290;1632;1233;68216;104371
tisyamukuna;Tisya Mukuna - La Kinoise;"Forbes 30 under 30 
- Fondatrice du café La Kinoise @cafekinoise ☕
- Vice-Présidente Nationale Jeune Entrepreneur @FECRDC 💛❤💙";16439;1800;51853;34275;104367
unwomenafrica;UN Women Africa;@UN_Women / @ONUFemmes is the UN entity for #GenderEquality and women’s empowerment. Tweets in English and French are from our offices in Africa.;16056;2755;80017;5234;104062
ze_flower;ThierryTexierLafleur⭐️⭐️🇫🇷;Thierry Texier Lafleur. #RSE - La Journée #solidaire, les collectes #solidaires & référent #Handicap #Bienveillance #Respect #GroupeBPCE #Inclusion #womenintech;31405;760;1285;70517;103967
GillesMoalic;Gilles Moalic;Chef de service et Urgentiste multitâche à Angoulême. Créateur de contenu de tes 1ières hs aux urgences, de vocations d’urgentiste et de filières de soins;29867;2752;3565;67750;103934
jacquesantoine;mathiou JA;"Citoyen Marseillais Nul en orthographe
#amish
#islamo-gauchiste #juedo-bolchevik
#khmer-vert
#pasteque
#EcoloDuDimanche";27748;688;1085;74366;103887
auvergne_infos;Aimable Auvergnat;Je retweete tout ce qui parle d'#Auvergne préparant la domination du monde par les bougnats;97454;418;5837;102;103811
nataliadagnese;Natalia Da;femme à la défense de l’environnement et la justice sociale, canadienne, latino-américaine, humaine, toujours pour la paix ,☮️🌍;49971;297;485;53051;103804
benoitpraderie;Benoit Praderie;Energy & territories, renewably (but not only) - Personal;42275;4327;1902;55255;103759
jenesaispasmec;𝗰𝗵𝗶𝗯𝗶 𝗰𝗵𝗲𝗽𝗮 ☀️;Éternellement en joie pour un jour sur la terre ❤‍🔥;18324;591;5738;79066;103719
trtfrancais;TRT Français;Retrouvez l’actualité internationale en continu 7/24 sur TRT Français, le média numérique de proximité.;10155;14;93457;0;103626
Laurent__l;Laurent L φ - ✌️🔻;Complotiste Anarchiste Anti républicain de l'extrême gauche de l'EG, islamo gauchiste ennemi de la république terroriste intellectuel et ayatollah khmer vert.;33658;5000;3371;61579;103608
Le_Madridiste;🇹🇳🇧🇪 SUPER LEAGUE IN;@realmadrid ⚽️ | @Cristiano 🐐 | @MercedesAMGF1 🏎 | #FreePalestine 🇵🇸;57730;1519;1665;42586;103500
TMocilnikar;Tristan Mocilnikar;Transition écologique - Sécurité;49525;5010;917;47967;103419
sacharner;sacha ☀︎;"23. artist🌼 fr/eng 💕 (iel/they) 
kirby fan, draws pretty girls and dragons ✨
portfolio : sacharner.tumblr.com";33653;813;847;68064;103377
ming_lilian;ZA SABLINU --Kalyima--;"pp by nitter.net/Oph2theworld

""Be strong in the belief that life is wonderful. Be positive and believe that the Revolution will always win.""
-V. Sablin";7649;396;430;94810;103285
SGBenot1;StÃ©phanie G.B ð´ð¾ ð±;"Aime la nature, les chiens, les chats, et les chevaux.
NÃ©o rurale...depuis un bail!";64825;671;1129;36466;103091
CHIRATChristop1;Le Collectif Les Pendus - Commerces, Restaurants..;"Depuis 2014, défense bénévole des Commerçants Restaurateurs Libéraux ! 
antigone-france.com
SECOURS : @antigone_france notre syndicat !!";17697;2096;10121;73159;103073
FranceNews24;FranceNews24;ð Les infos franÃ§aises et mondiales 24/24 & 7/7 365/365 ð²;71520;4959;23596;2990;103065
RousselBrigitte;brigitte roussel;;75678;158;261;26941;103038
RolandRabeau;Roland Rabeau ð»;"Conseiller municipal #Clamart, #EELV, BED @eelv92 ðªðº ðºð¦ ð¹ð¼
Ecologie & Urbanisme ð³, EAE, ENSTA, D. Sc.";38093;1382;5191;58248;102914
Bretooc;FBI de GRD;INDIGNEZ-VOUS ð«ð· Macron : Raconteur dâhistoires et manipulateur : piped.video/SlciL62fMrYaYAnHSjOâ¦ - Gauche antilibÃ©rale â;40186;2687;1412;58616;102901
YOUNGKOWALSKI;🇯🇲.;If I was you, I would hate me too. ✨;28841;3273;1550;69167;102831
EchosLeadership;Les Echos Leadership & Management;Accédez aux infos live des Echos Leadership & Management, le média de référence des créateurs, des dirigeants de l'entreprise et des acteurs de l'innovation.;60137;249;42184;220;102790
EriCachecou;jean bartðŸ‡«ðŸ‡·;;10776;464;109;91402;102751
lyonne_fr;L'Yonne Républicaine;Site d'information régionale - Toute l'actualité de l'Yonne et de la Bourgogne - Groupe Centre France - À suivre aussi @lyonne_sports;90638;942;10836;258;102674
bergeredwige;berger edwige;;94924;2365;1720;3463;102472
Stansdits;Antoine Lamanet;;42481;777;794;58281;102333
domhope3;dom Hope#NOWAR#PEACEđ;;24975;2219;923;74084;102201
AmbaFranceMaroc;La France au Maroc ð«ð·ðªðº;"Compte officiel de lâambassade de France au Maroc // Ø³ÙØ§Ø±Ø© ÙØ±ÙØ³Ø§ ÙÙ Ø§ÙÙØºØ±Ø¨-  
facebook.com/lafranceaumaroc @clecourtier ambassadeur de ð¨ðµ au ð²ð¦";6569;1274;92069;2265;102177
simpforiderr;venus in her philosophic era;rojin stan acc | @sasuukeeh;51014;335;358;50429;102136
Veritiste;Véritiste;« Complotiste » un gage de Qualité.;71539;548;3008;26826;101921
_FacelessM;‘;titi me preguntó;13304;108;138;88361;101911
sergesindani01;Serge Sindani;Journaliste MultimĂ©dia & Reporter #Radio #Web l Fixer I DG @kis24info l @politicocd l @observateurs I đź“˛+243 852 950 529;11998;1032;7457;80938;101425
_laerce;Laerce;je lis les astres et tire les cartes c: les tweets s’appliquent à tous et les prises de commande de tirage ou thème astral se font ici en dm ou sur instagram ♥️;36264;111;20877;44136;101388
NazratatReig06;nazratat;"""CATALAN-NISSART ET PIED-NOIR ""! Chevalier de la SAINTE ALLIANCE État  Pied-Noir, Fédération des Deux Rives,  Volontaire pour la France";60459;5000;1171;34715;101345
JeanLucHasseck;Jean-Luc Hasseck;« Pour triompher, le mal n’a besoin que de l’inaction des hommes de bien ». Edmund Burke;46435;955;1183;52740;101313
Marme_elade;Marme & lade đŻđ»;gauchiste (autodiag);18131;4999;4782;73341;101253
AgChristie2;AgChristie2;Compte personnel, agrégée docteure en biologie, bientôt désagrégée par le système, DM 🚫, #SVT #TeamCocker #TeamSurf 🏄‍♂️#Running 🏃‍♀️;39085;712;4057;57233;101087
Monaby__;ℳُ;𝒱𝑖𝑛𝑡𝑎𝑔𝑒 𝒮𝑜𝑢𝑙𝑓𝑎𝑠𝑐𝑖𝑛𝑒́𝑒 𝑝𝑎𝑟 -🏌🏻‍♀️🧘🏻‍♀️🎾🏇🏻;39280;730;1406;59448;100864
On_lacherien;《On》;“La tolérance atteindra un tel niveau que les personnes intelligentes seront interdites de toutes réflexions pour ne pas offenser les imbéciles” Dostoïevski;46383;4062;6179;44213;100837
Ugobernalicis;Ugo Bernalicis φ;🏛 Député français du Nord France insoumise φ NUPES 🔥 Révolutionnaire 🔻 écosocialiste 🌐 VIRepublique  ⚖️ Justice 👌 Securité 🤝Sûreté t.me/ugobernalicis;19590;1423;61293;18479;100785
qmike5491;qmike549;La politique est le premier des arts et le dernier des métiers.” Voltaire;42144;4254;1874;52457;100729
sosoracle;free fall;cartomancienne clairaudiente ðª¬ âï¸ âï¸ âï¸ ðª¬ consultations fermÃ©es ð®;44222;346;6422;49448;100438
nullepartjeten1;Roque de Lihou;;84319;321;338;15449;100427
JeanMarc312;Jean-Marc ♐ 🌊 👻;"“Il est plus désirable de cultiver le respect du bien que le respect de la loi.”
 De Henry David Thoreau";67970;2660;1900;27884;100414
corsenetinfos;Corse Net Infos;Primu media pure player di Corsica Per voi, incù voi in ogni locu. Premier média pure player corse.  instagram.com/corsenetinfo/;62142;1333;36740;165;100380
cmdtcostaud;Commandant Costaud;Sans boussole, sans rames, sans port à l'horizon, il se laisse aller à la dérive, sans lutter davantage, puisque lutter c'est vivre et que vivre c'est souffrir.;27111;319;107;72826;100363
recou62;Tom Michel;ex Taupin et fier - physique, mathématique, cosmologie, quantique;53746;747;389;45336;100218
MagazineJimbere;Jimbere;"Magazine par, pour les Jeunes & Femmes du #Burundi.
Mensuel/papier, Quotidien/ð«- ð¹- ð®.
Partenaire radio: @KazozaFM.
jimbere@jimbere.org | (+257) 22 280 250";26770;178;73190;0;100138
_Falbala;Cécile Ferrer Staroz 🇺🇦;Mi-Catalane Mi-Bretonne. Influenceuse madeleines au chocolat. #ComPublique #SocialMédia I Copil @cap_com | @MyObservatoire;56628;1105;2693;39704;100130
Marie31918177;Marie;;32908;866;1023;65276;100073
wilfridpailhes;Wilfrid PAILHES;Directeur développement délégué @suez •ex Dir Cab @grenoblealpes • chef cab @PatrickKanner @senat•cab ministériel @economie_gouv •Elu ville/agglo @valenceromans;4668;5139;4695;85534;100036
kendiomukendi64;Kendio;Patriote, citoyen engagé, et activiste. Membre du #Mouvement_National_des_consommateurs_lésés.;2077;1136;491;96135;99839
beauntel;beauntel;La douleur contraint à reconnaître comme réel ce qu’on ne croyait pas possible « Simone Weil;50254;2680;2268;44475;99677
coalitionavenir;Coalition Avenir Québec;"Dirigée par François Legault, l'équipe de la Coalition Avenir Québec veut continuer de servir les Québécois.
#Continuons";22376;2585;67685;7026;99672
rioujeanpierre;Jean Pierre Riou;Regard sur les sources de l'énergie.;44396;1522;6712;46855;99485
Fred281Par;Frédéric Paré;Effaré par la situation. Vieux croulant de la cambrousse, pas directement concerné par la chienlit, mais patriote.;19419;1165;1048;77744;99376
PygarguePirate;Ore ha Pygargue ! Piaf pirate 🇨🇦 🇯🇵 🏴‍☠️ 🇺🇦;Pirate du ciel qui écume les mers se nourrissant exclusivement de riches et autres bourgeois,  🦅, TSA, Unity3D, GMS, UE5, C++, C#,  3D, 2D, indé;46178;1613;1594;49891;99276
Ursulalouve;Ursulalouve;"Who is right in stories revealing 2 sides? Who is right or wrong?
Qui a raison dans les histoires révélant 2 côtés ? Qui a raison ou tort ?
Block 🇺🇦 🇪🇺";35788;1322;1040;61116;99266
cityofgaylight;Nico3300 🇪🇺;Libéral culturellement et économiquement. Serial liker. Though we travel the world over to find the beautiful, we must carry it with us or we find it not.;26562;1898;1598;69136;99194
PierreCol;Pierre Col;"Amateur éclairé de @DucatiMotor et vieilles @Porsche 911 travaillant dans le logiciel depuis 1986.

Ceci est un compte personnel reflétant mes propres opinions.";58161;5312;5564;30141;99178
Castielsewhere;grosse bouffone.;his heart was a useless fucking organ;55871;715;490;42008;99084
patrice_leclerc;Patrice Leclerc - Gennevilliers đ»đ;"Maire de Gennevilliers - citoyen du monde - apiculteur - Auteur de ""Inventons un nouvel art de vivre populaire"" aux Ă©ditions Arcane17";63281;800;7300;27678;99059
Yannzerodeux;Yann MARTIN;"Commercial engrais, ex Agriculteur, Troll, Geek, n'en jetez plus, tout y est, ou presque ... ;-) Mes tweets n'engagent que ceux qui les lisent !!
#FrAgTw";45205;2342;4163;47345;99055
YvesRocherFR;Yves Rocher;Bienvenue sur le compte officiel de la Marque Yves Rocher, Créateur de la Cosmétique Végétale ®;25756;1483;65244;6567;99050
25j00;💔;@PSG_Inside hate acc;60115;80;151;38690;99036
CatherineCroc;Catherine Croc;"ð§: mari, enfants, pts enfants
@UPR_Asselineau pour une France Libre! #Frexit!
-NON aux guerres! NON aux passes! 
Citoyenne Responsable!";32032;396;757;65784;98969
larras_p;Le Pélican;"🥕🥕🥕 
Cogito ergo sum";44541;2065;1329;50908;98843
AKJoana;Joana;Patriote - La #Reconquête ne fait que commencer !#OnEnPeutPlus #ToutDonneRaisonAZemmour #OùPasseLePognon #StopImmigration;60752;2473;1869;33639;98733
OhLaMoole;La Moole đ;25ans dâobservation du bullshit professionnel en milieu naturel, Leader incontestĂ© du CCC Chartreuse Chocolat Club, PrĂ©visiblement PĂ©nibleâą, Blanc & Duveteuxâą;15736;835;785;81361;98717
MALHERBEL;MALHERBE Laurence;cadre territorial adtinet.fr Sc Po Paris #management #écologie, #CollTerr #NTIC #innovation Nous sommes tous des êtres imagineurs P.VALERY 323 PPM;63128;1468;3106;31009;98711
sprinosrk;sprino;fly me to the moon;65495;361;298;32526;98680
leschtroumpffr;Le Schtroumpf;Je reschtroumpf les tweets de @lemondefr en langue schtroumpf.;98326;1;309;1;98637
arkhos94;Arkhos94 #vaccin 4/4đđȘđșđđ»âą;Le blocage des trolls en tout genre est systĂ©matique et sans avertissement.;66142;205;507;31733;98587
PierrotLimongo;Pierrot LIMONGO;"Je suis un garçon très flegmatique.
Étudiant en droit.";1571;1253;507;95223;98554
FranckYonboue;FranckYonboue;candidate for the national Presidency of the #LR party. candidat à la Présidence nationale #LR #2017 #2019 @lesrepublicains;7136;311;946;90114;98507
PerleIrradiante;Gilles-P.|L.;Pour un humanisme globalisé - développement & art d'y vivre : Afrique Asie Caraïbes;73530;4972;1865;17825;98192
Clavie_Sophie;Dominique LAURE ððº ð¼ðµââï¸;"Il faut toute la vie pour apprendre Ã  vivre.
SÃ©nÃ¨que.";51130;1481;424;45123;98158
laure77;๐ฌ๐๐๐-๐ท๐๐๐๐๐ง๐ช๐น๐๐จ๐ฎ๐ธ;J'aime le jeu, l'amour, les livres, la musique, la ville et la campagne, tout, jusqu'au sombre plaisir d'un cลur mรฉlancolique. Bas-bleu soignant son bovarysme.;43389;1003;1922;51798;98112
SavatierJ;Jérémy Savatier 🌍🌻;Co-secrétaire @EELVPB / Conseiller municipal Ascain @azkaineB  /  Ingénieur grand cycle eau - inondations - rivières / née à 332 ppm CO2;27568;1157;1711;67598;98034
LauraPz18_z;Laura P...Z;Twitter tourist.;17399;3826;916;75874;98015
Goudthy5;goudthy;Diaspora africaine;23886;451;334;73316;97987
ClemSenechal;Clément Sénéchal;Militant écologiste, expert des enjeux climatiques. Chronique politique chez @Reporterre. Dans la foule.;20421;1948;31416;44108;97893
korrrig;korig;"Quelle arme brise l'indifférence ? On, c'est un con.
Le plus important c'est le contexte.
Le bon sens c'est de la merde.";15686;107;206;81758;97757
tohruIover;☆lou;love;53020;1103;646;42963;97732
michelsalion;Michel Salion ð«ð·ðªðºð¬ð·;"Communicant, #politique #ecologie #ville #agriculture #europe et la #GrÃ¨ce. 
Venu au monde Ã  321 ppm de CO2. Binational.
corfiote-cosmopolite-poulpophile";40844;2867;1186;52746;97643
BrainlessMonkez;Brainless Monkez;Ne soyez pas victime de l'ignorance, Pensez pendant que c'est encore légal. 🧠 📚;37085;14674;15055;30809;97623
MylGorre;GORRE L'Enemy;Ya basta;39418;548;198;57220;97384
Le65avecSarkozy;๐ซ๐ท๐ท๐๐ ๐ ๐๐๐๐๐๐๐๐๐๐, FP ๐ยฐ๐๐๐๐;๐ซ๐ท ๐ฟ ๐ฅ ฬท6ฬท5ฬท ฬทaฬทvฬทeฬทcฬท ฬทSฬทaฬทrฬทkฬทoฬทzฬทyฬทโ ๐ค๐ช๐ ๐ข๐๐๐จ รง๐โ ๐'รฉ๐ฉ๐๐๐ฉ ๐๐ซ๐๐ฃ๐ฉ  ๐ก๐ ๐ฉ๐ง๐๐๐ฉ๐ง๐๐จ๐ !;81093;5775;8680;1744;97292
Philow457;Philowð¬ð¬;kennyS 1st CS player(imo) #FreeRyRy;15696;1018;138;80295;97147
LiaLiarico;Lia Ras-le-bol !🇦🇷🇨🇭🇫🇷🇮🇹🇺🇦;Abogada, Amo la Democracia, la República, la Libertad Y Respeto la CNA. Antiperonista de nacimiento AntiK por convicción. VOUS N'AUREZ PAS MA LIBERTE DE PENSER.;53927;2247;2099;38793;97066
boubou_super;۞ Super Boubou ۞;;33137;1294;495;62124;97050
Liz131975;LEBRUN Liz;;69358;1414;754;25438;96964
DrArielHenry;Dr Ariel Henry;Compte officiel du Premier ministre de la République d’Haïti | Kont ofisyèl Premye minis Repiblik d Ayiti.;1965;10;94778;130;96883
sefluctuat;Cicindelleğ¨ğµğ;;74572;2888;1547;17746;96753
Galex17200;Michel Renault;"'Vs pouvez tromper tt le monde 1certain temps ; Vs pouvez même tromper qq personnes tt le temps ; mais Vs ne pouvez tromper tt le monde tt le temps' Lincoln";88571;2353;713;4995;96632
WikiScene_Infos;WikiScene Infos;#Actualités #Informations #Presse;96209;0;256;25;96490
directfrigo;Directfrigo Mennecy;ex-pompier de Paris chanteur, écrivain  internet arme de légitime défense, contre des réseaux politico-affairiste qui ont tous les droits... nous non;74054;4042;2555;15835;96486
Real_BornFree;Real_BornFreer ð½;"""Puisque le peuple vote contre le Gouvernement, il faut dissoudre le peuple..""   Bertolt Brecht    ááá¢

Un retweet n'est pas un endossement.";49766;1285;550;44862;96463
StphaneBROSSAR1;Stéphane BROSSARD;;6207;2971;415;86673;96266
_fluoW;_fluoW;Ingénieur EIA;23381;1084;165;71613;96243
Arunachala_1793;ArunachaIa Shiva;"La question ""Qui suis-je?"" n'est pas destinée à obtenir une réponse, la question «Qui suis-je?"" est destinée à dissoudre le questionneur
Fraternité

AMOUR";35371;3982;1622;55129;96104
Marie08979035;El*a*e Carrier;"La vérité toute la vérité rien que la vérité 
Je déteste les mensonges

Je ne réponds jamais aux messages en mp
passez votre chemin";49457;17785;22831;6009;96082
arashiranpour44;Arash Iranpour;"L'adversité fait les hommes et la prospérité fait les monstres. Victor Hugo
République libre démocratique d'Iran avec Le plan en 10 points de Maryam Radjavi";46431;2041;1888;45651;96011
Lyzy5672;Eliza;"Geopolitics, international armed conflicts, extremist ideologies • Mainly focusing on the Middle East #MENA #Terrorism#Security             
#Iraq#Syria";50471;603;1886;42977;95937
NatGeoFR;National Geographic FR;Compte français officiel National Geographic;23986;29;70316;1280;95611
TempsInfo;TempsInfo;❗TempsInfo Actualité en temps réel chaque jour, aucune information à ne pas manquer. ℹ️ tempsinfoprocontact@gmail.com;95246;1;321;2;95570
EspacinsularRD;#PrensaInsularRD;radiocimarrona.out.airtime.p… Medios para construir ciudadanía. Contacto espacinsular@espacinsular.org - espacinsular.org;75128;908;2727;16769;95532
Hemail_79;Michel Lachartre;"Citoyen libre et vigilant - Européen et Méditerranéen / 
Warning: je bloque les geeks qui veulent me suivre uniquement pour alimenter leurs CRM et autres bases.";60898;1005;697;32772;95372
MBellessort;BELLESSORT FORCADE;"#Centriste et Indépendant# A Libre et Resp#Pensez Libre#Rugby#HOSSEGOR#PARIS#BEARN-LANDES
#Tacite #Epictete
#Décide de vouloir ce qui arrive et tu seras heureux";74169;2660;734;17799;95362
aphm_actu;AP-HM - Hôpitaux Universitaires de Marseille;Bienvenue sur le compte officiel des Hôpitaux Universitaires de Marseille, CHU de la 2eme ville de France. Notre ADN : prendre soin, innover, transmettre. #APHM;36075;2347;17998;38899;95319
Eleazar_jd;Éléazar;\\\;33757;300;441;60793;95291
sylvML15;SyML;"⚜🇨🇵✝️🌿📚
🌬L'annado de las pours?Laissons faire la Providence💨CJ ✝                                                     🌬Hic domus aeternitatis JBS ✝";43441;1128;708;49952;95229
jimanel;𝓙𝓲𝓶𝓪𝓷𝓮𝓵 𝓛𝔀𝓲𝓰𝓾𝓵𝓲𝓻𝓪;|Écrivain ✍️|, |Jeune adulte et travailleur de la foi, j’aspire à amener la paix et la guérison à mes prochains, par le moyen de l’écriture.| |Coach de vie. ✍️|;34997;303;1759;58160;95219
euryLP;Edith Le Pont @RenaissanceUE #avecvous;"#Macron2022 @LAREM93 #MajoritePresidentielle #RenewEurope #TousPolitiques @AvecEnMarche #avecvous #Noustous #Ensemble 

Bénévole BPA, Assistante trilingue";37238;5001;2091;50709;95039
SpyMabrouk26;Spymabroukđ„đ„đ„đ„đ„á á á á á á á á á á á á á á á;Humaniste;46318;388;1132;46938;94776
mehmedpacha;Johnny-boy;Je veux pas d'emmerdes.;83298;599;608;10224;94729
Ecrins6;Ecrins🇫🇷 🇪🇺🗻🧗🏿‍♀️;j’ai voté Macron. alpinisme, opéra, cinéphile, épicurien, barbecue, voyages, gros lecteur, déteste la culture woke, les extrêmes de tous bords, Marseillais;67660;3005;6876;17132;94673
MachuArsene;Arsène MACHU;;34217;575;3339;56541;94672
JuRaLex78;Ju, enragée comme t'as pas idée ✊🌻✊;"@JuRaLex78@mamot.fr

Terroriste intellectuelle (selon Darmanin)

Homo sum, et nihil humani a me alienum puto.

Insultes et menaces ➡️ blocage immédiat.";23383;1675;1489;68114;94661
TallerThanSoul;Mad♠️Shad;Mon psy me dit d’ignorer Twitter. Mes amis imaginaires me disent d’ignorer mon psy. Casimir punk. Nounours cannibale. Elégance et mauvaise foi.;79547;945;935;13209;94636
e_Fouquart;Ⓜ️ Emmanuel FOUQUART;Ex-candidat Législatives 2022 | Délégué dépt adj RN13 | C.Régional @rn_paca | C.Municipal de #Martigues | Retraité militaire (@MarineNationale & @Gendarmerie);10311;1609;4278;78317;94515
urbex25;Urbex;đșđŠđ«đ·Fervent dĂ©fenseur du patrimoine et des paysages. Passion Paris đâČïžđłâïž;39634;1496;1098;52180;94408
Mobrooo;đź‡«đź‡· Romain;RĂ©intĂ©grĂ© | EmmerdĂ© 595 jours par macron | 2+2=5 | Pragmatique | #JusticePourLesSuspendus;6978;700;384;86342;94404
KindaNoel;Noël Kinda;Ingénieur Agronome, Économie Agricole, Collecte & Analyse de données. Dieu ne commet point d'erreur !;16314;4686;2193;71159;94352
theodurcan;Pablo Fontecilla;"Covid Hoax Survivor: 0/0 (zero vaccine, zero test)
Christian. Patriot;
Canadian - Chileno fachopobre;
Russian bot in training.
Woodworker.";34399;775;744;58342;94260
diveinaelia;🌟;"ᴄᴀʀᴛᴏᴍᴀɴᴄɪᴇɴɴᴇ ᴅᴇᴄʟᴀʀᴇᴇ ~ ᴘʀᴇꜱᴛᴀᴛɪᴏɴꜱ ᴇɴ ᴇᴘɪɴɢʟᴇ
| ꜱᴀꜰᴇ ᴘʟᴀᴄᴇ : ᴍᴇꜱ ᴅᴍ ꜱᴏɴᴛ ᴏᴜᴠᴇʀᴛꜱ 🫶🏻 |                          

♍ ♋ ♌";31808;326;1520;60599;94253
AlmiraGulsh;Almira Gulsh;"la vie est une chienne. ça tombe bien, j'adore jouer à la baballe.
Bannière par @Celinextenso car nitter.net/AlmiraGulsh/stat…";85538;858;2534;5066;93996
lecairn;Vincent ROSTAING;"Pirate des #HautesAlpes, today en #Sarthe 
Accompagne les individus et leurs idées, les équipes et leurs projets, les organisations et leurs transformations";71256;7821;7573;7326;93976
MarieMonon;Marie;Non hypnotisée ! Réfléchir évite les formes graves du lavage de cerveau ! N’aime pas les animaux en cage ! Ceux qui survivront à l’orage deviendront l’orage.;22920;3878;11030;56062;93890
RigalMichele;Michele Rigalđšđ”ConseillĂšre Nationale ReconquĂȘte;RetraitĂ©e active passionnĂ©e de rugby. Le temps de la vĂ©ritĂ© n'est pas celui des mĂ©dias ou meutes enragĂ©es parceque la vĂ©ritĂ© prend toujours l'escalier...;27246;1054;1191;64256;93747
trulymona_;mona.szn;Chaos is the answer 🧚🏾‍♀️;84267;320;578;8496;93661
StavrosPapaioa2;Stavros Papaioannou;Je suis extrêmement courtois avec ceux qui le sont avec moi, et extrêmement désagréable avec les impolis et les trous-de-balles.;28215;8988;21786;34664;93653
Les_Repliques;Les Répliques;Média indépendant, libre et engagé dont l'objectif principal est d'informer en mettant en exergue des réactions critiques à l’actualité.;6026;2012;85138;428;93604
StephaneLagarde;Stéphane Lagarde;Correspondant @RFI Chine / Ex-Corée, Pékin moyen, gros reporter, cofondateur @Asialyst, proudfather, à prendre avec des baguettes. La radio c'est la vie !;45082;3791;12560;32147;93580
__absennce;Absence;Un gars qui s'ennuie un peu;63180;1983;452;27851;93466
pelagiere;Betty Bloodgood;;33341;1104;1259;57695;93399
colinlebedev;Anna Colin Lebedev;Maîtresse de conférences en démerdentiel à @UParisNanterre. Spécialiste des sociétés post-sov, à la solde du Kremlin ou de l'OTAN, selon les jours. Podcasteuse.;5109;662;84500;2973;93244
14FGerard;GERARD François;"Je cherche la vérité, je ne la trouve pas, je lis, je cherche encore et je dis ce que je pense.
#jambonBeurre
#saucissonpinard
# autrefois je votais Zemmour";32581;3687;1532;55398;93198
jfaix13;đ«đ·jf13;đżđ€;48592;2798;2775;38976;93141
JBOOVII;Commander J.B 🇬🇧 🇫🇷;"On my President's Secret Service
Vodka Martini Shaken, not stirred. 
#Renaissance
#MajoritéSilencieuseRépublicaine
#JamesMarine";37877;2857;5228;47072;93034
cecilealduy;cecile alduy;"Words, Meaning, Politics. Auteur de ""La Langue de Zemmour"" (2022) et ""Ce qu'ils disent vraiment. Les politiques pris aux mots"" (2017). Stanford U. and Cevipof";27554;3288;10076;52049;92967
DanielBoutonnet;DanielBoutonnet;Défenseur opiniâtre de l'Occident, de sa civilisation, de son modèle culturel, de ses Arts et Lettres. #Zemmour/Marion2027;42518;2657;3290;44372;92837
Mairie_Niort;Ville de Niort;Le compte twitter de la Ville de Niort, pour rester informé des dernières actus de la ville.;69357;636;10467;12363;92823
Journal_Palaces;Journal des Palaces;Quotidien de l’hôtellerie de luxe depuis 2004 avec actualités, emploi, ressources... English version: @Palaces_News;87210;181;4638;593;92622
seinemaritime;Seine-Maritime;"Compte officiel du Département de la Seine-Maritime. 
#actu, #agenda, #aides, #inforoute76, #jeux #seinemaritime";9000;701;78769;4134;92604
tradosaure;Tradosaure;Trader, analyste technique, auteur. Ateliers, conférences. Partenaire IG, AuCoffre, ProRealtime. Mes tweets sont des partages indicatifs jamais des conseils!;37255;86;37069;18143;92553
heptsibah;Heptsibah;;53185;105;896;38340;92526
api37;Andréanne 🎵🎶😊;"Mère et enseignante. La jalousie est le défaut pour lequel j'ai le moins de tolérance. Active ici depuis la pandémie.
apiesunshine@gmail.com";23529;1389;1789;65781;92488
Manu_Kerdraon;Emmanuel K.;Formateur, auteur, préparateur de concours, communication interpersonnelle et leadership.;3891;720;418;87335;92364
GrandsMeaulnes;Alexandre Lienard;"Curieux des affaires humaines
Passionné de #jazz, de #littérature et de #peinture
Mes propos n'engagent que moi";22556;3847;696;65225;92324
MaRegionSud;Région Sud;☀️Compte officiel de la Région Sud Provence-Alpes-Côte d'Azur☀️ Le Soleil se lève au Sud ! ☀️;28326;1334;52150;10495;92305
bravomorrayl;Bravomorrayl;Eloges du Monde Moderne, l'ironie en plus pour En Marche.;10288;1430;552;79977;92247
SGazanhes;Stéphan GAZANHES;"Ni Dieu Ni Maître, mais des Principes et des Valeurs.
#RefonderLaSociété
#Handicapé
Compte secours : @ymestre1984";37438;4084;4200;46518;92240
KurejiiU;Kurejii Usagi;"Les fascismes opérants ne sont pas toujours là où l'on nous ordonne de dénoncer avec dégoût. Macron n""est pas mon président.";40202;2046;1010;48893;92151
_athere_;Athéré ⚚;Partisan of direct democracy, libertarian collectivism, eco-anarchism and intersectionality. Libertarian socialism 🌹 Integral federalism 🏴 𝟭𝟯𝟭𝟮 𝗜 𝟭𝟲𝟭;33488;1471;833;56342;92134
TomDrach;Thomas Drach;Chasse, pêche, agri: Une culture qui préserve, une culture à préserver. #libéralisme #biodiversité #LibertéRuralité #ChassePartage #FrAgTw;27025;2803;4607;57692;92127
philippeherlin;Philippe Herlin;Économiste PhD Cnam /Livres #Bitcoin #PouvoirDAchat: vu.fr/RisX /Note #énergie: vu.fr/Nb33 /Textes d'actu éco: vu.fr/qZVa /Arts: vu.fr/cwQe /Vidéos: vu.fr/KiQK;23654;71;58910;9347;91982
AnneliseBocquet;Bocquet Annelise ð­;"Docteur en Biologie SantÃ©, professeur d'hÃ©matologie/immunologie en BTS Analyses biomÃ©dicales.
NON AU PASS VACCINAL ! NON AUX INJECTIONS !";25402;2991;15245;48251;91889
WachsKilian;KW;What should a freeman do ?;19281;730;299;71514;91824
PinkyYellowFox;PinkyYellowFoxyğ¦ğ»ğ¶ğ¼3ï¸â£ğ¸ğ»;Action, rÃ©action ... blocage systÃ©matique antivax, anti-tout et partis politiques de tout poil;48256;1348;594;41556;91754
Kasiuta;Kasiuta;"Afin de détruire un peuple, il faut d'abord détruire ses racines. 
Alexandre Soljenitsyne";43154;129;226;48147;91656
africanewsfr;Africanews Français;Le premier média panafricain indépendant qui présente le nouveau visage de l'information d’un continent en mouvement. For English follow @africanews;44239;329;46895;108;91571
sbangoup_;Sosa 🇨🇲;🇨🇲🇫🇷 ce jeune avec de l’or dans les mains Wardell Stephen Curry II / Lamelo Ball fan account;28101;277;775;62323;91476
LePatis799;Pastry-chef 799;Pâtissier - Chocolatier toujours aussi gourmand rien à changé je suis pour le 100% fait maison et contre le gaspillage alimentaire . 😉👨‍🍳🍰🍫🇫🇷🇷🇪;57624;2791;478;30497;91390
Vivet_Lili;Lilinote @vivet_lili@piaille.fr;"Pharmacienne géographiquement instable.
Indignée, dispersée, engagée. Entre autres.
@vivet_lili@piaille.fr";86931;544;2136;1675;91286
lgrwnh;LGRWNH;Streamer par intermittence sur Twitch, totalement indépendant de toute organisation économique ou politique. Dit parfois des méchancetés pour votre bien.;16880;60;155;73987;91082
chasse_spleen1;Chasse-Spleen;;73042;3950;1589;12488;91069
43_dom;43Dom;For Free...Dom.;47735;49;181;42926;90891
DulezC;ð¿ð¿ il Padrino R! ð¿ð¿;Souverainiste Patriote #UnionDesDroites #Zemmour #LePenð«ð· #Salvini #Melonið®ð¹ #Orbanð­ðº #Trumpðºð¸ #Poutineð·ðº No NATO - No EU - No BILDERBERG !!;32353;4679;4370;49411;90813
fannysparty;Fanny Bouton 🤖;Geekette for life #KOL Robot, IA, Space, Quantum Lead, Experte High Tech and Startup Program Leader @ovhcloud;58845;3934;14683;13338;90800
NicolasZeMinus;Maître Nicolas;"""𝑳'𝒆́𝒎𝒐𝒕𝒊𝒐𝒏 𝒅𝒆́𝒑𝒂𝒔𝒔𝒆 𝒍𝒆𝒔 𝒓𝒆̀𝒈𝒍𝒆𝒔 𝒋𝒖𝒓𝒊𝒅𝒊𝒒𝒖𝒆𝒔"" (Portalis, 1804 - à peu près) | 🔞 Compte interdit aux QI de moins de 18";55719;62;9385;25542;90708
jln942_;jln;doomed | 10US;53845;489;847;35380;90561
ymbaechler;Baechler Yves-Michel;Avocat, économiste - Droit bancaire, financier et des affaires;90023;76;335;35;90469
732bis;Jean Aimarre;đ«đ· AdhĂ©rent pionnier Ă  ReconquĂȘte! đ«đ· Citoyen patriote conscient que la France est en danger. #MacronDestitution. Mes tweets n'engagent que moi.;36386;4323;4310;45322;90341
PresidenceTg;Présidence Togolaise/Togolese Presidency;Fil officiel de la Présidence de la République togolaise;3477;183;85747;840;90247
RugbyAddictFR;Rugby-Addict FR;Tous les articles de #rugby sur 1 seul compte !;82290;2644;3833;1375;90142
GazetteHaiti;Gazette Haiti;Media/News Company;10827;898;78359;25;90109
b_sabric;bertrand Sabric đ«đ·;Vous pouvez ĂȘtre conseillĂ©, Ă©clairĂ© par dâautres, mais ne laissez jamais quelquâun penser pour vous.  #Frexit;19750;1344;913;68084;90091
_pcandlove_;PcAndLove;"Tout ce qui n'est point vert n'est que prose   
ðâð¼ð ð ð³
#EELV #NUPES #ÃcologieSociale #Intervilles et #Casserolatine";28031;728;822;60398;89979
Polynesiela1ere;polynesiela1ere;1ère sur l'information en Polynésie : TV - RADIO - INTERNET;76448;1284;12101;132;89965
Cdenquete;Complément d'enquête;🔴 Des enquêtes présentées par @tristanwaleckx tous les jeudis à 23h sur @france2tv ▶️ En replay sur @francetv 🗨️ #ComplementDenquete;5027;377;82402;2139;89945
EFFICYCLE_fr;EFFICYCLE;#EFFINEWS : retrouvez chaque lundi le meilleur de l’actualité du développement durable ! #MOTIVACTION : découvrez des portraits d'initiatives pleines de sens !;13170;23057;50083;3586;89896
Esprit10Libre;Hélène G 🐢 @JLM2022 - NUPES ✌;"✌ #NUPES 🐢 #Melenchon1erMinistre ✌ #NonVax
Ne plus fuir mais agir ! S'unir pour le meilleur comme pour le pire ! Nous sommes de la poussière d'étoiles...";42191;4999;1898;40762;89850
starry_bin;angélik 🍋;heart shaped box supremacist;17326;143;54;72318;89841
nuke_hero;petit scarabÃ©e atomique ðª²;nuke stan account | fission en attendant la fusion | scÃ©nario N50 Ã  50 EPRs | Ã©co-furieux, anti-Ã©colos problemos ð» | plan Messmer II âï¸ | stop nuclÃ©ophobie â;17133;3493;2446;66723;89795
Djbawlah;Mohamed Osman Alin, Cala.;Consultant in project management and in trade organization, tweeting on good governance. ``Marka war la heelo ayaa talo la heela!`` Somali proverb,;55484;1301;5838;27106;89729
MEUSEFM;MEUSE FM;"1ère radio A du département
Verdun 95.00
Bar-Le-Duc 99.00
Commercy 90.5
Montmédy 92.7
facebook.com/MeuseFM
instagram.com/meusefm/
piped.video/@meusefm6964/f…";85927;651;1949;1196;89723
RobindesChamps6;Robin des Champs;Auteur de la trilogie 2148, méchamment libérale. On y parle de virus, pandémie, faillite économique et avènement de l' AI... quelle coïncidence !!;52151;3617;1015;32896;89679
Eska80;エスカ;フランス人。フリーター。フランスの日本漫画のジャーナリスト。;31751;352;503;56944;89550
enedis;Enedis;"Gestionnaire du réseau public de distribution d’électricité sur 95 % du territoire français continental.
#NouvelleFranceElectrique #TeamFranceElectrique";28205;1728;46047;13545;89525
JCondamine;Jean Condamine 🇫🇷 🇪🇸 🇬🇧 👍🍻🍺🤔🧐😉👌🥂🍾;Il vaut mieux vivre et expérimenter, donner et recevoir, réfléchir sans agir ne sert à rien. Je n'argumente plus avec les trolls. (ils où elles seront bloquées);25286;21717;23666;18627;89296
SabAgape;Sabine _Soutien à Charline, Alex, Guillaume, ...;"🦩🐾 ""Ces lobbys qui nous gouvernent""
@stephanehorel  Lobbywatcher  ⚖🌏

@canardenchaine @attac_fr- Rapport Meadows #Climat";19284;4997;936;63879;89096
Olympetwist;Olympetwist;;17979;590;296;70181;89046
ClintGrease;Clint Grease;#RenaissanceEuropéenne 🇪🇺 #MajoritéSilencieuseRépublicaine #communisteUnJour… #nonAuRetourAlternanceStérile #pourUneOppositionConstructive #EtPuisOnVerra;56148;1725;1861;29296;89030
billon_yannick;Billon yannick;Professionnel et passionné du monde agricole . Révolté contre l'agribashing et les idéologues anti-science en tout genres.#FrAgTw Mes propos n'engagent que moi.;31983;1637;1623;53766;89009
pamelabrown1310;Pamela;La servitude volontaire est une tentation de toujours des sociétés humaines pour se délivrer du vertige de la Liberté.;38695;2923;1963;45364;88945
jmlesstartups;j'❤️les startups;"Ne manquez rien des nouvelles #startup et de l'actualité de la #FrenchTech. :)
Pour ajouter votre startup : shorturl.at/boyMV";23024;3670;15697;46551;88942
ISMTrunks;SEALMI ⓐ;Playmaker 🎮;30611;262;524;57525;88922
Soubi_;@Soubi@shelter.moe;#DevWeb #Drupal en gagne pain / Un de #CesGensLa / #Otaku un peu #gamer / Mastodon : @Soubi@shelter.moe;67503;1123;714;19569;88909
MickaCorreia;Mickaël Correia;"Journaliste climat @Mediapart • Auteur de ""Une Histoire Populaire du Football"" (2018) et de ""Criminels climatiques"" (2022) chez @Ed_LaDecouverte.";12304;2025;46066;28239;88634
Contexte;Contexte;L'info politique dont les professionnels ont besoin đź‘‰ contexte.com;53639;1305;33469;216;88629
Arnaud49179900;Arnaud;Patriote de toujours, pour que la France redevienne belle et respectable;56942;4777;3690;23127;88536
nbouzou;Nicolas Bouzou;Fondateur de @asteresinfo. Président des @Rencontres_AV de Saint-Raphaël. Éditorialiste @lexpress @europe1. Compte administré par la CM de Nicolas.;13611;2017;54726;18172;88526
naughtoine;𝙏𝙤𝙞𝙣𝙤𝙪;"Be kind. Always. Except with the nazies.                                                                                      
Futur travailleur social";45322;1275;1574;40347;88518
SiyanVegan;Eternal Sunshine Ѵ;"Free the people, free the animals. // 
Ce monde n'est pas le mien, même si je m'en sors bien - Oxmo Puccino
Born at 333,9 PPM";37828;1859;969;47658;88314
RCI_MQ;RCI Martinique;Radio Caraïbes International #Martinique. Toute l'actualité antillaise de la première radio de la Caraïbe;50821;801;35342;1333;88297
X345__;Corti l'abruti;Petit informaticien. Je dis beaucoup de bêtises sur les marchés, l'informatique, les neurotransmetteurs et l'immobilier.;46194;1119;4144;36708;88165
MoralPerci;moral perci;actu, blabla et retweet de trucs intéressant;82246;2735;598;2541;88120
enquete_plus;Enqueteplus.com;Enqueteplus est votre site pour plus d'informations en mieux. Sport, Culture, Economie,Politique, People...;75195;1;12786;5;87987
bobbyaxecap;Bobby Axecap;MBA Finance / Childs Foundation / HedgeFund / Trading / Crypto / Titrisation/ Estate đ«đ·đŹđȘđšđźđ»đŹ@Bloomberg fund ratedđđđŠđž;11190;1656;472;74652;87970
FrLeBourgeois;frank LeBourgeois;Enseignant chercheur math/informatique dans le domaine de la vision artificielle par ordinateur et analyse d'images.;26080;1024;1291;59463;87858
B_V_1981;💜¹⁰ Vanille81 ⁷;"Fan Account. She/her
OT7. BTS only / BTS Pop.
Antis/mantis/solos/shippers/ multis army semaine B ⛔️";34225;517;641;52397;87780
UNTalentJobs;UN Jobs · United Nations Job Openings;🇺🇳 We post job vacancies at the United Nations. 💼 Find your new job, internship, consulting contract, or become a volunteer.;74968;964;11282;552;87766
Bibra39;𝑩.𝒁𝒆𝒓𝒃𝒐;{Agent Sportif (MIC-ZS) | Management du Sport/Ordre des Experts Internationaux de Genève, AT-N° 1918-2018};42865;3401;9536;31856;87658
Pr_EChabriere;Pr Chabriere;"Professeur biochimie
opinions personnelles
Informations et humour contre le pessimisme";11742;292;70623;4881;87538
EpicurienB;épicurien- belge;;29676;666;378;56671;87391
eoizenoep;oeizenope;Alter Ego;19183;328;394;67203;87108
leguideboursier;LeguideBoursier.com;Suivez-nous pour les dernières actualités de la bourse, des analyses de marché exclusives et des conseils d'experts pour maximiser vos gains ! #bourse #trading;69796;6624;9743;828;86991
h0v0hys0;Greg - @hovohyso@mastodon.social;On ne donne pas le pouvoir à des gens qui le demandent.;41007;1615;584;43716;86922
charlynours;Heurtebise;QUAND LA LOI N’EST PAS JUSTE LA JUSTICE PASSE AVANT LA LOI;48704;263;196;37672;86835
loireatlantique;Loire-Atlantique;Suivez l'actualité du département ! #LoireAtlantique #DirectLA #MaLoireAtlantique // La Loire-Atlantique est aussi sur Facebook | Instagram | YouTube | Linkedin;8794;126;75502;2403;86825
Reasonabl_Doubt;Douter, toujours et encore.;"L'exercice du pouvoir se légitime par “une pratique quotidienne affectant la vie des individus dans le sens des principes d’égalité et de justice.”

E. Boulaga";49263;148;982;36393;86786
AneeObjFrance44;Dominique ANÉE;Entrepreneur.Pdt @ObjFrance44 Maire-Adjoint Urbanisme&Ville Numérique Carquefou Conseiller Métropolitain suppléant Nantes Métropole. exCandidat ANationale Sénat;58024;540;1120;27098;86782
DeuxKobal;Surement pas Kobal2;"Un peu toxique mais apparemment trop. 
Perdez pas votre temps à troller, les fafs, je bloque à vue.
🏴";27118;431;562;58661;86772
Nicole_Cannelle;RIERA;;85014;121;69;1515;86719
Apollinaire93;Valentin Guillaume;"Président de @TeamPropo #TeamProportionnelle
Conseiller municipal d'Achères
Libéral, centriste et démocrate
#FierdÊtreLibéral
Professeur de musique";23370;1542;1542;60211;86665
telematin;Telematin;1ère émission matinale française. Du lundi au dimanche, de 6h30 à 9h30 sur France 2 #Telematin #4V;39450;291;40649;6247;86637
olivierbianchi1;Olivier Bianchi;Maire de @ClermontFd - Président de @ClrmntMetropole. Ex-Secrétaire National à la #Culture - @partisocialiste #wargames;18146;5871;19693;42774;86484
P_VanDamme_EU;Philippe Van Damme;"Ambassadeur #UE | #EU Cameroun-Guinée Equatoriale | Cameroon-Equatorial Guinea
Vues = personnelles | views = personal.
RTs = pas validation | not endorsement.";19750;1548;43569;21613;86480
kinste23;Njane;;29181;882;495;55917;86475
bernardmartin86;Bernard Martin;Dans la vie, rien n'est à craindre, tout est à comprendre.;7401;576;734;77761;86472
FoissacPatrice;Patrice Foissac;"Dr Histoire médiévale
UT2J Framespa-Studium (histoire de l'éducation). Quercy médiéval aussi ! Cherche et collecte.";20718;744;684;64304;86450
JJPMIL;JJM;"Politiquement très incorrect.
De l'audace, toujours.
Si vis pacem parabellum, si vis vitam para mortem. 
Adepte de la loi du Talion.";52607;1185;474;32109;86375
Mc_Lanne;M-Christine Lanne;đŠDirectrice #Com Externe & #engagements @Generalifrance @THSNFrance | #Risques #Assurance #Climat #RSE #DD #SocialMedia #Digital #Innovation #Art;31934;3480;21104;29798;86316
DeParfouru;⚜ Antoine Brisebard🇨🇵;Patriote, légitimiste, soutien des populations civiles du Donbass depuis 2014.;7846;792;780;76847;86265
FTarlet;Fabien Tarlet ð§¹;"Ãcrivain. Gauchiste apartide. LittÃ©rature de l'imaginaire 
Traducteur littÃ©raire
Mon 4Ã¨me roman, L'Orchandeur: amazon.fr/dp/B0BBDJH2PN";49451;4491;16172;16149;86263
Univers_Alex_;Alex;Énergie, Spatial ☢️🌻🚀 | Étudiant ingé en SN spé télécom;15079;536;358;70287;86260
l_agroeconaute;L'agroeconaute ð±ðª±ð³ð»â;"Ex-ingÃ© Ã©nergie, ex-chef de projet informatique (banque).
Ouvrier agricole. Projet d'installation en maraÃ®chage sur sol vivant et agroforesterie. Bzh.";10062;671;344;75149;86226
Exlibris401;Exlibris40;Amoureux de la vraie Nature, libre et indépendant pour que vive la France !;41179;657;877;43504;86217
Diop_IFC;Makhtar Diop;Managing Director of the International Finance Corporation (@IFC_org), a member of the @WorldBank Group. Son of #Africa.;6041;401;77284;2411;86137
richie3366;Richie - Raphaël;"Dev /(VueǀNuxtǀAdonisǀNode)JS/; regex lover;
he/him";48746;630;33302;3328;86006
MediasFrance;Médias France;Toute l'actualité des médias en France : Presse, TV, Radio. #MediasFrance | DM ouvert - mediasfrance.contact@gmail.com | Insta & Tiktok : @mediasfranceofficiel;70125;138;12509;3215;85987
RomanAude;Aude Le Roman;"""Si vous considérez bien ce que vous êtes en vous-même vous vous embarrasserez peu de ce que les hommes disent de vous""";40791;3167;3882;38064;85904
FAGuadeloupe;France Antilles Gpe;Toute l'actualité de la #Guadeloupe sur franceantilles.fr;47193;763;37510;407;85873
alliounidizlov;alliounidizlov;"Living is easy with eyes closed, misunderstanding all you see. 
Aliencatgender. 
Pronoms : ffppp
Nombre de lavabos et divers (éviers exclus) : 2";11359;331;136;74022;85848
mariannaarras;marianna;โจ shine dream smile โจ ๐ฆ geminicae ๐ผ ๐ณ๏ธโโง๏ธ๐ณ๏ธโ๐;23891;137;520;61240;85788
Dunkerwest;LDzodiak;;80438;4159;569;582;85748
VINCIAutoroutes;VINCI Autoroutes;"Chaque jour, à toute heure et par tous les temps, nous nous engageons à vous faire #BienVoyager !
📞 Pour toute question : contactez le 𝟑𝟔𝟎𝟓 (24h/24 & 7j/7)";39267;854;38608;6906;85635
salefran;salefran;"Reporter Photographe: ðSyrie, Tibet, Afrique, Mexique, Asie, Russie...
Prix Civisme 2006.
ð·
#Handicap
#petitenfantderÃ©sistant
#sturgeweber #birthmark #life";33014;989;2563;49064;85630
CarroueYves;Carroué Yves;Il y a des jours où il faut dépenser son mépris avec économie à cause du grand nombre de nécessiteux (Chateaubriand).;13746;857;454;70544;85601
FR_Conversation;The Conversation France;"L'expertise universitaire, l'exigence journalistique đź”Ť
The Conversation France est un mĂ©dia indĂ©pendant.";40468;1122;41718;2284;85592
DrToudou;Dr Toudou;Docteur en blouse marron, chaussant les bottes et sentant la bouse. #FrAgTw;27983;839;43191;13572;85585
Astrancia7370;Christine B.;"Géo, sensibilisée écologie depuis 50 ans (au moins).
I love Alpes, France, Italie, Europe, India, Himalayas ...
Rech vérité covid, sans se prendre trop la tête";39486;582;600;44902;85570
Faiza_etmoi;۞Faïza۞🇨🇵🇩🇿🇪🇭🇵🇸;"Spéciale en rien, curieuse de tout.
Le mensonge est ennemi de l'humanité
@FaizEnaa";17635;1479;2866;63580;85560
F3Centre;France 3 Centre-Val de Loire;Toute l’info de la région Centre-Val de Loire. Charte d'usage : bit.ly/charteF3CVDL;51101;1578;27916;4951;85546
Poncia_N;Poncia;Résister. Même dans l’adversité. Surtout dans l’adversité.;34422;598;10479;39990;85489
jojofiertE;Joseph Komi Amenoudo;đLa fiertĂ© d'ĂȘtre soi-mĂȘmeđčđŹ;23656;566;1237;59819;85278
NordEclairWeb;Nord éclair;L'actu en direct de Roubaix et Tourcoing;60716;645;23211;523;85095
Panda31808732;Maître Pandaï;« Entre le champagne pour quelques-uns et l'eau potable pour tous, il faut choisir. » — Thomas Sankara;35883;109;24564;24437;84993
Ethique92350;Ethique Plessis-Robinson;Vive l'éthique;47778;134;403;36655;84970
Cobra_FX_;Cobra effect;"I want plans by the many, not by the few.
#free";27115;722;15671;41368;84876
MoroccoCouncil;Australia Morocco Business Council;;54910;4268;963;24682;84823
5ubconscious;Macumbo;"Passionnément curieux - Notre réalité n'est pas celle que l'on croit 
IΧΘΥΣ - 11.12.22
🇨🇵🇨🇱";57463;466;633;26206;84768
BrentnerA;Dame Kaamelott 🇫🇷 🌳 🏇 🦔;"♀️ Nature #AntiChasseCorrida #Gauchophobe #Areligieux #Abstentionniste  
“Parfois, un arbre humanise mieux un paysage que ne le ferait un homme” Gilbert Cesbron";30735;1479;1541;50947;84702
loysbonod;Loys Bonod;"Professeur de... de quoi déjà ?

Profitez comme moi de Mastodon : @DidierJodin n'y est pas encore : mastodon.social/@loysbonod";54539;437;7597;22107;84680
EdouardStenger;Edouard Stenger 🌡️⏱️🌍🔥;French sustainability professional working in #energy & #climateaction for public hospitals | Blogging since 2007 | MSc @Audencia 🇫🇷. MBA @PresidioGrad 🇺🇸;52431;1133;1213;29873;84650
DeadlegCyborg;Calvin Arium 🏳️‍⚧️;il,he 26 ENG/FR Auteur de BD et militant. Autonomie corporelle. Enfant sauvage. Multiaides. LandBack! Hel worshipper. @Calvinarium@kolektiva.social;47542;1644;6746;28685;84617
GauchisteduMEEF;Cla đłïžâđđ»;M2 MEEF. FĂ©ministe radicale intersectionnelle, matĂ©rialiste, syndicaliste, militante et plein dâautres trucs qui font que tu peux me bloquer direct. âïž;5225;791;96;78490;84602
eclemence;ManuBdx;Formateur Comm.Digitale, Ingénieur🎓 Prof Phys, Décrypte l'info à froid #Edtech innovation 4.0 #IA #défense #crypto Vs Conscience Liberté Ethique❤️‍🩹🇫🇷🗽☮✊🏼;24223;2107;2613;55650;84593
amfisherman;van de kamp;thank you and fuck off;35444;238;249;48661;84592
DanielDepaz;Daniel Depaz;Consultant chez #WSI (We Simplify Internet) @wsidom et gérant de #MailBoxesEtc. @MBE_Martinique (Emarketing et Services aux Entreprises) en #MARTINIQUE;73221;4996;1917;4287;84421
neoecocitoyen;jason hunt #lanceurd'avenir φ;Le mensonge est une solution chimique sursaturée : déposez une seule goutte de vérité et l'ensemble se cristallise tout entier autour d'elle, inéluctablement.VS;48280;907;1098;33880;84165
LaRepDpyrenees;La Rép des Pyrénées;🗞 1er quotidien d'info locale en Béarn et Soule, compte 100 % humain ! Animé par @robaly @JC2Pau @Ambre_trn;63754;507;19337;542;84140
Margauxps;🦋;@claraipnida 👩‍❤️‍👩 |@MPokora 💫|@justinbieber 👀 | Spiderman 🕷& BTS a mes heures perdues 🫡;59921;475;373;23206;83975
amadoud98130314;Amadou diallo;CHARGÉ COMMUNICATION DIGITALE DU MAIRE DE KL Mr SERIGNE MBOUP @se_mboup RESPECT DE L'ÉTHIQUE & LA DÉONTOLOGIE #KAOLACK #SENEGAL #Kebetu #Réalisations #Projets;13544;6565;11464;52366;83939
AnneMar83996184;AnneMarie ð«ð·ðªðº ðºð¦ #Macron2022 #5ansdeplus;#RN #LFI et autres extrÃªmes, passez votre chemin , EuropÃ©enne convaincue, EPO;29279;681;629;53278;83867
Nathmanziona39;Nath's✌️🇨🇩;"Économiste quantitativiste 📈📉📊

Dès que tu cesses d'apprendre, tu commences à mourir dixit Albert Einstein";46740;1651;2762;32712;83865
gpmt;michel verstrepen;Information Analyst, Digital Skills expert ( digital & blended learning, AI, IoT ...);75506;4995;3163;100;83764
mathieucordier;mathieu cordier;;34009;302;134;48888;83333
Azzdean;Azzdean ⴰⵣⵣⴻⴷⵉⵏⴻ 💀;;63659;1209;2346;16020;83234
reseau_internat;Réseau International;Site de réflexion et de réinformation;51752;2686;28652;138;83228
Villon_;Villo!;Le vélo ? C'est ma passion :p;24251;1370;198;57393;83212
HepisBenoit7;Benoit 7.0;Stagiaire pôle emploi en reconversion pro;54359;487;658;27673;83177
franceliberte45;đšđ”France LibertĂ©đšđ”;;47778;316;499;34533;83126
RicolotContact;Ricolot#DarmaninEnPrison;"@Ricolot@mamot.fr
#6èmeRépublique";25533;998;337;56197;83065
GRAZIANILaetiza;Laetizia GRAZIANI;Mes 2 blogues 1) Marques Mode & Beauté fabriquées en France labelfranceacheterlocal.word… et 2) Culture politique/générale : Des livres & Nous;16988;753;851;64461;83053
Johanna_Rolland;Johanna Rolland;Maire de @Nantesfr • Présidente de @NantesMetropole • Présidente de @France_urbaine • Première secrétaire nationale déléguée du @Partisocialiste 🌹;12678;1572;64022;4689;82961
EcoSceptique;Olivier Simard-Casanova en français;Économiste & data scientist - Vulga, science éco, scepticisme scientifique, données, USA, mobilités urbaines, exobiologie & Lorraine - @o_sc@mastodon.social;35760;312;14745;32092;82909
VilleCG;Claire Guéville;Prof d'histoire-géo, secrétaire nationale responsable du lycée au @SNESFSU #CSE , Présidente du Comité syndical francophone de l’éducation et de la formation;48044;2055;6517;26260;82876
NicMCtheold;Just Nic;"life is a game.
đŽ Ancap individualist

pronoum? you blind or just dumb?

yes i'm far from you";49338;998;652;31743;82731
ctardivel;Christophe Tardigrade;"En version 2.0 de ma vie depuis le 6/12/2014. #DoubleLungTransplant #ALPHA1 #IRC #dondorganes #MerciLaVie #Pourvuqueçadure  
✊🏻✊🏼✊🏽✊🏾✊🏿
Un peu moins là...";29718;732;572;51654;82676
SMaroufle;Sylvain Maroufle;;11163;2320;269;68874;82626
CZacharopoulou;Chrysoula Zacharopoulou ­čç¬­čç║­čçź­čçĚ;Secr├ętaire dÔÇÖ├ëtat @francediplo charg├ęe du d├ęveloppement, de la francophonie et des partenariats internationaux. ­čçź­čçĚ­čç¬­čç║;6908;2610;23337;49746;82601
cassouman40;Christophe Cassou;"Directeur de Recherche @CNRS, Climatologue
Auteur principal 6e rapport #GIEC/@IPCC_CH 2017-22
CoFondateur @TrainDuClimat
Tweet perso";7250;1485;51337;22477;82549
corynenicq;Coryne Nicq ✨;"#dircom free #chasseusedesignauxfaibles #administrateur.e indépendante
🎈dg @UMANAO_exp 🧠 co-fondatrice @EntrepreneurAv🌱
#i4Emploi #AdnCitoyens
#RegardOblique";40717;2196;10813;28814;82540
SpockPQC;SpockPQC;Papa 3 fois et Ph.D. en génie⚡Pragmatique d'extrême centre⚡Jadis modérateur chez politiquebec.com/forum;73526;842;622;7531;82521
Sors2cecorps;mouradidi ð°ð²;Le cÅur grand ouvert mais les centres d'intÃ©rÃªts restreints... TrÃ¨s restreints ð¤£;2125;94;74;80131;82424
_LuCaS_tS_;Lucas Jetski ;Tech&News  | et désinstallez TikTok !;3978;219;309;77910;82416
Mikaa_H2;Mikaa Mered;Analyse + enseigne l’hydrogène (marchés, diplomatie & géopolitique) @SciencesPo & @UM6P_officiel | Tuteur Environnement @EcoleDeGuerre | @Editions_PUF @IAHE_GH2;11791;187;10914;59521;82413
VincentMigeat;Vincent Migeat;Corse-Ardéchois de coeur, français de naissance et citoyen de raison. Philosophe à ses heures perdues. Photographe à l'agence VU'.;59073;1653;1522;20015;82263
RJD_666;☠️Heavy Metaller ☠️🤘;;22887;879;642;57835;82243
musema_kweli;Espe Ngongo M. Ukweli;"Doctorant en Technologies de l'information,
Maitrise Sc. en Technologies avancées de l'information et gestion des affaires (University of Wales)";28192;568;1459;51860;82079
babonnay;rossel;"Piéton de Paris. ""Notre pays tel qu'il est, parmi les autres, tels qu'ils sont, doit, sous peine de danger mortel, viser haut et se tenir droit."" CdG";66639;1409;1247;12735;82030
F3PaysdelaLoire;France 3 Pays de la Loire;Le compte officiel de France 3 Pays de la Loire đź“ş Orange/Sosh 320 | Free 321 | SFR/Red et NumĂ©ricable 450 | Fransat 314 | Canal Sat 369 | Bouygues/ Bbox;48881;1053;29594;2378;81906
Mulunda_JC;J-Claude MULUNDA;MD, PMP Certified #WomenRights & SRHR Activist. @IpasOrg DRCð¨ð© Country Director  #Mari et #PÃ¨re #PersonalAccount;27770;3334;8218;42546;81868
Arxnonyme;ðª Ouragan;Beatmaker ð¹ / Arsenal Opinions (ici ð¤·ââï¸) & Community Manager lÃ -bas (@Arsenal_FRA) ð´âªï¸;42395;555;686;38135;81771
Mogwai92;Le Gremlin;Je vis chez une Maine coon;38821;10220;10605;22111;81757
Figaro_Etudiant;Le Figaro Étudiant;Retrouvez l'actualité et les conseils de la rédaction du Figaro Etudiant 📚🎓🔍🤗;30854;917;47740;2244;81755
ctvm;CTVM info;CTVM info, le quotidien québécois des professionnels du cinéma, de la télévision et des médias numériques. Jean-Pierre Tadros et Liliane Tremblay;36110;1058;3964;40440;81572
enilordnA;✨Androline;Caroline, 30 / Mad dreamer 🇫🇷Louis’s mom💖 030820 . waiting for Ben Barnes to marry me.👀;45340;276;862;35032;81510
Camarade222;Товарищ 222 ☭ 🚩🇨🇵;"Communisme : 'le mouvement réel qui abolit l'état actuel.' Marx.
Comment les communistes ont transformé le monde : piped.video/FvSLXt32NW0";34632;1124;484;45189;81429
75_bishop;oliver-Bishop;Qui s'y frotte s'y pique... #Culture #Libertés #Eveildesconsciences #Sophia #S.Libertaire #Surlepave #Justicesociale #Antisectes;18907;913;508;60976;81304
etpisquoiaussi;Robert Dupontđź‡˛đź‡«đź‡Şđź‡ş;"Avant les idiots dĂ©versaient leurs stupiditĂ©s  au bar. On les virait et c t terminĂ©
Aujourd'hui ils sont sur les RS et leur voix est la mĂŞme qu'un prix Nobel";54390;4384;2239;20267;81280
JouveauM;Marie Jouveau;Architecte et urbaniste du patrimoine « L’efficacité, ça ne se présume pas, ça s’évalue » #teamarchi mes tweets n’engagent que moi;22484;1398;2548;54771;81201
Mphala12;Méphala ☭🚩🏳️‍⚧️🏳️‍🌈🇲🇫🏺🦈;"En un monde de vieux parchemins: Daedroth androgyne du sexe&de l'ambiguïté.
En ce bas monde: Léniniste radicalement progressiste, p'être libertaire p'être pas.";32290;1428;1007;46349;81074
BigMedicine;Hal Newman;Curator, The Last Ambulance project - La Dernière Ambulance. /  I see you. I see your good works. I see the difference you are making in the world.;50236;6108;5572;19078;80994
MLMontpellier;Midi Libre Montpellier;Info / Culture / Jeunesse, suivez toute l'actualité de #Montpellier avec Midi Libre !;43662;300;36150;841;80953
nocomment71;Louis Ferron;;23636;1645;1277;54362;80920
placmuche63;Pierre Lφ,🐢🔻🆙 ✌️#Judéobolchévique, #NUPES;"Retraité privilégié.  Pour la fin de tous les systèmes politiques basés sur la domination.  #JeSuisSocio  ,
#LFI #NUPES , @plac63@mamot.fr";36608;3441;2008;38811;80868
tim_ide_;Chicago boy;thirst trap, pole dance & Chicago - 🇺🇸🇫🇷;36222;961;5549;38088;80820
evs_ic;ICEvsLAND;;1770;104;77;78856;80807
amibiaka;Amine Idriss;"PhD Candidate-École des Ponts Business School (AFRIQUE-SCIENCES- ""défendre la rationalité contre la pensée magique, promouvoir la science contre les croyances"")";14868;2702;44704;18482;80756
laurentgallois;laurent gallois;Après 4 ans à la Régie Renault et 34 dans le transport ferroviaire (maintenance matériel et conduite métro/RER), je plie les gaules et garde un regard attentif;42286;861;2514;35021;80682
muriel850;anonyme de la france souveraine;bon ben twitter sera géré par le nom autant dire qu'on ne pourra plus rien dire ...;36919;4151;3523;36016;80609
Naelye;Nana;La killjoy préférée de ta killjoy préférée | Je streame tous les jours ici : twitch.tv/naeiye;68857;461;1994;9265;80577
sbellenger;Stéphanie Bellenger-Heng 💙💛;ex-Élue CSDM. Droit & RI en télétravail. Mère de F12, engagée, justice sociale, éducation, inclusion. Maintenant/Now mstdn.social/@sbellenger;40214;3533;2448;34137;80332
denoticias;deNoticias;Noticias sobre turismo, hoteles, viajes y ocio;75981;509;3414;392;80296
DeadshotRcs;Deadshot | BLEACH ๐ฃ 08.07;๐๐๐๐๐๐ ๐๐๐๐ ๐๐.๐๐ | ๐๐๐๐๐๐ | ๐๐๐ | ๐๐ฅ๐ฎ๐ ๐๐จ๐๐ค | ๐๐ฅ๐๐๐ค ๐๐ฅ๐จ๐ฏ๐๐ซ | ๐๐๐ | ๐๐ก๐ซ๐๐๐๐๐ซ | ๐๐๐ฒ๐จ๐ฎ๐ญ @Lv_kuchiki ๐ธ;31751;410;855;47251;80267
Linoxhan;Soonie | ID | love or loved;ikon ot7 ✨skz✨day6 ✨Ateez ✨got7 & more;32869;706;673;46017;80265
OlivierHochstr1;Olivier Hochstrasser;Râleur;35011;4970;1313;38881;80175
BABONKSTINI;matières premières 🏜🛸;live for today , gone tomorrow - artistic director;9290;561;122;70191;80164
Pauline_RF;Pauline Rapilly Ferniot;"Conseillère municipale écologiste à #BoulogneBillancourt
Se déplace sans avion, en ce moment à Dakar";13427;3044;19027;44657;80155
vincent_philion;Vincent Philion;Enverdeur. Papange. Views personal. Low tolerance for antivax, AGW denialists, I despise Trump or Elon Musk fans;18334;892;461;60463;80150
XRP_QC;C.R.E.A.M.;Cash Rules Everything Around Me. Le 1% des gens possèdent les richesses.. 99% pensent tout comprendre. Alors on continuent de tourner en rond?;34763;1232;2530;41541;80066
FAMartinique;France-Antilles Mqe;Toute l'actualité de la #Martinique sur franceantilles.fr;39200;974;39009;735;79918
RoudautJeanne;Jeanne Roudaut;Approfondir le discernement est un exercice quotidien;38495;412;463;40350;79720
ZeuStef;ZeuStef ™️;"Karl Marx akbar
#IslamoGauchiste #insoumis";50560;1738;3372;23786;79456
EuropaMagnifica;Un baron fou;Si ils prennent les rênes de l’humanité, alors la terre sera privée de ses habitants et recommencera à tourner, seule dans le vide et le néant intersidéral.;44997;1156;1687;31615;79455
Nouvelle_Donne;Nouvelle Donne;Le mouvement politique pour #ReprendreLaMain ! đ  Ătre Ă  la hauteur des enjeux face Ă  l'urgence climatique et sociale. đ±đȘđș;24457;3230;21769;29992;79448
CarenewsCom;carenews.com;Carenews, le média des acteurs de l'engagement #ImpactJournalism #Mécénat #Philanthropie #Associations #Fondations #RSE #ESS #Engagement #IntérêtGénéral;34176;2436;14195;28606;79413
CGN_FR;CGN France;Compte officiel de China General Nuclear Power Corporation, le plus grand fournisseur d'énergie en Chine et le leader mondial de l'énergie propre.;799;32;77895;653;79379
KolieGoikoya;Goïkoya Kolié;Juriste. Passionné de politique.;41859;12370;11245;13857;79331
TimeTraveIer_0;TimeTraveler_0;Soyez gentils avec les gens autour de vous;58079;240;255;20757;79331
RaoulCAYOL;Raoul louis CAYOL;;55403;4976;3793;15156;79328
BrownBaklawa;هشام;"🥄Algérien ; Arabe ; Anticolonial. 🍉";18118;4977;492;55683;79270
MSJF21;ðððð;ð... ð¡ð¢ð³ðð«ð± ð©'ðð±ð¢ð¯ð«ð¢ð© | Tous les dieux,tous les paradis,tous les enfers sont en lui, Il incarne si bien la puissance du Mythe;30374;1522;1067;46243;79206
Kako_line;Kako;Scientifique, femme de convictions et fière de l'être. Travaille dans le Génie Civil et l’énergie. Responsable com scientifique de l’association @7eContinent;29180;449;30890;18654;79173
el_morce;MrPropre;;26612;471;178;51881;79142
SparkyKV;JoeChip;Laïc. Athée. Obscurantophobe.  Ni facho-ni bigot. Ni FI-ni FN. #JeSuisCharlie;22740;1289;487;54480;78996
ShaeCald1;Shaé;aime la culture, la liberté et la justice (ça fait beaucoup !);51213;1402;573;25756;78944
violaine143;MacVio;Liberté, Équité, Solidarité...! Une civilisation ne commence que là où les puissants traitent les faibles avec dignité et humanité.;45398;2010;600;30929;78937
timeoutparis;Time Out Paris;Avec Time Out Paris, retrouvez l’essentiel des arts, de la culture et des sorties parisiennes.;18198;1037;58716;850;78801
LEWISTRUDEAU;Trudeau Pierre-Louis;LL.L. 1976 (Droit). DÉSS 1988 (Droit international). DÉSS 2010 (traduction juridique). Membre ACJT. UNEQ. Auteur. Agent. Éditeur. editionsmontroyal.com;56568;5007;3144;14053;78772
GaudetteMario;Mario Gaudette;Métis de 5ième génération ou blanc :), curieux, informé, connaissances, athée, scientifique. Valeurs, principes et si il le faut on s'adapte...;25617;292;286;52530;78725
CaluGuillaume;Guillaume | Louernos Nature;#Biologiste (PhD). Blogueur #Biodiversité et #Ecologie. Fan #Ornitho #Entomo. #Darwin & #Évolution / Auteur du @Voyage_Darwin #VoyageDarwinBeagle;31859;999;4393;41450;78701
ChamboncelLea;Léa Chamboncel;"Political Journalist with a Feminist POV 🎙️✨🏛 @PopolMedia @LCP @Backseat_fr

Author ✒️ 📚 Plus de femmes en politique !";7548;1534;51331;18182;78595
AlamedaLamelune;Alameda;Je dis souvent des trucs stupides et parfois dans des éclairs de génie des choses sensées;13761;351;51;64375;78538
hellopopoyeyo;yakak;When Diamonds Aren't Forever. 🌒;16747;554;99;61054;78454
ericvidalenc;eric vidalenc;"Auteur @edtPetitsMatins
Blog @AlterEco_
Conseiller @futuribles_int @Andra_France
expert @horizonEU 
& LBNL @ademe
#energie #climat #prospective #numérique";33356;990;10213;33877;78436
tomroots;Tonton Mesca 🌶️🥑🍗🍻;Saucilluminati/CarpeMage;19098;705;268;58332;78403
anna_tambo;Anna alonso tambo;Represéntante du Président Fédération Française des Ports Plaisance FFPP en Catalogne;19122;2671;733;55839;78365
HochonPaul2;Hochon Paul;;42884;236;338;34889;78347
MocquardThomas;Bleu (de Prusse);Je pense, il paraîtrait donc que j'existe. Mea culpa, mea culpa, mea maxima culpa!;61975;614;1212;14479;78280
piRdumont;Pierre Dumont ð¥;Lobbyiste des vÃ©hicules Ã©lectriques & hobbyiste des Ã©nergies vertes ðð âï¸âï¸ð¬ï¸ððºð¦;8136;484;1080;68543;78243
asapzeld;Enzo;16 /;66967;515;222;10438;78142
psst_;Opinions & Tendances;Plateforme d'échange interprofessionnelle autour de l’innovation digitale et responsable à portée écologique by @jeremydumont;57319;10827;9637;338;78121
BertRacicot;Bertrand Racicot ⚜️🇨🇵🇨🇦;photos , journaux,  Montréal,  Québec,  Canada;57444;43;446;20183;78116
AdamGlamoour;AdvmđȘ;âł;6788;767;147;70380;78082
IESEG;IÉSEG;Grande Ecole and top #international Business School with #TripleCrown accreditation:#EQUIS #AACSB #AMBA. All programs in English. Top-notch #research with #CNRS;42979;754;10154;24168;78055
slovar;slovar;Blogueur, motard et râleur ...;60380;491;2890;14285;78046
Patracklamatrak;pat-le-nerveux φ;pas d'accord ac ce q vs dites mais je me battrai pour que vs ayez le droit 2 le dire. j’ai le droit aussi 2 me foutre 2 votre gueule;17712;3141;2395;54687;77935
USBEKetRICA;Usbek & Rica;"Le mĂ©dia qui explore le futur đ
Abonnez-vous đ bit.ly/32Xosd5
OĂč nous trouver đ bit.ly/3kDPVsl
Contribuez đ bit.ly/34mJp1Z";27531;1412;45267;3661;77871
outremers360;Outremers360;Toute l'actualité des Outre-mer à 360 ° #outremer;58140;1097;15035;3528;77800
ClaireLuminus;Claire Luminus;;15905;1446;1161;59234;77746
oim781;Steph16300;"Par la, mais souvent allieur entre barbezieux et AngoulÃªme Charente 16.-ð
Mon telegram :@oim781";59712;413;217;17351;77693
banquedefrance;Banque de France;La #BanqueDeFrance est une institution indépendante. Ses 3 grandes missions sont : la stratégie monétaire, la stabilité financière, les services à l’#économie.;20667;236;55299;1388;77590
EPLF_fr;IRDEME . EPLF (Entrepreneurs pour la France);La Démographie des Entreprises portée par des chefs d’entreprise. Revue de presse quotidienne vue par IRDEME/EPLF!;24665;1288;2522;48992;77467
conanfredleseul;Conanfredleseul ©️;Developer for game and programs on phobia  treatments for psychologists.;32565;389;1896;42537;77387
fibladifr;fibladi Algérie;L'actualité de fibladi.com;75764;171;1389;1;77325
NicolasTscr;サトテル fan account;;65734;779;807;9984;77304
departement13;Département des Bouches-du-Rhône;Au coeur de nos actions pour les Provençaux #solidarité, #économie, #sport, #culture, #jeunesse, #transport, #santé, #environnement...;15270;1244;29380;31365;77259
ValentinBlly;Valentin ð³ï¸âð;"ð³ï¸âðð¨ðµðªðºð¹ðð»
ProfondÃ©ment Socialiste, Ãcologiste, DÃ©mocrate, Anticapitaliste et Antifasciste â¢ Dyslexique â¢ Moins de travail pour plus de temps libre";3421;2293;295;71154;77163
tdgGeneve;L'actu genevoise;Toute l'actualité locale de la Tribune de Genève @tdgch #TDGInfo;63084;165;13839;70;77158
LemoineSbastie2;SebXrider;"Admin de Go Nagai, Go !,  fan de Soulcalibur.
STU (03) & EnÉdu (15)
DiaMaNt
«Là comme en Union sov. on aime aussi peu s'entendre dire la vérité.» (Para Bellum)";33163;311;352;43167;76993
fabxrider;FabX;Avant, je prenais la đ, tout le tps. Maintenant je prends le đČ en ville et petits trajets, la đ uniquement pour les longs trajets. @FabX@masto.bike;32049;749;767;43424;76989
laKritic;đ;;39595;3289;390;33704;76978
MagaliReghezza;Magali Reghezza;Géographe. Environnement, risques et catastrophes, résilience et adaptation. @Ens_Ulm. @hc_climat. Compte personnel.;6654;907;21886;47457;76904
K20LeFlowlower;Kévin Caoimhín Coemgen Lartin 🇫🇷 ⚜⚜⚜ 🐓 ✝️ 🇷🇪;"Menuisier, Bohémien.
.Le Triboulet D'Angely.";49365;1307;588;25554;76814
lecese;CESE;"Suivez l'actualité du Conseil économique, social et environnemental, la troisième assemblée de la République
Organisateur de la #ConventionCitoyenne";22270;2531;46855;5153;76809
__Idiotix__;Mathrix;"plus facile d'aligner des équations que des mots. Bienveillance dans le second degré, non-violent. Chemisette et tongs
Mastodon : @__idiotix__@mastodon.social";37723;421;478;38180;76802
Ines_el_;Ines El;;21178;301;254;54982;76715
JfRBabin;POTATO ARMY 🪖;;56310;1277;1005;18093;76685
CCI_Paris_IdF;CCI Paris IdF;Acteur majeur de l'économie régionale, au service des #entreprises, des #jeunes et des #territoires d'Ile-de-France. Président : @d_restino;34565;2040;29225;10845;76675
IFC_fr;IFC - Société financière internationale;Compte officiel en français d'@ifc_org, filiale du Groupe de la @Banquemondiale, qui travaille avec le secteur privé dans les pays en développement.;2842;260;70067;3468;76637
Jmchataigner;Jean-Marc Châtaigner 🇪🇺;Ambassadeur de l’Union européenne 🇪🇺 auprès de la République démocratique du Congo 🇨🇩 @UEenRDC @eu_eeas #UEdansleMonde #ÉquipeEurope #StandWithUkraine;26919;594;49068;50;76631
ElisaFavre69;Favre Lisa;;770;48;125;75643;76586
ShemboMorgan;Sir Morgan Shembo;Serviteur de Dieu, engagé pour mon pays 🇨🇩et pour le Royaume de Dieu✝️  #Mes tweets vous engagent;13849;2777;6644;53239;76509
GloBackita;M. GIUSEPPINA GLORIA;;38023;2533;1216;34702;76474
baceau;Mister baceau;l’actualité financière et crypto c’est ici !;70591;2856;621;2319;76387
mdemeaux;Mickaël Demeaux;"Journaliste @EBRApresse / Directeur départemental de Meurthe-et-Moselle @lestrepublicain #Nancy #Toul #Lunéville #PAM /
Chef #Web 54 et 55 / Corres @Le_Figaro";56389;3818;4147;12018;76372
ROCHEFORTPierr1;Pierre-Etienne ROCHEFORT;"Aussi courtois et respectueux avec les gens qui débattent
Qu'infecte et odieux avec les trolls qui profs-bashent 

reformesblanquer.fr";29719;3035;2569;41027;76350
CLOUTECHRISTIN2;CLOUTE CHRISTINE;"IDE 87, libéral, privé, public ...DU autisme 2019 ; vécu sang contaminé,Médiator, Hormones de croissance ... PRIMUM NON NOCERE     quoiqu'en dise Fabius ..";40060;705;865;34698;76328
HespressFr;Hespress Français;Quand l'actualité vient à vous !;61938;2;14343;3;76286
BridgetPTh;B One đđđ;"EX CITOYENNE DEPUIS LE 5/01/2022 
NO PASS 
""L'ignorance est comme l'ocĂ©an, quand elle est profonde, la lumiĂšre ne peut lui parvenir.""";5588;2763;1312;66546;76209
Philoufish44;Philou Normand;Ingé génie indus et informaticien, fan de technos 🚀🎛️📷🛠️🧬🔭🛰️🌱 Soucieux de la santé de la 🌍🌡️ 🥺 #NoFakeScience;9678;818;345;65305;76146
Lauwette77;Laure Martin;Aime la vie, elle t'aimera | #Formation #Pédagogie #Inclusion #QVT #Santé #Gouvernance #Sport #Cinéma #Culture : Co-fondatrice Filmezlesport.fr;34424;1906;2920;36889;76139
FestimagesNatur;CHAUVIN Yves;Concepteur, organisateur Festimages Nature : 1er #concours photos nature numérique en France parmi les 7+ en Europe instagram.com/festimagesnatu…;40261;1374;1418;33083;76136
serge_amar;Serge Amar;Adjoint au Maire d'Antibes. Vice Président @maregionsud artisanat commerce Tpe Pme;23004;597;1592;50917;76110
Marhabal;đđ«đ·đȘđșđ€đșđŠClisthĂšne đđ;Democrate, laconique, AthĂ©e, Charlie, UE,OTAN,conducteur de car, VaccinĂ©, Gauche KeynĂ©sienne, anti libĂ©ral, anti complotiste, contre toutes les religions.;15571;515;133;59832;76051
usky73;(u͜͡s͜͡k͜͡y͜͡);passionné par les enjeux énergétiques.;23898;1068;311;50649;75926
ramasseudordure;Anas Seko 🌍 🇧🇯;Activiste et Communicateur Environnement, Artiste Phoneographe, Initiateur Mon Anniversaire Ma Patrie / FD @AssociationApcm •Compte Professionnel Linkedin 👇🏾;28598;297;13790;33228;75913
ChiefDaira;Chief Daira 𓂀;"Je ne suis pas Journaliste.
Je suis d'un pessimisme noir.
Je représente Rien.";27035;1012;197;47669;75913
ffunivers;Orange pressé 💉💉 BioNtech 💉 NIH/Moderna 💉#BA5;"« L'ignorant affirme, le savant doute, le sage réfléchit. », Aristote.

Les vaccins sont sûrs et sauvent des vies. #FaitesVousVacciner";63284;1976;750;9767;75777
lepenenchon;Jean-Marine LepenenchonZ (parodique);Compte PARODIQUE - Mi-blonde, mi-ronchon et mi-Z : 100% #RNupes #ZFI #TeamDeglingos #JamesMarine #Les4Fantastics #MajoritéSilencieuseRépublicaine #NousSommesLa;22274;1145;1750;50577;75746
QuebecScience;Québec Science;Québec Science, le magazine scientifique québécois depuis 1962.;8449;373;66299;609;75730
hertzeleid;Lothringer ☨;j'aime ma région Lorraine, qui fût un état libre, riche d'une histoire hors norme oubliée de tous ou presque, j'aime mon pays, de droite, de toutes les droites.;1746;584;322;73003;75655
Ao3Groovehigh;Groovehigh;"Depressed fanfic writer (Groovehigh & MacdeauShipper on Ao3)
PassionnĂ©e de pol' et de đ·
A l'occase je tape la causette avec ministre ou dĂ©putĂ© sur Instagram đ";9199;550;300;65582;75631
Fragren36;Vent Libre;Préservation d'un cadre de vie magnifique. Le cadre de vie change, le droit d'en profiter et l'obligation de ne pas le détruire demeurent. #éolien;47777;891;1108;25853;75629
TraKouassi;Tra bi kouassi Martin;"on est riche quand seulement on a dans la main une valeur que l'argent peut acquérir...

cette valeur peut être un talent ou un bien matériel";39878;4914;1753;29046;75591
jhjbonnet;Jerome Bonnet;;8202;1109;577;65599;75487
SaccageGuada971;Baudouin Quatre;"Patriote Européen Français d’Amérique #PoutineTerroriste #stopTraore #StopAntivax #StopJaunards 
Merci @Elonmusk
lisez bien ceci avant de vous abonner.";28483;2699;2371;41863;75416
MaudBregeon;Maud BREGEON;Députée des Hauts-de-Seine (Antony, Bourg-la-Reine, Châtenay-Malabry, Sceaux), porte-parole @DeputesRE, ingénieure nucléaire @OPECST_ ⚛️🇫🇷;5882;2052;44329;23047;75310
Dia_Sakho;Bibano Wakane;Ingénierie Projets | Média | Auteure |@MaliCultureML | @capacity4dev #UE | Certifiée Sciences Po| Macquarie University| HEC-Paris;24203;3330;32617;15150;75300
Mystic_Lams;Chasseuse de légendes Lamé 💕;"Origin ID : Little_Lams
Auteur ""Les âmes immortelles"" 
Cozy gameuse et Simmer
Passeuse d'âme terrestre ✨
piped.video/c/MysticLams";26109;891;758;47445;75203
ArSaintMartin;Arnaud Saint-Martin;"Sociologie (@CESSP_UMR). Édition (@EdCroquant). Politique (@FranceInsoumise, @ParlementNUPES, élu à Melun). Astronomie amateur (🔭).
mastodon.social/@arsaintmart…";38414;1292;11242;24236;75184
Theo_Parigo;Théo Farmer ;Pronouns : pota/toe (@Lamaresseux_ a 13 ans oskour) | vague connaissance de @111inho44;35399;402;2795;36571;75167
Benjam1Lucas;Benjamin LUCAS;Député • Groupe écologiste - #NUPES • Membre de Génération.s • 8ème circonscription des Yvelines • Mon actualité 📲 linktr.ee/benjaminlucasdeput…;20459;8438;30651;15556;75104
DSauvebois;dominique sauvebois;;41344;1302;551;31874;75071
NicolasMeilhan;Nicolas Meilhan;"Ingénieur sur les sujets du transport et de l'énergie - Conférencier
#Econoclastes #ASPO #MIT";12413;67;49442;13051;74973
luc_ju04;Luczs;"""Okay, le musée ne reviendra pas.""

Creative developer WIP.
Trying to educate some brains in web development

Development X design X UI/UX

#TeamOM
#TeamChambé";35823;839;319;37872;74853
philemonkabamba;Jésus Revient Bientôt;𝗟𝗔 𝗣𝖮𝗦𝗦𝖨𝗕𝖨𝗟𝖨𝗧𝗘 𝗗𝗘 𝗗𝖨𝗦𝗣𝖮𝗦𝗘𝗥 𝗗𝗘 𝗦𝗔 𝗣𝗘𝗥𝗦𝖮𝗡𝗡𝗘 𝗘𝗧 𝗗𝗘 𝗦𝖮𝗡 𝗧𝗘𝗠𝗣𝗦. 𝗟𝗔 𝗦𝗘𝗨𝗟𝗘 𝗩𝗥𝗔𝖨𝗘 𝗟𝖨𝗕𝗘𝗥𝗧𝗘.;26899;4989;4063;38895;74846
Valerieguerout;valerieguerout;Lettres, Bâtiment, Social, Urbanisme / CNAM Paris, et la vie est un mystère. ////;26733;4996;864;42152;74745
BertrandMocquet;Bertrand Mocquet Ph.D.;"Expert num @amue_com
Chercheur SIC @leLabMica @UBMontaigne. 
Resp. Rubrique Parutions @sfsic. 
CS @hypothesesorg. 
Ex VPnum VP IT, #TransfoNumDuSup #i4emploi";40393;6209;5645;22357;74604
Construction21F;Construction21 France;Depuis 2012, le réseau des professionnels de la ville bas carbone;54888;2615;11991;5097;74591
Papineau_LJ;Papineau;«Le ⚜️ Québec est mon seul pays» - Jean Duceppe;39206;1493;1679;32161;74539
Infraraid;Infraraid đčđ«;;19174;1016;273;54071;74534
graphAD;graph;;18256;40;253;55843;74392
tshitok;MYKT - Nec Plus Ultra;"⚖ (Int'l) Env. Law & Sustainability ♻
Women Empwrmt 👩🏾‍🦱🧠💪🏽
Boxing 🥊 - Soccer ⚽ 

~ B The Change U Wanna C ~

Views solely mine, RT ❌ endrsmts, ❤ ✖ 👍🏽";26369;2268;1348;44359;74344
JeanMichelP3;JMMMMM⏳;Simple citoyen du monde contre l’injustice et la prolifération de la désinformation et du mensonge;10338;272;257;63340;74207
ezints;Ezints;"Démocratiser l'actualité des marchés financiers mondiaux.
Marchés financiers, cryptos.
Géopolitique et politique internationale.";65401;339;5098;3366;74204
CyrilMouquet;Cyril Mouquet;"Adhérent Nouvelle Donne.
Chacun de nos gestes témoigne pour toute l'humanité.
Mes tweets n'engagent que moi.
👉@Cyrilmouquet@piaille.fr";30577;880;703;41960;74120
Lesmatinsfcult;Les Matins de France Culture;Les Matins sur @franceculture, de 7h à 9h du lundi au vendredi par @guillaumeerner.;22553;1527;48371;1490;73941
TBrochot;Thierry Brochot ðºð¦;"Ãcologiste 

'Soyez vous-mÃªme, les autres sont dÃ©jÃ  pris' (Oscar Wilde)";25468;3312;6715;38399;73894
LAfrobuilder;SIRADIO ®;Civil Engineer, Manager Openbrige. Trust Allah, Dream big, Work hard. Family, Construction, Books 📚 Alhamd lillah for Everything;26871;2594;5043;39385;73893
LerouxArthur10;Leroux Arthur đź‡«đź‡·đź‡¦đź‡˛đź‡Şđź‡şâš˝;"Mes opinions n'engagent que moi ! my views are my own.
PĂ¨re, ingĂ©nieur, libertarien, entrepreneur dans l'Ă©nergie
#NoCorruptMed";16642;4626;14500;38090;73858
anabtd;Isana;đ„ Monteur vidĂ©o â„ïž Les films les sĂ©ries đ©đŸâđł Passion cuisine et đ€ Mes propos nâengagent que moi;37994;640;132;35050;73816
JosiMoha;JosiMoha;1 homme  1 femme - Tunisien  Belge #Ecolos #CitoyensDuMonde #VivonsEnsemble #ToutesLesCouleurs #ToutesLesReligions #Partage #Solidarité #EnrayonsLeRacisme;55334;733;418;17270;73755
mikiane;Michel Levy Provençal;Prospectiviste. Consultant. Conférencier. Cofondateur de Brightness.fr & TEDxParis 📚 amzn.to/3f6jGmw 🎙 brightness.fr/trendspotting;2577;2835;56718;11615;73745
UMQuebec;UMQ;La voix des gouvernements de proximité du Québec depuis 1919. Mission: Rassembler, Affirmer, Accompagner.;40545;790;10113;22253;73701
DavidLaMars;David Coquille;"Journaliste @lamarsweb. Explore #Marseille de l'an pèbre. #Μασσαλία
davidcoquille@gmail.com";39245;291;14537;19598;73671
zorah_lille;zorah φ 🐢 ✌️ 🕊;"Infirmière...insoumise ! 👇
#Nupes = 650 propositions en commun ✌️ pour une #6èmeRépublique en 🇫🇷 ! soutien à @JLMelenchon 🐢 
mes tweets n'engagent que moi";16371;1584;1586;54110;73651
fenottec;CALMO Fenotte;NI DIEU NI MAÎTRE;72877;217;114;398;73606
Richard_Loyen;Richard Loyen;Délégué Général @ENERPLAN depuis 1999. Fondateur de @QualitenR Président du Club Solaire Métropolitain d'Aix Marseille & de asso Les Festins Photoniques Citoyen;19376;2635;4819;46739;73569
JeromeMouton1er;Mouton Jerome;On ne fait pas une bonne omelette anticapitaliste sans casser des Ze;33680;1498;794;37449;73421
vincentmorisse9;Poteux;"Je suis comme une bonne dose de piments fort.
L'avantage c'est que sa peu te mettre le feu au cul sans utiliser du précieux gaz. Ton portefeuille me remercie!";18384;376;535;54099;73394
RenaudMuselier;Renaud Muselier;Président de @maregionsud - Président délégué des @regionsdefrance, Délégué régional de @renaissance #NotreRegionDabord;13116;2001;47064;11062;73243
sxm_news;SXM-NEWS;"St. Martin đź‡«đź‡· / St. Maarten đź‡¸đź‡˝ distribute only on twitter a platform of local news from major source from other local news source
#event #weather #sport";66487;372;2120;4076;73055
actufr;actu.fr;73 hebdos, 1 quotidien, 12 gratuits, 38 pure-players et un desk national = 400 journalistes au service de l'info locale. Groupe #Publihebdos #SIPAOuestFrance;61554;290;10936;127;72907
Axiome;►Paul-Popov◄;''J'ai développé un sentiment ambivalent à l'endroit de la vie'' #PassionBidou (& gauchisme, 📷,🚲véhicules se déplaçant horizontalement ou verticalement,etc);18406;1026;1169;52136;72737
Fin98382220;Fin(49)đ;Le monde change brutalement. Je dĂ©couvre ce que je ne voyais pas de perverti avant dans notre sociĂ©tĂ©. C est trĂšs violent mais je prĂ©fĂšre Ă§a au confort endormi;24351;1765;930;45682;72728
MargauxVIDAL1;Margaux VIDAL;CF @PSRhone, ex-suppléante de @julien_giraudo (législative 2017), ,Ex-SF @PSRhone, #handiféministe #Intersectionnelle;37526;800;956;33409;72691
GregIenco;Greg Ienco;"đ» Journaliste @BelgaNewsAgency đ§đȘ 
đČ @CyclismeRevue  
đ @Blueprint_PM  
đź twitch.tv/Greg_Ienco
đ§ La TĂȘte dans le Guidon";66416;1477;2499;2289;72681
xxmasx;Cyrille A. NOEL 〓〓;La vie est faite d’étude, recherche et pratique - l'art au mille-lieux | La machine a déjà remplacé l’humain | Nous vivons dans une ère d’expériences nouvelles;44075;1467;1592;25511;72645
Aurelientache;Aurélien Taché;Député du Val-d'Oise et trésorier du groupe écologiste • Coprésident du groupe d'étude sur les discriminations et Président du groupe d'amitié France-Mauritanie;17954;3741;38996;11941;72632
pierrehman;Pierre;Consultant - communication, rÃ©seaux sociaux, influence et d'autres trucs chouettes ð´ð®ð¹;46344;920;1132;24167;72563
me_breakfast;Breakfast;Si vous trouvez ma ligne éditoriale, merci de la remettre à l'accueil;19030;1496;2514;49428;72468
IThisSaintJean;I. This Saint-Jean;Professeure @univ_spn / économiste / #velotaf  / chroniques @AlterEco/ Avant j'ai fait un peu de #politique / #gauche #écologie #recherche #université #économie;33251;2794;6022;30361;72428
NathalieRoyPres;Nathalie Roy;Fière députée de Montarville, présidente de l’Assemblée nationale du Québec,ministre de la Culture et des Communications (2018-2022), avocate et ex-journaliste.;30444;5239;17244;19456;72383
manutoma1;manutoma;#En2027 Dystopie;36839;1693;524;33306;72362
Financialafrik;Financial Afrik;Le journal financier panafricain.Analyse des enjeux financiers et économiques. Mensuel, Newsletter quotidienne, financialafrik.com;45545;1421;24889;503;72358
hibiscus_peyi;Hibiscus Tropical ðð¦ðºð´;"Anticonformiste et amoureuse de la Vie et de la LibertÃ©.
J'aime les esprits indisciplinÃ©s. Ceux qui pensent Ã  contresens, mais parlent avec justesse.";14259;646;578;56813;72296
DavidJohnTarhn;Tärhn Prince des Etoiles;;22756;2608;805;46112;72281
INRAE_France;INRAE;INRAE Institut national de recherche pour l’#agriculture, l’#alimentation et l’#environnement Nos communiqués de presse #RP_INRAE Our activity in EN @INRAE_Intl;18959;910;48004;4393;72266
jeremydumont;jeremy dumont;Planneur strategique engagé #innovation #transformation #facteurhumain #leplanneur #noussommesvivants #eelv #jensuis;53189;9456;8459;1075;72179
LaurentAlaus;Laurent Alaus;"#TeamChocolatine #RSE #inclusionnumerique #WomenInTech 
Ex #Orange, Ex Commissariat à L'Énergie Atomique (#CEA) #Carcassonne #Jazz #Otacute";18394;9480;8903;35337;72114
th_gre;Tom.G;"Universaliste, rabelaisien, sceptique, hégéliano-marxiste.
""Science sans Conscience n'est que ruine de l'âme""";40212;239;167;31442;72060
coknou;Bruno Vallée;Pessimiste souriant. Poète du dimanche. Éternel farceur qui ne prend rien (ou presque) au sérieux. Souverainiste, malgré tout.;52148;494;576;18713;71931
E_M_08;Mrick08;;23781;556;181;47279;71797
4dri4nG4rrigos;φ_de_la_5ème 🍀🔺️;Web Entrepreneur, Formateur informatique, Hacktiviste! Penser juste est difficile, c'est pour cela que nous en sommes là. #RIC #FI;53747;894;1229;15811;71681
338Canada;Philippe J. Fournier;Polls & politics / sondages & politique丨Writer/Analyst @Politico @Lactualite丨Creator 338Canada/Qc125丨Prof astrophysique @cegepsl丨alum @universitelaval @mcgillu;15389;933;33700;21625;71647
Waimais;Moodparledetoutetderienenpaixš¤š¾šš¤š¤;"Consultant š§ š #reflexion #deconstruction #reset #soi  Tu attires l'Ć©nergie que tu es š§²šš¾š

                              DM Uniquement consultation š";41388;1251;7813;21146;71598
Ulysse_Rives;Ulysse Rives;Ătudiant. Auteur, parfois. Pour un monde plus juste. đ± Influenceur CROUS. đ;15211;888;5588;49864;71551
ORSYS;ORSYS formation;Spécialiste de la formation continue. Suivez ici notre veille #Formation, #Digital et #RH mais aussi nos actus et les livetweets de nos événements.;52559;1334;5430;12191;71514
vinzradio;Vinz Kanté;"-  🔎🎬 : @limitofficiel 🌍💭 Limites planétaires
- Fondateur SCHOOL'UP! 🎓
- Shifter🇧🇪♻️⛽⛔
- Born at 350ppm
- ✉️ vinz@limit.media
#Degrowth
🇧🇪🇸🇳🇫🇷🇲🇱";32030;1649;24348;13473;71500
FunMooc;France Université Numérique;Infos, actus, retours d'expériences... Tout sur #FunMooc le diffuseur des #MOOC & #SPOC des établissements de l’#EnseignementSup français et leurs partenaires;23943;2732;23975;20734;71384
DenisPayre;Denis Payre;Fondateur de #BusinessObjects, #Kiala, #Natureandpeoplefirst, #CroissancePlus, #NousCitoyens - Auteur Le Contrat Mondial;15710;2042;30606;22988;71346
InsoumisJeunes;Les Jeunes Insoumis·es;Compte Twitter officiel des Jeunes insoumis·es • Notre programme 👉laec.fr • Rejoignez la #GenerationMélenchon 👉 melenchon2022.fr/generation-… ✊;14887;272;38022;18109;71290
CollegeCan;CICan;The voice of Canada’s colleges, institutes, cégeps and polytechnics // L'association porte-parole, des collèges, instituts et cégeps du Canada.;29572;3132;7539;31041;71284
lemainelibre;Le Maine Libre.fr;Bienvenue sur la page Twitter du site lemainelibre.fr ! Suivez ici toute l'actualité sarthoise, en 280 caractères...;56966;653;13196;406;71221
neoliterature;M. Nachtergael;Pr. French Studies | she/elle | Co-head Gender Master program @ubmontaigne #GISGenre | Cnrs x Musée national Histoire Immigration 22-23 | @cnapfr Photo board;4066;2902;3265;60975;71208
Ksivatte;Karl Sivatte;"Journaliste FTV  - Martinique la 1ere
 - Mes tweets n'engagent que moi!";62047;1691;5047;2402;71187
Dark_Jeanne_86;Nono - COMMS OPEN DM ME 😗😗😗;"elle/she, medium certifiée, pétasse engagée 
linktr.ee/jeanne_dark";11748;746;711;57894;71099
ClaudeMery1;Claude Mery;"Usager de Twitter.
Illustration : vitrail de l'église Saint Joseph de Laden.";38621;1016;695;30751;71083
AndreeRouillard;Rouillard Andrée;Est-ce que ce monde est sérieux?;24124;605;882;45425;71036
PIERREERREIP3;Pierre 🚴‍♂️🐝🌍;#velotaf #végétarien #Arras #ZeroDechet #permaculture #agnostique #ciné #musique;24898;1071;593;44464;71026
marwanefrcs;eren est gentil (🇲🇦);Depressed Liverpool Fan;4767;385;58;65769;70979
Vauban059;VAUBAN Sébastien Le Prestre;Il paraît que je suis réac...mais je suis vacciné. Conscient du changement climatique donc pro-nucléaire.;35159;255;151;35374;70939
BFMGrandLille;BFM Grand Lille;"Info, trafic, météo

📺 Sur la TNT (canal 31) et les box SFR (483), Bouygues (326) et Free (329), sur Molotov TV et sur notre application";37678;633;31905;496;70712
angelicamzcj;Angelica;;39904;423;187;30194;70708
tristanwaleckx;Tristan Waleckx;Intervieweur en fauteuils rouges dans @Cdenquete @france2tv Pas là pour donner mon avis, juste des faits sur des enquêtes passées/en cours #ComplementDenquete;6629;4549;51000;8482;70660
blabli_blibla;blibla blabli ☭;"Communiste (et donc athée) révolutionnaire et internationaliste.

Exproprions la bourgeoisie !";22883;424;481;46866;70654
TheAfricayn;TheAfricayn;a committed panafricanists, passionnates about african issues. this account is managed by multiple people.;47295;1558;11223;10504;70580
LeRektorat;Le Rektorat;"Stormtrooper souverainiste désabusé. Asseyez-vous, prenez de quoi noter et jetez toutes vos émotions par la fenêtre.

Politique, shitpost, chaussures et YouTube";23295;548;15309;31309;70461
EmbaCubaFrancia;Ambassade de Cuba en France;Embajada de la RepÃºblica de Cubað¨ðºÂ en Franciað«ð· /Ambassade de la RÃ©publique de Cuba en France;18679;6281;14810;30658;70428
jjohana;JJHN;ingénieur;35863;1926;18327;14222;70338
AnatoMarab;Marab Anatho;Guérisseur traditionnel marabout puissant la magie du puissance vodoun;1705;4991;449;63178;70323
karinagould;Karina Gould;MP for Burlington | Minister of Families, Children and Social Development / Ministre de la Famille, des Enfants et du Développement social | she/her/Elle;20721;2134;36056;11409;70320
harddis61809291;Maxime Alexandre IV;"Requiem pour un Monde ""Those who would give up essential Liberty, to purchase a little temporary Safety, deserve neither Liberty nor Safety"" ф";21783;1080;390;47022;70275
lesoutremer;Ministre délégué chargé des Outre-mer;"Bienvenue sur le compte officiel du ministre délégué chargé des Outre-mer
𝗝𝗲𝗮𝗻-𝗙𝗿𝗮𝗻𝗰̧𝗼𝗶𝘀 𝗖𝗮𝗿𝗲𝗻𝗰𝗼";8777;529;50478;10483;70267
martin_anota;Martin Anota;Prof de SES. Je blogue ici blog-illusio.com, lĂ  annotations.blog.free.fr et sur @AlterEco_ blogs.alternatives-economiquâŠ đ martinanota@mas.to đ;51510;616;8777;9298;70201
MachaDuWeb;Fraide;De la fanfare;54971;223;431;14544;70169
EVANVAERENBERGH;ERIC VAN VAERENBERGH-艾瑞克;;35911;2661;3377;28127;70076
lelabtv;LΞ La฿ TV 📺;"t.me/lelabtv
Boomer after all / j'essaye aussi mastodon tooting.ch/@lelabtv";61567;3322;3094;2027;70010
feulaflamme;Pépère Laflamme;Franco-Ontarien québécois un peu nationaleux un peu woke. Enverdeur. Hockey outsider. Papa d’accueil: 1 ti-gars, 1 cheval et 2 chats!;18407;1203;1084;49250;69944
LaurentMazaury;Mazaury Laurent;Maire Adjt Culture de la ville d'Elancourt.Vice-Président de Saint Quentin en Yvelines délégué aux sports.Conseil National et Départemental de l'UDI.Pdt de TV78;48299;2323;2393;16904;69919
Alorscaroule;Alors, ça roule?;"Juste un peu de #mobilité... et, si en plus, elle est #autonome et #propre... :-) Avec parfois, quelques trucs en plus ;-) Aussi sur Flipboard : bit.ly/2KFEgqy";68231;542;529;614;69916
MfumuDiamondb;Déconnexion;masculiniste et Misogyne!!;53615;520;559;15181;69875
aympontier;Aymeric Pontier;Ecomoderniste. Actualités scientifiques, économiques, et internationales. 🇫🇷 🇪🇺;24798;4723;13239;27077;69837
Noah_UTD;Noah φ🧤🇫🇷;"Référent @MNL_National pour le @MNL_17100 (Charente-Maritime), surtout à Saintes. 

Mes tweets n'engagent que moi. 

Soutien #LFI φ et #NUPES

GGMU 🔴🇫🇷";26147;1939;626;41014;69726
BawalaJeancy;Bawala Jđ­đ;"Notre mĂ©moire c'est notre identitĂ©. đŻ

la patrie ou la mortđšđ©âđȘ #Panafricaniste #Libre_PenseurđŻ #FanduRĂ©alMadrid #DubNation #WGS #NBA
#RwandaIsKilling";5955;424;904;62424;69707
so_maghribia;t’as cru t’étais qui ? 🇲🇦;🧕 Pv : @sotEsqui;27596;1273;1148;39488;69505
Reze_Stances;Rezé_Stances;Vivre et survivre à Rezé, la trop mal aimée. Rezé appartient à ses habitants, pas aux militants politiques.;14388;697;253;54141;69479
trevisev;Vianney;"Libéral développeur. Freelance.
#science #dev #entrepreneurship";21230;280;261;47601;69372
Pandalatesta;Dr. Panzou - Reviewer #2;"Lillois en exil đșđMCF en Ă©conomie. Too absurd to be dangerous. đł&đ„&Proudđ #ButtChicđâš. 
đ@pachanarchiste@piaille.fr
MaleToken @LesTroisPoints_ đ§đđŽ";26390;281;665;41847;69183
RMCStory;RMC Story;Compte officiel. Chaîne gratuite disponible en France sur le canal 23 de la TNT HD et sur les réseaux numériques. #RMCStory;32826;532;30676;5132;69166
JacquesPinchard;jacques PINCHARD;"Elu #Rennes et métropole.
Militant @nouvelle_donne et @Climat2020
Entrepreneur Hab-Eco.fr
#Climat #Sante #Education #Emploi #justiceFiscale #TaxeSpeculat";19736;1512;1499;46362;69109
Flop_Ysh;Flop;"@Flop_Ysh@hostux.social
French webmaster, contributor of Piwigo... learn more on fr.gravatar.com/flop25 !";43116;145;193;25642;69096
CCleaphee;Cléaphée DERETOUR;Se faire une fois de plus éjecter, mais revenir encore et encore et ne rien lâcher….;23159;497;422;44989;69067
ju_drdn;Jln75;;20042;1085;937;46976;69040
JP_O;Jean-Paul Oury;Freedom & progress are the most important things for me. Science-tech, politics, biotech, jazz, auteur de Greta a tué Einstein et Greta a ressuscité Einstein;44825;1086;4191;18938;69040
RapRap_pido;Rðµp Rðªðºpidð¶ââï¸;"""la France, le pays des gens heureux qui se croient malheureux."" Zar Amir Ebrahimi";22186;731;220;45701;68838
sender_jean;Sender Jean 🇺🇦kherson 💔;"Liberté.. Democracie. 
Non à l autocracie.";59548;449;451;8357;68805
eparody;Emmanuel Parody ðªðº ðºð¦;journaliste, tech et Ã©conomie des medias. Sec gÃ©nÃ©ral du GESTE et du DVP (droits voisins). Adtech Club, mind Media. ex Les Ãchos, CBS ZDNet, CNET, Gamekult;45644;1426;12035;9696;68801
AgnesEvren;Agnes Evren;Vice-présidente des LR, Députée européenne, Conseillère de Paris #15e Présidente de la Federation LR de Paris agnesevren.eu;14204;5423;33474;15697;68798
DavidCormand;David Cormandð»ðªðº;DÃ©putÃ© europÃ©en @GreensEFA ð» ðªðº ð«ð· Co-President de la DÃ©lÃ©gation @euroecolos @eelv Membre des commissions budget, marchÃ© intÃ©rieur, pÃ©titions et culture;23694;8699;29735;6652;68780
HWillert;Hans Willert;34 years XP #Insurance #Risk #Digitization #CX #UX #AI #Metaverse #Insurtech #Data #Cyberrisk #IFRS17 #Assurance @MagellanPartner #SV98 All opinions are mine;41965;5304;4829;16681;68779
jo_desx;Desseaux Joël;J'ai commencé en 2009 à me demander pourquoi le prix du pétrole avait autant monté, puis suis tombé sur le pic pétrolier et ai continué à creuser sur l'énergie.;67568;73;280;808;68729
math_caill;mc danse pour le climat;"Techno gréviste
écolo 
sosie officiel de Alma Dufour
fille d'un petit bourgeois planqué

militante @alternatiba75
team @alma_dufour";5922;986;33450;28357;68715
Geuze_F;François GEUZE;L'innovation au cœur des RH. #RH #SIRH #HRAnalytics #RelationsSociales f.geuze@e-rh.org;42298;2250;8954;15187;68689
dingerjoe;Dintinger Gérard ☮ 🇪🇺 🇺🇦;Mauvais esprit mais esprit libre, je me balade dans la vie comme un éléphant traversant un magasin de porcelaine.;60393;2347;2891;3032;68663
Precadh;Prec đź¦Š âś’ď¸Ź;"SĂ©nĂ¨que, Cyrano & Camus enjoyer
Je veux juste baisser les Ă©missions de CO2 svp";25345;613;283;42421;68662
HervePommereau;Hervé Pommereau;Agriculteur en Eure et Loir #céréales #semences #betteraves #pommesdeterre;25622;1502;2033;39502;68659
nrb33300;ma libellule;jsai pas;21304;246;127;46974;68651
Manganet;Guillaume Lablanche;;42864;456;252;25072;68644
SiteTaiwanInfo;Taiwan Info;Site d'information en français du ministère des Affaires étrangères de la République de Chine (Taiwan). RT et abonnements n'engagent pas Taiwan Info.;30002;2740;7457;28368;68567
virgule_lu;Virgule.lu;Compte officiel de la rédaction de Virgule, qui détaille l'actualité du #Luxembourg, mais aussi de la #GrandeRégion;49318;367;18645;219;68549
BorisVallaud;Boris VALLAUD;Député de la 3e circonscription des Landes - Président du groupe des députées et députés @socialistesAN;13215;2921;41681;10671;68488
Oitajpn;Oita;Pixel Art / Music / Trends;6222;1128;187;60943;68480
Declafoot1;Déclafoot;"Suivez toute l'actu foot en temps réel en suivant
@declafoot1
 • 🔔 Pensez à activer les notifications pour ne manquer aucune alerte 🚨 - contact@declafoot.com";68232;34;74;2;68342
EditionSpecial2;Edition Speciale;Ne me reprochez pas de RT les gens les plus exécrables. Je ne soutiens ni hommes, partis, religions. Je soutiens les idées quand elles sont Humanistes !;58738;1726;1820;6053;68337
CGEM_MA;CGEM;@CGEM_MA est la voix du secteur privé au Maroc. Créée en 1947, elle représente plus de 90.000 entreprises membres directes et affiliées.;4595;1011;61443;1260;68309
chahid_soufiane;Soufiane Chahid;Journaliste, Rédacteur en Chef Economie de l'@LOpinion_Ma. Ex-@TelQuelOfficiel, Ex-animateur et créateur du podcast 'Le saviez-vous'.;6329;4134;4502;53325;68290
Djoanarcho;BZH ð´ââ ï¸ð´;La dictature sâÃ©panouit sur le terreau de lâignorance, G. Orwell;19340;934;544;47466;68284
Cryptonoobzzzz;Cryptonoo₿ From 100K to 0 🐐;"Je ne perds pas, j'apprends 🙏
Single dad 🍼 Investisseur amateur optimiste prudent maximaliste en rien, autodidacte, gentil trolleur taquin, scammers sniper 🔫";22468;629;904;44264;68265
jmdjossoujean;Jean Maurice Djossou;University Professor,    Doctor of Law,LL.D. (Ph.D.) And Author;33571;5001;420;29207;68199
FilFrance;Fil Rouge France;Il paraît que mes tweets comportent des contenus potentiellement offensants alors qu'ils ne sont que le reflet de ce que pensent les patriotes;28643;7175;16379;15999;68196
LPeyrebrune;Luc PEYREBRUNE #Lola #LaRacailleTue #Nuremberg2;U. DES DROITES ou macron. Coup monté électoral 2017 → 2022 ? Presse pourrie. Juges indignes. Plus de contre-pouvoirs ni d'Etat de droit. Islam=secte assassine.;46096;2065;1412;18599;68172
jedy00075;jedy75;mère insoumise;53067;2944;725;11328;68064
salemsupremacy;xotwod ☆彡;ʕ•ᴥ•ʔ~☆。・゜・゜・。| Contemporanéiste à en devenir @afterhours_444;42068;731;1115;24123;68037
LeoLeoBasta;Léo Basta;"Les chiens, c'est comme les gens : avec un os, ça grogne !
Ni dieu, ni maître, ni mie, ni bestiaire, ni gens, ni os. Et basta !";14544;203;254;52893;67894
LCyclable;Stein van Oosteren;Auteur de “Pourquoi pas le vélo? Envie d’une France cyclable”. 👉 Il ne faut pas empêcher les gens de se déplacer à vélo.;30767;3958;14989;18141;67855
EtienneDolet2;Etienne Turbo Dolet;Flamand francophone né à 1000 Bruxelles: hoofdstad van Vlaanderen. Non dolet ipse Dolet, sed pia turba dolet.;35733;335;437;31340;67845
rencontrejfm;Jean Corcos #standwithðºð¦#niRNniLFI;IngÃ©nieur retraitÃ©. La Revue Civique, FraternitÃ© d'Abraham, #ResistanceAuxExtrÃ©mismes, politiques ou religieux. Je combats les antisÃ©mites et les racistes.;36205;2910;3394;25263;67772
corto06691958;Corto;Le mensonge, c'est comme une dose de vaccin anti covid-19 : il en faut toujours un de plus pour rattraper le précédent.;35779;1267;905;29820;67771
FestiComSante;Festival de la Communication Santé;33e édition :Journée de la #Communication #Santé francophone le 25 janvier 2024 & 14&15 mars #Deauville #FestiComSanté #hcsmeufr #esante #comsante #francophonie;25520;13871;17592;10758;67741
clauderenard777;claude;"Massaliote
Super-Héros du #Motchus doté d'une vision à rayons-X pour la lecture des grilles.
Mes tweets n'engagent que la responsabilité du gouvernement.";30224;913;340;36259;67736
CRYSfcb;CRYS;@fcbarcelona #barcafans#muanacongođź‡¨đź‡©;13213;65;277;54161;67716
Ensemble_UE;L’Europe Ensemble;🇫🇷🇪🇺🇺🇦Délégation des députés européens de la majorité présidentielle au sein du groupe @RenewEurope.;20273;1357;45388;649;67667
stervigil;stervigil;"Le chat belge téléphage est mort le 15 mai reins bloqués
It's a tale told by an idiot, full of sounds & fury, signifying nothing ...";30372;1616;416;35262;67666
MariePochon;Marie Pochon;"Députée de la Drôme 🌱
Militante écologiste @NotreAffaire 🌍 @Les_Doleances
👩‍🌾🫒💧🐑🌳⛰️📣";17579;3677;13107;33145;67508
TerresDeProgres;Territoires de Progrès;Parti progressiste, social-démocrate, réformiste & européen.🇫🇷🇪🇺 Majorité présidentielle d’@EmmanuelMacron | Présidé par @olivierdussopt;30679;1622;12914;22252;67467
daniele_noel;Danièle Noël;Présidente @MoDem54. Secrétaire @TeamPlanete . Présidente honoraire #EuRegio #SaarLorLux+. #Aidant .e - Enseignante . Conseillère municipale @NancyPositive;50393;2651;3137;11283;67464
franceguyane;France-Guyane;Toute l'actualité de la #Guyane sur franceguyane.fr  et tous les vendredis dans nos points de ventes pour le journal papier ! 🇬🇫🗞;38735;613;19559;8541;67448
Noonours78;Alexandre Haincourt;Noir est le temps… Noir est le vent… Noir est le chant.;57533;188;239;9462;67422
jjweisrock;JeanJacques Weisrock;Twitter,la vraie démocratie? Arrêtons d'être primaire. L'homme providentiel n'existe pas. L'élégance est une priorité. Sinon, passer votre chemin.;40774;567;516;25564;67421
Marie_Lorraine_;MarieLorraine;"Elle/she. Lorraine d'origine. Rouennaise. NSO - Roller Derby - Les Veuves Noires.
France";6383;712;121;60195;67411
CoulombeMartin2;Coulombe Martin ™️ 🏴‍☠️;"INDÉPENDANTISTE de droite ...2x pépère....zoné agricole..philosophe édentés...punk's not dead🖖
né d'une mère lesbienne communiste
humoriste peu connu.";19409;705;2924;44364;67402
Doc_Rogno;Mister Anderson ð½;Free man #FreeSpeech #LibertÃ© #SubsidiaritÃ© fr/en;25259;724;1164;40247;67394
EHESS_fr;EHESS;L'EHESS soutient le développement des sciences humaines et sociales en favorisant la prise de risque intellectuelle et les démarches interdisciplinaires.;14564;662;47409;4741;67376
sorcieer;sorcieer A.Louv;;35606;279;288;30993;67166
Isarta;Isarta;Emplois, formations et tendances en marketing, vente et numérique isarta.com / Jobs, training, and trends in communications, digital & marketing on isarta.com;41825;2430;14375;8469;67099
jm_senga;Senga;đšđ© Â« Soyons notre propre soleil ! Â» â Mabika Kalanda;31122;837;17160;17951;67070
ghjattu_neru;Marcus Antonius Rex;Adulte Relais, Médiateur Scolaire  | Co-secrétaire de la Section @PCF d'Ajaccio | Conseiller National du @_MJCF | Titulaire d'un M2 en Histoire;17085;3195;3469;43301;67050
nymalla04;Nym;Non-affilié. Fr & Eng. No DM. I’ve started drawing, like my works !;4785;231;159;61868;67043
Legifrance1;Legifrance;Bot qui publie les mises à jour Legifrance. Non officiel. Créé par @L_DiCarlo.;66251;19;732;6;67008
SciencePresse;sciencepresse;Compte officiel - Agence de presse scientifique francophone - #JournalismeScientifique #Actualites #Detecteurderumeurs @JVPLS #EducMediasInfo;29933;1774;33828;1426;66961
SofianeDZ_Bylka;Sofiane ๐ฉ๐ฟ;๐โตฃ;44989;2358;3237;16341;66925
CubaUNESCO;MisiónCubaUnesco;Misión Permanente de la República Cuba ante la Organización de las Naciones Unidas para la Educación, las Ciencias y la Cultura (UNESCO);29068;5682;6040;25949;66739
phenixfr;Phenix;Phenix, lâ#antigaspi qui fait du bien ! đ„Š Des solutions #tech et humaines pour envoyer le #gaspillage Ă  la poubelle #EconomieCirculaire #BCorp #TechForGood;23435;5114;13778;24407;66734
PSG_WorldNation;PSG WORLD NATION ™️ 🔴🌎;🇫🇷 Twitter officiel de PSG World Nation™️ Actualité fiable + Mercato du PSG 🇺🇸 #PSG Reliable News + Transfer ❤️💙;33028;2172;9353;22177;66730
romneyscarecrow;Mike Renzo;"Je préfère la liberté dangereuse à l'esclavage pacifique
Je bloque les trolls sans aucun préavis, merci!";26083;99;1950;38556;66688
CoinTribuneFR;Cointribune;"La #crypto pour tous ðcointribune.com/liens/
ðMÃ©dia leader sur la #blockchain, le #bitcoin et les #cryptomonnaies.";17281;1204;41105;7083;66673
nicolas760;nicolas760;Ancien chercheur, maintenant retraité. Un retweet ne vaut pas approbation. -- Former researcher, now retired. Retweet is not endorsement. @nicolas760@mas.to;63551;1279;556;1261;66647
ProfesseurMajax;ProfesseurRajax;Professeur de  philosophie et auteur sur L'Attaque des Titans chez Third Edition.;22947;533;1079;41914;66473
MystereFreeze;Mістер Фріз #fellas 🇺🇦;J'ai le comportement d'un chat. Et je suis aussi une working girl. Diaspora ukrainienne en France. Slava Ukraïni ! resistiblevertige.blogspot.f…;21926;568;2836;41127;66457
BotetJosette;Botet Josette #Z0ZZ ❤️ 🇨🇵 #Lola;Géographe/Prof Hist-géo-EC Retr.Sec.Interna.Espa.Paris/… cyc Univ M. musul./Prolo Paris20 décrassé enseig.1960/Fémin.Un./Droite gaulliste.Zemmour/;60230;1117;1258;3797;66402
laetitia_leca;Laetitia Leca;;45879;3936;460;16058;66333
lemonde_campus;Le Monde Campus;Etudiants, jeunes diplômés : comment la jeunesse se forme, travaille et change la société. Enquêtes, reportages et témoignages @lemondefr;15674;635;49088;923;66320
fcauchi;Fabien CAUCHI;En transition numérique & écologique @Metapolisfr #numeriqueresponsable #sobriété #transfonum #interetgeneral #tech4climate;55156;1823;4034;5294;66307
RaynaldBernier;Raynald Bernier;"B.Sc.Pol.
LL.L.
Avocat/Magistrat/Procureur au DPCP/Terminé!
Aujd'h: ""VIVRE ET LAISSER VIVRE""
    Tjrs :    Justice pour Tous!";37452;3204;2123;23489;66268
OlivSauvage;ð¾ï¸liv'~ ð¨ðµ;"ð¤¾ð»ââï¸~ #RandonnÃ©e ð¶ââï¸#Nature ð´ #Patrimoine âª~ #Citations ð~ #CinÃ©ma ð¬~ #Nautisme ð~@anticor_org
Â« Aimer, câest tout donner et se donner soi-mÃªme Â» ð";15776;2299;709;47441;66225
gil2chill;GilSoChill;Entre BD, Cinéma, musique et basket. I love comics, movies, music and basketball;38828;462;353;26566;66209
MarionR81511134;ð¿ð¨ðµmonptitnom42ð¨ðµð¿;"ð¿En avant la ReconquÃªte!ð¿
Ma vie n'intÃ©resse pas les gens, alors j'ai Ã©pinglÃ© les grandes lignes
Le gras, c'est la vie! (Karadoc de Vannes)";13441;4972;3599;44150;66162
SectionPaloise;SectionPaloise;Twitter Officiel de la Section Paloise Béarn Pyrénées 🏉 @top14rugby @supersevens @ChallengeCup_ #EnVertEtContreTous;31210;910;25874;8120;66114
Xanatosia;Xanatosia;;46875;362;280;18595;66112
beoelss;Béno🔻;La casse matérielle est le blasphème ultime dans notre monde matérialiste;10543;196;198;55164;66101
TendanceRouge;TaxiMauve;"""Quand le sage montre la lune du doigt, l'imbécile s'empresse d'en faire un proverbe.""
Cinéphile. Mélomane. Insoumis. Et orchidoclaste.";36372;1143;865;27686;66066
CesariLaurent1;Laurent Cesari;Prof. universités, histoire des relations internationales contemporaines, notamment politique étrangère US. Détails sur LinkedIn. Compte personnel.;5501;1156;1468;57929;66054
leconteclaire;Claire Leconte;PU émérite psycho. Éducation et chercheur en chronobiologie;40659;1081;1597;22708;66045
BlanchardRaphaL;Raphaël Blanchard;"Adjoint d' @ArnaudRobinet aux #Sports #Reims ; VP #Sport département de la Marne #Reims5 #Bétheny #SaintBriceCourcelles ; CoDir @ReseauAndes";34468;1186;3651;26724;66029
MarlonMorue;Marlon Brandon de Morue;"KLATU BARADA NIKTO
je déteste les drapeaux, TOUS. 
Odio las banderas, TODAS.
#AbolirLaPolice
#AbolicionDeLaPolicia
et dès que je vois un drapeau : 
je bloque.";37289;4734;1200;22789;66012
autommen;Nicolas;En France, on n’a pas de pétrole conventionnel mais on a des vallées. @autommen@mastouille.fr;33464;670;2807;29043;65984
BlowzRollz;Kanye West Enjoyer;Je fais badaboum et c'est rollz;28230;161;61;37429;65881
rabah_chaker;رابح شاكر;"Le visage souriant est un second soleil ⚽️ 
On a deux vies. La deuxième commence quand on réalise qu’on en a qu’une! ⚽️ 
Vděčný Vítěz";22489;1314;507;41494;65804
Threadsinsomnie;Les threads de l'insomnie;"Je n'ai plus d'idées claires, la folie tient mon corps et l'insomnie est mon cœur, demain ne me fait pas peur. 

secours: @Eliteinsomnie
NSFW: @ThreadsHorny";41489;2797;5263;16242;65791
gillesduffau;Gilles Duffau;#museums, #art, #culture, #movies, #archives, #web, #digital, #music, #litterature, #museogeek, #ITweetMuseum and more;33516;1375;1896;29001;65788
lematinpointma;LE MATIN.ma;L'actualité crédible, partout, tout le temps, par l'équipe rédactionnelle du premier média francophone du Maroc.;33315;33;32361;32;65741
InfoFlash_30;đ«đ· InfoFlash_30;"Informations officielles et alertes locales concernant le dĂ©partement du Gard. 
âč PrĂ©vention des risques et information des citoyens.";65128;10;468;3;65609
Tomsawy22670318;Tom sawyer;"#energie #SolutionVelo #velotaf #TERNancyMetzLux et #VE
social.sciences.re/web/@TomS…";19792;976;1203;43589;65560
La_carparis;M. B;"Des sources, toujours !

L'homophobie n'est pas une opinion, c'est un dĂ©lit đłïžâđ";29472;1241;375;34396;65484
Lyon5AVelo;@lyon5@masto.bike 🦣;"😍👍 le 🚲 
🤬😡 les #GCUM et la #violenceMotorisee 
A suivre sur 🦣 masto.bike@lyon5avelo
Né à 327 PPM";29176;1397;1653;33202;65428
ALpinino_;ALpinino;c’est bien en fait Twitter 😂;59801;3647;691;1225;65364
GrandCapelet;Grand Capelet;vive la France Libre ♿️🇫🇷🇷🇺 Z 🐶🐈#Frexit ! blocage Ukro-nazis et covidiots ! FB assuré pour tous ! PAS DE MP SAUF PATRIOTISME ! merci 🙏;33719;4537;3661;23373;65290
tayoken_ytd;Yanis 💪;🇨🇵🇲🇦ⵣ // 17 yo // WE GO JIM 🦍🏋️ Artist;10169;830;360;53890;65249
Rrr_helene;🐝 Rrr_helene 🐝🔻;À la recherche d'Oviri;50861;2133;681;11574;65249
maeool;Maël;"Climat, environnement, urba & co 🙂

Projets & blog ➡️ kont.me

Dev indé nosgestesclimat.fr 🥵 @_datagir @BetaGouv

Contenu exclusif sur 🐘 @maeool@boitam.eu";27384;2173;3594;32095;65246
CCIcotedazur;CCI Nice Côte d'Azur;RETROUVEZ l'actu #economie06 via #RéflexeCCI06 #LaPlaceBusiness #eDRHsud #UnJourUnTalent #SoluCCIo #CCIO6 #infoCCI06 #CCI;30283;2107;17884;14879;65153
ArriveBenoit;Arrivé Benoît;Maire de Cherbourg-en-Cotentin | VP @leCotentin | @partisocialiste;26554;1617;4534;32402;65107
ChMerchadou;MERCHADOU Chantal;Ancienne élue d'Aquitaine et de Paris - Inspectrice Générale du Développement Durable - Épouse #HenriLegrandX75 #Macron @TenorKaufmann #Giscard;27076;1789;2309;33922;65096
F3FrancheComte;France 3 Franche-Comté;Canal 312 Orange et TNTSat | 313 sur Free | 442 SFR | 302 Fransat | 361 Canal Sat | 481 Bbox | 442 Numericable;43030;790;20460;815;65095
Isabell53646257;Isangel;Mes enfants, c est ma vieđź¤Ş;35987;4028;1460;23594;65069
IAmNeboo;ηеЬοο;;23568;405;238;40814;65025
Modj0r;Simon;I am Chroot. Clandé des Internets depuis 1994 (Compuserve, 9600bds). Bûchers, IT et chats. @simon@mamot.fr;49429;712;968;13910;65019
rageousB;rageous Ze;"♥ tjs libéraux, sciences sauf militantes 🚮, génie, progrès & me marrer svt 😋
Tjs 1 haine féroce des obscurantistes & autres menteurs manipulateurs #GetOut";26831;1263;964;35922;64980
paulfl2;Julien Gracq stan account;Earl grey et déficit public qui touche le ciel;13962;1093;1794;48071;64920
LightRider59;ð¨ðµFabrice Bonneðºð³;"Co-Fondateur Unis pour la PlanÃ¨te â¢ IngÃ©nieur process/mÃ©thodes â¢ â
#marchesclimat #CCC #etatstratege #gaullisme #laÃ¯citÃ© #universalisme #sciencematters";14683;850;1296;48090;64919
Badr;Badr Bouanani;"đź—ş Travel enthusiast 
đźŚź Adventurer / Climber / Biker
đź“Ť Morocco đź‡˛đź‡¦";57074;949;5758;1088;64869
FrammeryChloe;Chloé Frammery;"Ils ne savaient pas que c'était impossible... Alors ils l'ont fait.
(Mark Twain)
Info :
t.me/chloefinfosofficiel
Vidéos : odysee.com/@Chloe_F:b";5582;460;43440;15303;64785
BW_French;BW_France;Leader mondial de la diffusion de #communiqués de presse et de contenus #multimédia.;63502;334;913;1;64750
Outofnone1;Outofnone;"""N'attribuez jamais à la méchanceté ce qui peut être expliqué par l'ignorance. Les hommes sont beaucoup plus stupides que mal intentionés.""";18783;3263;2538;40157;64741
QuentinC_ILM;Quentin Carpentier;"Adjoint mobilités/espaces publics à Lyon 9
Autiste
Mobilités, écologie, antivalidisme, réflexions perso et autres absurdités 😎
#CSCG #FolloForFlowersBack";22626;546;892;40631;64695
BourlieuxJimmy;Jimmy Bourlieux Ⓜ️;Délégué départemental du @RN33_officiel | Secrétaire Général du @RNational_NA | Assistant parlementaire | Membre du Conseil National du RN;10678;419;6800;46780;64677
joussea19411065;jousseaume;Plp lettres histoire, syndicaliste Snuep- fsu, conseillère CESER Nouvelle Aquitaine;12410;59;173;51968;64610
universitelaval;Université Laval;Première université francophone d'Amérique, l'Université Laval tire sa force de son expérience et du dynamisme qui la caractérisent.;11046;2811;39278;11461;64596
ziebayves;Yves Zieba;Entrepreneur #Angel #sensibiliser #environnement #tourismedurable #EconomieBleue #climat #économiecirculaire #3D #CO2 #biodiversité #GES;16126;8016;7780;32572;64494
Prospectioninfo;ProspectionInfo;#conférences #sciences #solidarité #altruisme #autonomiealimentaire #partagedesrichesses #écologie #RIC #souverainisme #Frexit #CNR #giletsjaunes 🇫🇷☮️🇷🇺;53318;3332;727;7109;64486
Yasir_Naqvi;Yasir Naqvi đź‡¨đź‡¦;LibĂ©ral. Leader. Iâ€™m running to transform the @OntLiberal Party and restore the promise of Ontario | MP, Ottawa Centre - DĂ©putĂ©, Ottawa-Centre;30071;6308;25276;2824;64479
GLA32G;GLA32;"""Nous aurons le destin que nous aurons mérité.""
Albert Einstein";40665;273;478;22957;64373
jmt_musique;Jean-Marc Toillon;;14066;225;164;49867;64322
jlukphoto;Jean-LuK;"Breton de cœur.
Textes, photos et reportages.
Après « Fest-noz, la découverte », 2022 serait-ce l'année de mon livre sur la Vézère ?";40657;1459;906;21268;64290
KiloWattKyr;Kyrillos ­čîŹ­čĄŁ­čĺÇ;Zarbi le grec.;44451;657;643;18524;64275
undphaiti;PNUD Haïti;Le PNUD est à l'œuvre pour mettre fin à la pauvreté, aux inégalités et lutter contre les changements climatiques et pour faire avancer les #ODDs;4410;824;56670;2363;64267
FleurSiberie;Petite fleur de Sibérie;"🇷🇺🇫🇷🇨🇦🇩🇿🇲🇱🇺🇸 
Ph.D X3
#physicist #mathematician
#MIT 
work for @ENERGY
#ΣΠΣ #AIP #APS
Right-wing and feminist but not like you. 
No DM ⛔";27527;1317;2465;32836;64145
paddock_inside;Gazou;"Gaël Angleviel
📰 Rédacteur en Chef @FranceRacingfr
| Rédacteur : @blogbmw / @agendaauto / @autowebbb / UniversJeep (soon)
📧 Pro : gael.angleviel@outlook.com";36361;1673;5635;20452;64121
marxovitch;Pavlo Marxovitch 📉⚒️🇻🇳🇨🇺;Beaucoup de 3e degré, hésite pas à demander avant de t'offusquer 😘 les Gauchistes - Droitardés sont juste libéraux 🚩Communiste 🚩 Graphoshère 📉🏓☕👔;44886;887;3951;14391;64115
peter39332;Glace à la menthe-djan, Tourān-Spāhbed 🇦🇲;Agrégat' spé Bactriane-Sogdiane, shitpost 3j/7. ''T'es dans ta jalousie, jsuis en Arachosie'' (Antiochos III). PP : @Telepeturtle;25490;1576;542;36455;64063
MaelCommunique;Maël;Communiste de conseil. Anti-Impérialiste. Pacifiste. Le domaine de la liberté commence là où s'arrête le travail déterminé par la nécessité. 🚩;4170;1494;597;57795;64056
Celsus178;Celsus;;13666;731;143;49362;63902
MouldeuxJean;Stop secte du N.O.M. - J. Mouldeux ✊;"STOP 🖐️🛑⛔ RÉSISTER à la SECTE du Nouvel Ordre Mondialitaire FASCISTE et TOTALITAIRE !
Bienveillance 🙏
VICTORIA IN VERITATE.
✊🧠♥️
#Resistance";23203;2114;2752;35800;63869
FloC36;Florentin Cayrouse;Chasseur d'#orages. Vice-président et prévisionniste de l'@AssoMeteoCentre. Photographies. Infos #météo #sciences #environnement #climat #astronomie.;20642;773;2675;39765;63855
BiboumFlorent;Florent Samuel biboum;Only Jésus-Christ Can save!!!;7690;46;178;55844;63758
lenoble_alain;PAL95;"quelle France pour nos enfants? nos devoirs avant nos droits
 laguerreceserasansnous .wordpress.com    @guerresansnous";51965;1776;823;9141;63705
jpgcrowley;John Crowley;Mobilizing technologies to produce better & consume less | This is my personal account. For business news, you can also follow @GroupPhgd.;30063;591;1255;31784;63693
Fabrou13;Fabienne Roumet 🇺🇦;#multispécifiques #zoopolis. #conditionAnimale. @ECAanimal compte insta perso bcp dédié aux amis #oiseaux #corneilles instagram.com/fabienneroumet;30175;1761;1249;30494;63679
GazonBreton;GAZON.B 〓〓;Toute personne rageant sur les montants du Stade rennais, à tort, se verra distribuer un slip .;40738;738;5403;16759;63638
linososaa;fucklinoš¦;ici cāest Paris @yeat1_ @user_xman ~ ig linoo.bl;30930;291;258;32041;63520
ZugolJannone;Christian Jannone;passionné de littérature, de science-fiction, de cinéma, d'astrophysique et de paléontologie, sans omettre bien sûr la bédé franco-belge, Franquin surtout.;50126;5001;2632;5727;63486
Lau0002;Lo2;"Démocratie : un peuple souverain.

Toutes les entités supranationales ont fini dans la poubelle de l'Histoire.

-----
Je bloque si on me bloque.";42551;43;153;20727;63474
Varron;Emmanuelle Varron;ð¼ Coordinatrice Formation @5SensParis, ex communicante PSG, Pierre HermÃ©, USAP, LNR... mais pas que | ðï¸ Senior Editor pour xn--afleurebon-n6a.com;35927;1809;4111;21626;63473
jpwaec;résister;Jean-Philippe Waechter, pasteur en Camargue - La foi, l’espérance et l’amour qui est au premier plan  1Co 13,13;54361;2371;1644;5089;63465
MaggyUltime;Maggy;"Adhérente Reconquête 🌿
Zemmouriste depuis tjr
Ex-RN/MLP
Ex-gauche
Française naturalisée
Apostate d'islam depuis tjr
J'ai fait 3000 km pour voter EZ !";21339;2039;1718;38367;63463
locolupus;đș MadWolf;Il nây a que 2 dates qui comptent : celle de la naissance et celle de la mort. Entre les 2, essayons de faire le moins de mal possible aux autres.;26599;320;252;36288;63459
PPEEBPORG;PPEEBP / #StopEolien;Association de protection des paysages et de l’environnement;22962;826;1650;37976;63414
Spinest2017;Skew;;21315;251;167;41672;63405
_Rowlf;Rowlf;Il faut avoir la lucidité du pessimiste et la volonté de l'optimiste, mais c'est difficile.;39107;2933;16719;4603;63362
discuss50;Hyernard Jean-Luc;;14721;538;204;47889;63352
BruceRogersWayn;Bruce Rogers Wayne;"De Oppresso Liber.
One human race, no ethnic group is superior to another.
Open to discussion, and debate, on the other hand I despise racists and supremacist";16728;1865;393;44302;63288
zazielazizanie;zazie đ;Quand la vĂ©ritĂ© n'est pas libre, la libertĂ© n'est pas vraie. J.Prevert.đŸđŁ Ruffinđ;22392;452;543;39899;63286
AxeVertRamee;Axe vert de La Ramée;"Collectif pour des transports respectueux de la nature et des citoyens dans le Sud-Ouest toulousain.
mastodon: @axevertramee@mamot.fr

Sign the petition:";14955;4997;1281;42024;63257
824Krts;Santa Dréz 🦝 🌈;"Sous-Cheffe, Seasons Lover & Fresh Product.
Kawasaki Z 💚";59080;101;191;3864;63236
Iry;Iry;;27001;163;194;35859;63217
ColineSomek;CS;Bureau des courriers non transmis. Demander le bon de retrait de formulaire.;22636;375;597;39597;63205
Sachadici;BulletinBlanc;"ApeZment Challenge
đŻ jours";24703;1672;470;36344;63189
FabriceGarcia3;Fabrice Garcia;Entrepreneur dans les Travaux Publics  Admirateur de Vauban et de tous ceux qui ont construit la France. La passion a toujours raison.;58864;99;1670;2494;63127
AuCoinJoh;Joh;"Ochlophobe.
J'aime pas les pâtes !
Et j'aime pas le foot non plus !";15959;324;429;46383;63095
FBenrix;Farîss ۞ فارس ۞ⴰⵎⵏⴰⵢ۞אַבִּיר;"Ici dans cet univers, Je ne représente que moi même.
Explorateur et Artiste Multiversel.
Introverti.
InFJ-T.";14728;1376;551;46366;63021
ChaBahuon;Charlotte Bahuon;Journaliste Desk56 @ouestfrance Ă  #Vannes Passion vieilles pierres, festivals et pizzas đ @EpjTours ASJ 2010 đ#Bretagne #Morbihan #SR;36310;532;1182;24997;63021
AdriNumeros;Adri;Libertarien politiquement, conservateur dans la vie.;5441;111;68;57379;62999
Ketkouta84;𝐾𝑒𝑡𝑘𝑜𝑢𝑡𝑎 🐥;Ici Juste pour le Plaisir..;44562;2036;167;16207;62972
svklvo;sylvie vo;somewhere on Earth - #PhD in progress - #EHESS /// « Être (bien) informé, c’est être libre ! Being Well (Well-Informed), is to be Free! »;42266;5001;1901;13799;62967
PFRunner;P F R u n n e r;#MerciElonMuskDePasserTonCheminDeTwitterOuOnSenVa—Actu Progressiste + Photo + Architecture—par un Photographe-Architecte—Portrait/PhotoD'Archi/Street Photo;56852;1256;1672;3182;62962
Momok79;爪ㄖ'🫶🏾;📍🇫🇷. Certified Money Lover. |. Data 👨🏾‍💻 🔴⚪️ @Arsenal 💙❤️@FCBarcelona;35255;760;2739;24194;62948
gp_bzh;Guillaume PORCHER;La mobilité économe pour tous. Préparer le futur sobre & intelligent. #Mieux #Moins #SolarPower #ebike #INSALyon #lowtech;44916;217;2227;15561;62921
AXAFrance;AXA France;Retrouvez ici notre actualité et celle de l’#assurance. Une question ? On vous répond en DM du lundi au vendredi de 9h à 18h (hors jours fériés).;12502;1713;42204;6460;62879
MR_officiel;MR;La liberté est le fil conducteur de l'action politique du Mouvement Réformateur. Elle garantit la solidarité et l'épanouissement de chacun et chacune.;22531;446;34012;5874;62863
GourmelonBer;Gourmelon Bernard ⚽️;"QUOI: cosmos politique économie & le reste.
COMMENT: politesse arguments.
SPONSORS: #LaNef #LeDiplo #AMAP #ÉNERCOOP #LFI #EELV😵‍💫";35667;280;240;26672;62859
Pomerol16;Pomerol;Citoyen qui like et retweet, bonne chance dans la bienveillance et le respect. đŠđČ đ«đ· đšđź đ§đ· đŻđ”;25262;785;689;36061;62797
PRproBE;PRpro.be;PRpro is a @BelgaNewsAgency service for communication professionals #PressRelease #MediaMonitoring #BelgaAgenda #BelgaImage;58913;257;3523;84;62777
NannyCool5;Nanny Cool;J'aime la culture et le bel esprit français que je ne veux pas voir mourir, je déteste les politiques vénaux qui trahissent et pensent que tout peut s'acheter;25367;629;379;36402;62777
Benead2;Benead;;21508;919;272;40073;62772
LDarcos;Laure Darcos;▫️Sénatrice de l'Essonne @Senat ▫️Conseillère départementale au @CDEssonne▫️Présidente @Republicains_91;26283;2350;4227;29886;62746
cetrocool;Les fraises Cetrocoolðð¾ð;#teamDirecteur REP+12cl #TeamKlassroom #CNV, #velotaf #icem34 ï£¿teacher #7ans#10ans#12ans#14ans#16ans#17ans #DDPublicMontessori34 #teammaternelle #CARDIE #E3D;29113;1737;2138;29735;62723
JeanJacquesDu93;mͨ͊́ͭȧ͌͗l̐̄̂͒͋̈́̽͜ew̴͋ͦ̄ͫ̌̓̂i̐̆̄͢f̴̋̿͛e̎ͭ;J'aime les cris des trains. J'ai déjà vu un concert de macaroni. j'ai un boule qui chamboule. insta : xxjeanjacquesdu93xx;23501;357;150;38611;62619
coupdepied_cul;coupdepiedaucul;"patriote et râleur / 
humour second degré exigé !
adhérent #reconquête #teampatriote
#zemmour2022";20723;219;184;41488;62614
EdoardoSecchi_;Edoardo Secchi;Entrepreneur, Investor. CEO of a group of companies. Economic & Business Advisor for France and Italy : Enterprises, Institutions. Columnist : Media.;5196;867;2669;53880;62612
PhilippeBUERCH;Philippe Buerch;Fondateur de @ClarelisGroupe | Clarelis Notaires & Clarelis Avocats;24533;5141;5029;27879;62582
ICARE8;Yvon lapierre;"Nous sommes tous différents, mais cette différence ne se voit pas à priori: l'intelligence; pour tout le reste c'est du travail de série: un cœur, 2 poumons ect";28660;3546;3222;27075;62503
Mazal_Bof;Zemel tov ð¤¸ââï¸;Galette saucisse kosher edition / Histoire & mÃ©diation du patrimoine / Breizh enepfaskour;12616;780;8480;40599;62475
Arab_Intel;Arab Intelligence - المخابرات العربية;Page d'information | Veille politico-stratégique, affaires militaires, terrorisme, pensée Arabe et Histoire des mouvements de libérations nationaux.;33758;20;26597;2044;62419
ali03801472;ali๐ฑ๐ง๐ง๐ท๐จ๐ต๐ฒ๐ฆ๐ฎ๐น;"-Computer engineer
-Nature photography๐ธ
-Pilot soon";11179;3376;2434;45416;62405
Meorciaa;Liane Foley;iel, elle / en harmonie avec ma nature, old skool mais vit avec son temps / spécialiste web;20887;523;204;40768;62382
CowsEveryWhere5;Sparrow;"Des tartes aux fraises, des vaches, un peu de soleil et des mojitos. Le paradis n'est pas si compliqué quand même, remuez-vous le boule --
She/her 💗";17736;1128;180;43331;62375
fabio35590;Fabio đšđ”;Empathy & Justice âïž, Against Conspirators & Profiteers đ”, Science without Consciousness is but the Ruin of the Soul (Rabelais) đ;24917;1195;1145;35109;62366
BaratteNathali1;Baratte Nathalie;;16957;253;403;44730;62343
3_1415926R;Pierre 🌿;Retrouve-moi plutôt sur Parler...;20731;644;359;40551;62285
LHomme_Qui_Rit;L'Homme Qui Rit;"Observatoire des salaires des enseignants : blog.epicycle.fr/?page_id=67…

Présent sur mastodon : @LHomme_Qui_Rit@mamot.fr";41301;732;1306;18939;62278
KankouMoussa99;Sekou Touré🌍;"Qu'allâh bénisse le Mali 🤲🏾🇲🇱.
Vive une Afrique unie et sans tutelle !! 
Résister contre l'impérialisme est un devoir ! 
un Peuple - un But - une Foi.";13475;829;1033;46844;62181
d_Bouticourt;DAMIEN BOUTICOURT;"Secrétaire général adjoint #DeboutlaFrance 🇫🇷,
candidat #europeennes2019,
Maire-adjoint rural (28)🌾
Lieutenant honoraire 🚒
Souverainiste et Anticor";12154;2880;2968;44125;62127
defenseaxessud1;Défense axes sud Normandie;"Collectif citoyen, crée le 5 fév. 2018, pour la défense du service public
ferroviaire, les citoyens se mobilisent contre les ordonnances !";23094;1220;1005;36754;62073
dlbrgn;Damien;littérature, internet et politique. work @paris, ex @spintank.;30836;948;2070;28150;62004
CDarwin3270;Charles D đâïžđïž;Scientifique, biologiste, humaniste et agnostique. Charles Darwin c'est mon pote, Ă  lui seul il fit une rĂ©volution de la pensĂ©e humaine.;17013;616;753;43618;62000
MilanMarinerS;Ma Vérité 🏹 👼 Gabriel 😝 🇲🇫 🇷🇸🇷🇺;"Il n'y a que deux races au monde, celle que je n'aime pas c'est les cons.
Je bloque les mangas, les cons, et autres trolls insultants. Je suis athées ⚛.";37187;403;392;23994;61976
SierraTango74;Tangosierra74;Catholique - Coët - ex Off Para. C'est d'espoir plus que de choses dont l'Homme se nourrit ! J'aime la liberté d'expression et la censure m'insupporte 🇫🇷ن;19942;6230;6699;29077;61948
larayrieclic;La Sybille du chemin;Libres réflexions sociétales «seuls patience et lenteur garantissent l’éternité du chemin», pour une France🇫🇷Laïque Républicaine et Souveraine;36469;2442;789;22222;61922
sidiabdou123;Thomsank;ouvert d'esprit;3933;2979;1095;53902;61909
cegron;Christophe Egron;📸 chrisegron;60798;653;381;56;61888
ThierryGibert2;Gibert Thierry;adhérents Nouvelle Énergie David Lisnard. revenons à une politique digne et constructives.;12241;142;294;49188;61865
FrancaisMarc;Marc FRANCAIS;;35834;449;496;25057;61836
gillesjohnson;Gilles Johnson;Cinema blogger (@aucinecesoir), Canada/Qc lover, @PSG_inside fan, French/EU citizen. Currently @VilleNanterre RTs ≠ Endorsment. Tweets are my own (FR/EN/ES);32103;1852;950;26913;61818
fpdoO;fpdoO;;40478;1590;712;18895;61675
Hadeye_Fofana;Salou Casais;;18446;617;4352;38245;61660
26enColere;🇫🇷---Drômois en Colère!---🇫🇷;Plus les hommes seront éclairés, et plus ils seront libres. (Voltaire);20888;8844;8508;23368;61608
nda_jsuis;✨Nda🌙;On a grandi te-tê dans l'étau / Antiracisme;21035;528;1743;38134;61440
PochoDiaz;Carlos Díaz;International project manager for development & good governance of resources. Transform to make impact.;17652;1931;1470;40363;61416
leparisien_eco;Le Parisien | économie;Pouvoir d'achat, vie des entreprises, emploi... Toute l'actualité économique avec @le_Parisien;42207;88;19021;29;61345
Elishean;Michele Berdah;Travailleur de Lumière au Service de la Nouvelle Terre;60314;33;986;9;61342
BereniceGagne;Bérénice Gagne;"🔭Vigie du changement global, je vois l'#Anthropocene partout
@EcoleUrbaine @R_Anthropocene
#Urbanocène #Capitalocene #Plantationocene
🌈 Née à 332 ppm";18166;348;1760;41015;61289
YahiaouiSalima;Salima El Yahiaoui;"Le génie... C est celui qui a compris le sens du partage des somme....
Quand a l imbecile lui.... Il comprend l adittion des valeur....";57976;1889;56;1270;61191
ChomEnterprise;chom-enterprise;"Il y a deux monde, 
celui où tout est facile
et celui où rien n'est simple.
Compte restreint par tweeter France";30548;689;1524;28428;61189
le_quotidien_lu;Le Quotidien;đź‡±đź‡ş L'actualitĂ© du Luxembourg et de la Grande RĂ©gion en langue franĂ§aise | Print & Web epaper.lequotidien.lu đź“¸ Instagram: @ lequotidienluxembourg;49446;441;10579;711;61177
NgoyiPatrick11;Patrick Ngoyi Buanga;Expert en Santé publique, Manager, Leader et l'oeil de l'observateur.;19942;2012;3080;36122;61156
Samjoab;Sam joab;;5983;389;124;54630;61126
abadinte;abadinte;Cousin de Roger Hanin donc cousin par alliance de François Mitterrand. Mange tes morts. Photo crédit shien.;50654;1292;2151;7020;61117
europe1presse;Europe 1 Service Presse;Compte officiel du service relations presse @europe1 : Coulisses, photos et infos. #Europe1;47069;965;6882;6113;61029
FranceArchives;FranceArchives;Portail national des archives, porté par le Service interministériel des Archives de France;17429;953;25962;16660;61004
mary_ng;Mary Ng;"MP | Députée Markham—Thornhill
Minister of Intl Trade, Export, Small Biz & Economic Dev
Ministre du Commerce 🌎, des exportations, de la PME & du Dév économique";16271;2684;32050;9887;60892
fabalsace;fabienne;Géographe, amoureuse de la nature mais pas écolo, curieuse pour le scientifique, naturellement insoumise;30896;239;98;29650;60883
LeNouvelEco;Le nouvel Economiste;Politique - Economie - Entreprises;26962;800;32559;554;60875
tshidmukendi;Mukendi Tshidimu Arsène;Son of #Africa | Passionné de la #RDC | Psalms 23;33962;1940;8542;16410;60854
BulletBear13;Bull et Bear 13;"Boursicoteur actif, cryptosceptique convaincu, Supporter de l’OM, ami des animaux, fan de Muse et des Daft Punk.
Mentor Slice
slice-app.io/";19519;81;1805;39420;60825
SuzanneLCampion;Suzanne Campion🇪🇺🇫🇷🇩🇪🇮🇹🇺🇦🇦🇺;"🌏citizen seeking to understand things antipodean; geopolitics, energy, art history.⚛️";9699;3729;643;46714;60785
hipdipp;Hip Dipp;No labels. No filter. No nonsense. No DMs. ALL blue checks get blocked on sight, no exception.;12796;230;431;47307;60764
PPC;PPC;Chief Digital Evangelist | MC🔥🎙#Web3 smartlink.ausha.co/ledigital…… …smartlink.ausha.co/le-web3 smartlink.ausha.co/mgmt;28768;2728;17418;11803;60717
arsenenama;Arsène Nnama;"Expert Socio-Environnementaliste.

Secrétaire Politique National Adjoint en charge de l'Environnement UNC....";36252;1793;7009;15595;60649
btabaka;Benoit Tabaka;SG, Head of Policy @GoogleenFrance. ex @Android, @CNNum, @PriceMinister. ex Lawyer too. Tech news addiction. Food and Wine are my religion. #TeamGoogle;38670;1493;11667;8797;60627
vgoyet;Vincent Goyet ð«ð·;Maire de Saint-Mitre-les-Rempartsâªï¸Conseiller mÃ©tropolitain @ampmetropoleâªï¸Conseiller dÃ©partemental, dÃ©lÃ©guÃ© aux relations internationales @departement13;39605;6056;9819;5127;60607
NADIARAKIB;Nadia's WINKð¸;ÙÙØ§ÙÙÙÙØ²ÙÙÙ ÙÙÙÙÙÙØ¦ÙØ°Ù Ø§ÙÙØ­ÙÙÙÙ Û ÙÙÙÙÙÙ Ø«ÙÙÙÙÙØªÙ ÙÙÙÙØ§Ø²ÙÙÙÙÙÙ ÙÙØ£ÙÙÙÙÙ°Ø¦ÙÙÙ ÙÙÙÙ Ø§ÙÙÙÙÙÙÙÙØ­ÙÙÙÙ Al A'raaf v8;46805;402;437;12930;60574
robespyotr;Robespyotr;Snip snap Snappy, das kleine CrocoSchwanz.;11727;673;145;47878;60423
lemondedudroit;Le Monde du Droit;Le Monde du Droit, le magazine des professions juridiques : Actualités, Deals, Nominations, Décryptages, Interviews...;26380;227;27504;6253;60364
francoisros;francois (75) đ«đ·;;28628;2711;2381;26606;60326
ChanebYoussef;Joejoe;;6860;3898;215;49334;60307
aishflr;🫶🏿;ouaaaais la citeeee;20305;207;141;39634;60287
Rurka_;Rurka;ⵣ Plantdad, Pastry chef & @Karminecorp;47419;291;328;12208;60246
m_zenonus;Zenonus Maximus;"philo-Shs-accompagnement ; patou des montagnes protégeant les troupeaux";42347;913;2385;14576;60221
AlanTradingYT;Alan;"#Crypto #Trader #Investor #YouTuber #Streamer #Bitcoin                    
  ðð¼ Lien pour me rejoindre sur mes rÃ©seaux.ðð¼";5994;99;41288;12833;60214
drole_denana;🇨🇲L’eau glacée 🥶;VERSATILE 🔸« je veux la paix » 🖋📕. auteur de « douleur silencieuse » Fashion, Art 🖼 lover .| 🧘🏾‍♀️;52594;304;555;6744;60197
ycelesti;Celestino;"Systems & Networks Engineer, Blockchain and cryptocurrency specialist.
Don't waste your life earning it  and live each day as if it was the last...";23793;2275;864;33239;60171
falfaled;falfaled;“Le bateau s’échoue et on l’encadre..”;28447;3745;1126;26813;60131
BelgianGreenCub;Cyril;Henegouwestvlaming ðð¦ð§ðª Amore Vincit Omnia ð³ï¸âð;16446;1010;634;41924;60014
18sd18;wad;Algérien de l'EST;14427;696;592;44283;59998
DavidGaizord;Gaizord;Passionné d’économie et de politique. Le modèle économique doit changer et il nous appartient d’y participer.;31701;28;75;28164;59968
Fabien_Bagnon;Fabien Bagnon ð¿ð¨;Vice-PrÃ©sident @grandlyon Voirie et MobilitÃ©s actives PrÃ©sident @lpa_mobilites Conseiller @St_genis_laval Administrateur @SYTRALmobilites VP @Villescyclables;16388;1556;9033;32969;59946
magicalain;MagicAlain;A Working Class Hero is something to be.;42340;80;82;17441;59943
CanadaPE;Pol. étrangère CAN;Les activités de la politique étrangère du Canada sont dirigées par Affaires mondiales Canada - English: @CanadaFP international.gc.ca/Mediasso…;31021;540;28173;166;59900
fredericrahan;Régime collégial;"VIeme république,
régime collégial";21551;1519;552;36272;59894
AmadouDiawaraMl;DIAWARA AMADOU;President and Founder of Cluster Digital Africa, CEO of the Center for Innovation in Technological Research and Creative Industry (CIRTIC) (FAMIB) Sedispace UGA;28137;371;14721;16643;59872
PJanuel;Pierre Januel;"Journaliste essentiellement parlementaire.
Le droit est mon ami.
Membre de l' @AJTransparence
Mes MP sont ouverts";32098;1611;25994;159;59862
YujoJoestar;Yujo 🗡️;zelda enjoyer;9960;371;204;49221;59756
PowerRangersFR;T1m3R ⚡️ PowerRangers-France.fr ⚡️;#PowerRangers fan since 1993 ⚡️ The « dad » of the community⚡️ Fan depuis 1993 ⚡️ Le « papa » de la #RangerFamily;17708;412;1034;40575;59729
GGuilbaultCAQ;Geneviève Guilbault;Citoyenne et députée de #LouisHébert, vice-première ministre, ministre des Transports et de la Mobilité durable;5670;347;50868;2798;59683
kolak33;Kolak;"Fils des monts adoptĂ© par la mer.
đŠđđââïž
VaccinĂ© x 3
#Bordeaux
Team #CesGensLĂ 
Wannabe #BZH";12712;772;193;45963;59640
GerEffe;ger effe;;42677;60;210;16671;59618
Alternatiba_;Alternatiba;"Mouvement citoyen pour le climat et la justice sociale.
Nous rejoindre ðââï¸ alternatiba.eu/agir

Canal tÃ©lÃ©gram : t.me/AlternatibaANVâ¦";14134;1186;35671;8623;59614
Schmit_Henri;Henri Schmit;"Chercheur & publiciste. Systèmes électoraux & représentation politique. Ph.M. Sorbonne; LL.M. et DEA Panthéon-Sorbonne; Institutions&finances europ. CUECE/CRUE.";30364;2040;927;26242;59573
Cwam69;Cwam;"Mes tweets n'engagent que moi
Fluctuat Nec Mergitur";15300;748;236;43158;59442
e454bbe3d5974c6;Alፋ T. እኔም ለኢትዮጵያ . . . . ወታደሯም . . . ካድሬዋም ነኝ;Agricultural;36364;1013;1227;20834;59438
ChatSecouriste;Le Chat Secouriste ♂️🇫🇷🇺🇦🇪🇺 ᓚᘏᗢ;"Secouriste, chat noir #NoFakeMed #Vaccinateur
Lutte anti fake-science avec sa lady 🐞 @locuste_ #RPG
- Tous les réseaux: lechatsecouriste.fr/social/";30993;394;1755;26276;59418
an_xiaohong;🍊ᵃⁿˣⁱᵃᵒʰᵒⁿᵍ🐢🐸🍀🆙🌻🌹🔻;;28848;1554;856;28122;59380
humaindesouche;Khlifa 🕊🦁 🦅🍀;"Insolent 2ème dan.

#liberté #égalité #fraternité #laïcité.

La culture n'est pas signe d'intelligence.

Je ne suis pas responsable de votre interprétation.";18464;1264;1505;38066;59299
InfoVoisin;Passe l'info à ton voisin φ 🔻✌️;Poste des articles médias de ma région #Flandre #Westhoek #NpdC #Hautsdefrance qui me paraisse interressent Follow Me Likes où Rt Souhaite Bienvenu chez nous;49521;760;847;8149;59277
NiortAgglo;Niort Agglo;Compte officiel de la Communauté d'Agglomération du Niortais. #NiortAgglo;39135;647;5362;14131;59275
QForce2014;Brusk Kobane2;Siwerek, Kobanê, PARIS 🇫🇷🇪🇺 En lutte contre tous les terrorismes : daesh, Turcs, alqaïda…;38533;480;358;19899;59270
maxcordiez;Maxence Cordiez;"Ingénieur au @CEA_Officiel et auteur du livre ""Energies"" publié chez Tana Editions

Compte personnel.";18763;465;25183;14858;59269
ReineGenievre;Brout’chouille;Je vous souhaite ni Dieu, ni maître !;9170;359;222;49496;59247
TesongoVictor;đVictor TesongoâĄïž(Transition sans TSHISEKEDIđ«);"Master of Laws,
Promotion and Defense of Human Rightsđ #HumanRightsDefenderâ, #ExecutiveDirector @LPDHRdc, Activist #LUCHA, @FreeBeya. 
vtesongo29@yahoo.comđ§";24680;1611;2531;30419;59241
Noo_IDcard;Momar Assane;Serve ALLAH with HIS help #Finance #Business #plug #Project #Développement #Youth #Social #Business_Plan CEO @Landofafrica1 New_account @No_IDcard;23048;1462;7669;27057;59236
rolandrichard;Roland Richard;Producteur et réal' de #podcasts || Vidéaste et photographe || Féministe et humble défenseur des #LGBTQI;37454;1414;1831;18526;59225
neon_mediafr;NEON;Média sérieusement allumé, qui éclaire l'époque sur neonmag.fr •🤳;30034;1000;18847;9270;59151
LudwigMerenne;Ludwig51;Juriste publiciste à ses heures perdues, mais une galaxie lointaine, les ténèbres d’un lointain futur et d’autres choses me prennent beaucoup de temps #TBL;10277;476;154;48231;59138
Le_Reveilleur;Rodolphe Meyer;Je vous parle principalement d'environnement mais ça ratisse large: changement climatique, autres formes de pollutions, épuisement des ressources, énergie...;15054;890;34318;8868;59130
DanieleDoucet;Doucet Danièle;"De l'information sans rivages, 
De la musique à tout jamais,
De l'humour toujours.
(RT ne vaut pas caution)
Soudards et vulgaires bloqués d’office";33606;1106;424;23940;59076
ShangoNews;SHANGO News | đ«đ· FR;Toute l'actualitĂ© franĂ§aise et internationale des diffĂ©rents mĂ©dias Ă  un seul endroit. Pour l'actu foot đ @ShangoFoot;57762;1;1292;0;59055
MocTRI;MocTri;;33466;4733;1556;19285;59040
MF2France;FM Berry;"“L’homme libre est celui qui n’a pas peur d’aller jusqu’au bout de sa pensée.” Léon Blum. Nostalgique de Philippe SEGUIN 
 LISNARD BELLAMY Marion MARECHAL";24472;4674;7001;22882;59029
Cinzia100th;Cinzia Messina 🔞;Europe : d'Auschwitz libérée... jusqu'à Marioupol libérée ❤️💙🤍...;42098;1781;323;14781;58983
SdB_dip;Stephen de Boer 🇨🇦;Personal Account/Compte Personnel Views are my own;6753;357;2827;49040;58977
JeanBap42778887;BiiG MōM;;12384;809;128;45576;58897
NancyDeziel;Nancy Déziel;Scientifique qui s'intéresse à la R&D, la politique, la diversification économique, l'environnement. DG du CNETE et Conseillère municipale, dist. de la Rivière;20547;2363;5452;30522;58884
airplusnews;air plus news;✈️ Revue de presse ▫️ PaxEx ▫️ Reportages ▫️ Actualité des airs;10211;565;43863;4228;58867
ulyss3;ulysse;Lyonnais, papa, sysadmin, râleur (j'ai hésité pour la virgule voire le râleur parce que c'est le job non?). Humour discutable (les bons jours) Je suis personne!;27426;663;618;30160;58867
LavoieRobin1;"Lavoie Robin ""Que sont les faits?""";"GROUPE SENTINELLE
Roger Descartes: ""Le doute est la première démarche de l'intelligence mais je n'en suis pas très certain""";27692;676;975;29522;58865
electractu;Alex đ đ»;"Ăcologie sociale  #CĂ©vennes. Pour le #RIC car Ă©lire, c'est renoncer Ă  voter .đŽ
#FreeAssange";18776;1129;810;38105;58820
DenoeuxMarie;Marie DN;Éduquée au numérique, élevée au naturel. Formatrice numérique et insertion pro. Devise : chassez le naturel, il revient au galop 🐎. 🎨♥️💻☘;13623;502;388;44229;58742
QueroJeremy;Jérémy;Modélisation agroéconomique | Innovations sociales, économie/politique | Rap et cultures urbaines | libertaire, not libertarian | Politologue amateur | HEC.;32582;659;426;25028;58695
bcassoret;Transition énergétique;Énergies fossiles, nucléaire ou pauvreté ? L'énergie ne fait pas le bonheur mais elle y contribue fortement.;15362;963;7369;34926;58620
Fatiiche;Chérif Fatoumata ❤💛💚;Com Expert I SDGs Advocate I Changemaker I France24 Obs I  Civic Engagement I Founder #SelfieDéchets #FemmeVision2030 #VideosMakeChange @ESJLILLE I'm O+;17372;7373;20696;13176;58617
motoepela;BIENVENU MASS MP LE DÉFENSEUR;QUAND LE GOUVERNEMENT VIOLE LES DROITS DU PEUPLE, L'INSURRECTION ET LA DESOBEISSANCE CIVIQUE SONT POUR LE PEUPLE, LE PLUS SACRE DES DROITS ET DES DEVOIRS.;51456;414;180;6499;58549
Lucy___Roche;Lucy ROCHE;Australopithèque, lanceuse... d'alertes, capable de placer une charge utile en orbite autour de la Terre.;20289;1187;1472;35588;58536
equiterre;Équiterre;Équiterre travaille à rendre tangibles, accessibles et inspirantes les transitions vers une société écologique et juste.;21709;913;25412;10425;58459
spc_cps;Pacific Community;Official account of the Pacific Community (SPC). Compte officiel de la Communauté du Pacifique (CPS).;11076;388;37856;9095;58415
michelbriand;Michel Briand;acteur des réseaux coopératifs, de l'innovation sociale ouverte, des communs et des pratiques collaboratives, @michelbriand@framapiaf.org;37927;9576;10495;411;58409
rajbhagwandin72;Raj Bhagwandin;"Follow my Instagram account
@rajbhagwandin2";34774;2457;1201;19787;58219
HAIDAAbdelali;Abdelali HAIDA;"Directeur Stratégie – Organisation, Qualité et Client | Ecole Mohammadia D'Ingénieurs 

                     🇲🇦 الشرفاء السباعيين الأدارسة 🇲🇦";29111;4727;502;23823;58163
Sabine75006;Sabine A. Berger;Senior Lecturer in Medieval art history @LettresSorbonne | Gothic art (13th — 14th c.), archaeology, art market, heritage, museums, web & environment. ⓥ🇫🇷🇭🇺;42802;4995;4715;5637;58149
Juste2T;2teqCO2;"Consommation Responsable/Logements/Territoires
Objectif : 2 tonnes équivalent CO2 / personne / an
(et beaucoup d'autres choses hors sujet...ou pas)";32367;652;1643;23439;58101
calmitoo;Calmito;Ex detrackito // Chomeur // Wah🙌;6227;416;169;51283;58095
redacTendances;Trends-Tendances;Actualité, analyses, opinions sur l’économie et les finances. Au quotidien.;42429;87;15171;358;58045
bwanyaburunga;BwanyaburungaUb;| J’❤️ le Bdi 🇧🇮 pays de lait & de miel, pays de mille collines 🫶 | J’❤️ une presse & justice indépendantes 🤙 pilier d’une démocratie | #Panafricain 💪 |;31361;2155;1956;22411;57883
MboupDoudou3;𝑫𝒐𝒖𝒛𝒂_𝑱𝒖𝒏𝒊𝒐𝒓🇸🇳;"Des versets religieux dans la bio mais les péchés sont toujours en DM.
Madrista à vie🇪🇦
Luka Modric ❤️🇭🇷";2029;1209;217;54415;57870
jogany;Joan Razafimaharo;Architecte OAM, MIRAC;21869;461;1934;33579;57843
Tournefloor;Aabd ☀️ 🧙‍♀️🌻🌍🔻;Graines de tournesol 🌻 du capitalisme au socialisme;31393;2320;1153;22964;57830
lejournalafrica;LE JOURNAL.AFRICA;Compte officiel de LEJOURNAL.AFRICA. Tout sur l'Afrique au bon moment. Comparez les informations des différents médias africains et internationaux.;33937;522;20557;2703;57719
rap_addictoff;PLK addict;fan de rap à la @Booska_p. Artilleur de première ligne;41347;3593;331;12421;57692
NatGarstecka;Nathaniel Garstecka;Rédacteur de presse 🇫🇷🇵🇱•Coordonnateur @ReconquetePOL 🇫🇷🇵🇱•Tireur sportif 🇵🇱•;10366;286;863;46153;57668
PapyMarcus;đąPapy Marcusđą|woke islamo-gauchiste;Franco-salvadorien et citoyen du monde, ex-prof. Anticapitaliste, donc rĂ©volutionnaire. Il faut abolir la propriĂ©tĂ© privĂ©e des moyens de production.;42579;360;408;14256;57603
Feureux;Feureux⚜🇨🇵;Père de famille, catho, conservateur.;30720;1107;548;25215;57590
N4suk4;Nasuka;Technicien support en informatique, amateur de Nutella !;21435;311;198;35644;57588
BrefdamVictorON;Komlan Victor;"Jeune entrepreneur passionné au NTIC
ÉLECTRONIQUE🦚
ÉLECTRICITÉ 💫
INFORMATIQUE 🕊
VIDEASTE🌹
INFOGRAPHIE😻";20781;2947;1591;32258;57577
joyPC37;Joy & H.ð #inconsolable;... suggestion lectures : J. Grenier, F. Verdier, O. Pamuk, H. Cixous,  P. Quignard,  J.P. Winter, Y. Mishima et bien sÃ»r Duras ( H.Michaux ci- dessus);47945;118;159;9314;57536
BetterCallMedhi;Mehdi🍊🏴‍☠️- 🦇🔊;Manufacturing the future at the intersection of DeepTech & DeSci | @joininteract @_buildspace - ex @ens_ulm;14630;2034;8415;32386;57465
AtelierVolane;Sonulik;Céramiste. Cristallisations sur grès et porcelaine.;17589;759;629;38461;57438
DenisPl02652422;Denis Plourde;fier Québécois libre chez nous contre tous l’ordre mondial papa et grand papa heureux retraité;28341;4992;1968;22093;57394
UNOPS_fr;UNOPS en français;#BâtirLAvenir : des services d’infrastructures, d’achats et de gestion de projet pour un monde durable. Suivez @UNOPS | @UNOPS_es;5348;785;50803;378;57314
fmbreon;Francois-Marie Bréon;@ENS_Ulm. Physicien-climatologue.  Vélotaffeur fréquent et alpiniste occasionnel.  Président de l'@afis_science.  Tweets perso (i.e. n'engagent pas l'AFIS);19163;379;26926;10843;57311
AngersOnline;Angers Online;A suivre !;52246;952;3787;245;57230
univcan;Universities Canada | Universités Canada;The voice of Canada’s universities | Le porte-parole des universités canadiennes;29244;1292;22873;3801;57210
teledakar;Teledakar;"Retrouvez toute l'actualité sénégalaise en vidéo ! 
teledakar.net";51578;126;3960;1471;57135
PaulPlamondon;Paul St-Pierre Plamondon;Chef du @PartiQuebecois, passionné du Québec, entrepreneur en pays. Député de Camille-Laurin.;8641;1733;43723;3035;57132
philippe_jehan;philippe jehan;#agri53 #Mayenne Éleveur #volailles plein air LABEL ROUGE et #laitier chatillon sur colmont;26288;219;3424;27103;57034
joelgarcin;Joel Garcin;"Consultant webmarketing SEM SEO Analytique.
Formateur IFC - titre I et II communication.
Expert en solutions web Opensource";19163;379;340;37138;57020
BzhNafoFella;Breizh NAFO Fella 🇫🇷🇪🇺🇺🇦;"#NAFO #StandWithUkraine #RussiaIsATerroristState
I fight russian propaganda and conspiracy theories. DJ at Crimea Beach Party 2023 🤘
Tweets in FR/EN";16140;885;3758;36218;57001
herisson13;roberto;;21109;2949;3318;29617;56993
salledepresseGC;GC Salle de Presse;Gouvernement du Canada: Centre des nouvelles. Conditions: ow.ly/eGJR30jtO3V English: @NewsroomGC;41108;1;15815;0;56924
DavidBurlot;David Burlot;"Créateur de petites phrases pour périodiques.
Elu municipal de Lamballe-Armor Planguenoual. 
Infirmier de Bloc opératoire.
#PrintempsRépublicain";39395;1193;1447;14847;56882
JB51125001;J B;"Ingénieur, informaticien, passionné d'agriculture, d'environnement (et un peu de football)
Bloqué par S. Foucart.
Pas encore par Hugo Clément.";6935;175;203;49558;56871
Eddie_Poker;Edson Ribeiro de Rothschild;Trader, globalist, Financial markets and economy in 4 languages: ENG, FRA, SPA & ITA.;53537;835;986;1448;56806
soter_victor2;Soter Victor;Noir c’est noir il n’y a plus d’espoir;31891;1159;509;23201;56760
icialberta;ICI Alberta;ICI Alberta offre une programmation riche et variée aux francophones et francophiles de l'Alberta à la radio, à la télévision et sur internet.;50589;2100;2985;1051;56725
heidi_news;Heidi.news;Le mĂ©dia de la science đ§Ș, de la santĂ© đ©ș, de lâinnovation đ€, du climat đ et des grands reportages đ;35683;1016;15621;4351;56671
MarieAnaisAnais;Marie-Anaïs;"Justice sociale, écologie politique, art & littérature 
Ici je me prends au sérieux mais je suis drôle sur YouTube.";1754;833;120;53912;56619
ElvisLegault;Elvis Legault;"Los Tabarnacos CAQ destroyer
French canadian General in the great meme war";36984;5091;4638;9897;56610
fabien_gay;Fabien Gay;ð Directeur @humanite_fr ð ðï¸ SÃ©nateur de la #SeineSaintDenis;7358;1390;43080;4765;56593
Novethic;Novethic;Toute l’actualité de l'économie responsable #Environnement #Social #Transitionécologique #Financedurable;18457;1831;34439;1856;56583
VenDetta_9800;Ven Detta;Quand l’oiseau bleu transforme le cheval en âne puis oublie que l’âne est têtu;11038;894;333;44265;56530
juleamath;S-H-G⭐;"L'entreprenariat/Finance Inclusive/Économie/Politique
Cheikhoul Khadim amoul morom
Dieureudieufé Borom Darou";13536;870;872;41201;56479
Aboriginal_Jobs;AboriginalCareers.ca;Canada's Leading Indigenous Job Seekers Portal - 1,000s of Indigenous Jobs - Top Canadian Employers - Opportunities across Canada - Since 1999;49545;2395;4019;494;56453
ibrahim212kebe;🇸🇳حاج حنيف ‎;إِنَّا لِلَّٰهِ وَإِنَّا إِلَيْهِ رَاجِعُونَ;31115;508;631;24153;56407
science_md;Marc Demillequand, PhD, Chem Lc.;"PhD, Chem. Sc. Lc. // Dr  Sc. //
Biomedical Sciences Lecturer
gettr.com/i/science_md
Twitter backup account @MarcDemillequa1 
MeWe account: science_md";18095;335;2764;35205;56399
IngoMagazine;INGOMAG;A Magazine & TV launched by a group of young women to promote tourism, business, art, culture & sport, to introduce Burundi’s Beauty and Potential to the world.;20232;341;34518;1259;56350
Chris87Runner;Chris Runner;Mes sports la course a pied/ trail / /tennis/ le chocolat// fier d être patriote Et Rock'N'ROLL ATTITUDE;51563;192;270;4312;56337
PerrineCoet;Perrine de Coëtlogon;#Blockchain & #OpenEducation European Blockchain Partnership - France #EBSI #OEGlobal #DINUM #Université de Lille;10353;5006;2454;38514;56327
businessamfr;Business AM (FR);"Business AM est le média qui vulgarise l'économie.
📩 redactionfr@businessam.be
NL : @businessamnl | Event :
Le futur de notre planète lefuturde.be";53055;21;3156;54;56286
FEncel3;FredericEncel3;Ⓜ️🇫🇷 🇷🇺 🦅🦅🦅🦅 🇫🇷🇷🇺 MLP TRUMP POUTINE 👏👏👏;37233;3188;1916;13947;56284
dleskaniel;dleS kanieL đź‡«đź‡·;Notre monde nâ€™est que vanitĂ©â€¦   Full support to đź‡şđź‡¦;1929;357;40;53915;56241
PBienne;Philippe Bienne;#comprendre #géopolitique #civilisations #libertédeconscience #contretoutedictature #écologie #permaculture #petitespoirqueleschoseschangent;25003;4663;5174;21399;56239
UneAme3;Une Âme;IN MEDIO STAT VIRTUS;24615;216;90;31307;56228
MARCOLO6469;MARCOLAU;;38072;108;124;17851;56155
EYCanada;EY Canada;"đ Leader in assurance, tax, transaction and advisory services.
đ Chef de file en certification, fiscalitĂ©, services transactionnels et services consultatifs.";22547;294;26921;6352;56114
rachelcorre;Rachel Corre;Auvergnate #Australie #Italie #Vichy #transitioneco #santé #puydedome #culture Mes tweets n'engagent que moi - RT n'est pas approuver - cpte perso;31565;4603;3032;16839;56039
ParodiClemence;Clémence ParodiⓂ️;Conseillère Régionale RN PACA. Conseillère du 1er secteur RN 🇫🇷 de #Marseille. Responsable RN des 1er et 7ème arrds de #Marseille.;14624;1424;2576;37396;56020
agnesfirmin;Agnes Firmin Le Bodo;Ministre déléguée chargée de l’Organisation territoriale et des Professions de santé • Conseillère départementale @seinemaritime • Porte-parole @HorizonsLeParti;13256;3780;21196;17737;55969
ArnaudCourti;Arnaud;Ph.D. sciences, feux đ„ et incendies, matiĂšres dangereuses âąïž;14243;2421;1942;37354;55960
lenadesbois;Lena Des Bois 💚 🌱;Vegan Power, Defender of Human and Animal rights,;14718;253;235;40743;55949
HUBInstitute;HUB INSTITUTE;#thinkTank helping leaders to accelerate their #DigitalTransformation : #Retail #Ecommerce #Marketing #Innovation #SmartCity #Data #AI #SupplyChain #Sustainable;24282;905;14752;16006;55945
marylinebaumard;maryline baumard;Journaliste au Monde, directrice adjointe de la rédaction. Ex du Monde Afrique, des migrations 2014-18, des politiques éducatives...;27410;1047;25321;2114;55892
AllumeGlotte;Cux’inelle 🐞;Existencialiste, excentrique avec une pincée de naïveté et un soupçon de sarcasme | Snap : Pouyouyoux;36636;48;169;19010;55863
politicoboyTX;Politicoboy;Lonesome journalist, spécialisé 🇺🇸, de retour du Texas... Auteur « Les illusions perdues de l’Amérique démocrate » (Vendémiaire).;25348;529;5315;24661;55853
denisfabre;Denis Fabre;"Something . Somewhere . Somehowð
â Eco, Opinions, Geopolitics, Food & Science, Outdoor ð
ð¨ðµð¬ð§";46122;972;2867;5871;55832
nkuruemery;El Prof;Lecture  in universities #Twige #Elprof 🇧🇮;17783;1442;3657;32942;55824
Alex_V006;Alexia 💙💛 #NAFO 🇫🇷;"Слава Україні #NAFOfella from 🇫🇷

J'aime les crêpes maison au petit déj, accompagnées de délicieuses larmes de vatniks";14875;499;1957;38417;55748
Boucles_Dor__;simply bogosse;Welcome to the Death of the Age of Reason;14689;392;839;39811;55731
DZBusinessToday;Algeria - Business Today;"● Become STRATEGIC for your organisation
● We PROVIDE news,datas and analysis                    
● Make smarter DECISIONS";30451;2180;2551;20526;55708
Elli_Mac_Axl;Elli-Mac;Langues, Histoire, politique, cinéma, musique, au service de la Liberté, de centre-droite, INFJ borderline INTJ, apprécie l'humour intelligent ✌️;8747;149;906;45901;55703
JackProphete;Mike le prophète médiéval;Michel de Nostredame, prophéties en tous genres. Born at 322 ppm CO2. Will likely die around 475 ppm. Energy is life™️;32895;948;1808;19989;55640
CannesPalais;Palais des Festivals;"Accueillir durablement le monde.
The (he)art of sustainable hospitality.
Compte du Palais des Festivals et des Congrès de #Cannes 
Tourisme : @Cannes_France";16148;941;15003;23532;55624
kafunel1;kafunel;2016;51429;3206;973;5;55613
tc_montagne;montagnetc;"Je m'intéresse aux transports publics, à la politique, l'informatique, l'éducation, …
Amplitude, fréquence, cadencement en réseau, intégration tarifaire";11684;434;234;43231;55583
PetricorLatente;petricor continuo;la manteca de cerdo es divina y de éste vagón de metro no me bajo.;7946;2055;450;45076;55527
Keneda1970;Ignorare;Je reconnais qu'une seule religion, celle de mes chats, leur Dieu existe, c'est un ouvre-boîte.;7030;2670;262;45547;55509
kiaoze;Alain Comte - Kiaoze;Agence #marketing #communication #SEO #SEM #Web #events #transport #logistique #lyon;55202;109;165;3;55479
Jojofine8;Celeste_Nova 🏳️‍⚧️🔞𒉭 (Struggler arc);Enby Trans Fem Human 💜🖤. Total Nerd. Kitchen Witch. Aspiring musician. Opinions are my own. Banner from @39daph / Partner @jana_dax;14675;896;414;39492;55477
Fab_XS_;ð« Fab !;Actu & dÃ©cryptages JV sur Youtube || Feu de camp et Chamallow || Previously: co-founder @XboxSquadFr â¨|| fabendirect@gmail.com;32096;616;2403;20301;55416
NJAnoto;Nicolas Anoto;Presse, influence, Ã©ditorial & international @unsa_education  - ð¤© #histoireantique #geopolitique - #Prof #histoiregeo dans une autre vie - ð orxata & kakis;33536;1457;2704;17707;55404
DILA_officiel;DILA;"Direction de l'information légale et administrative (DILA)
#JORF Légifrance Service-public.fr (particuliers et pros)
Vie-publique.fr  La Documentation française";26189;578;26963;1649;55379
2niGln;2ni;J’ai pas inventé le fil à couper l’eau tiède. Sport 🏀 ⚽️ 🏈 🏌️Musique 🎷 Sud Ouest way of life #64 🌊⛷️🏔️🥩🍺;38983;540;387;15452;55362
finrion;Dolisy;"« Comme s'il voyait l'invisible il tint ferme » ; Amour des gens, des animaux, de la nature ; Lutte contre obscurantisme, injustices. Ingénieure Gref et Ethno…";31161;3123;666;20405;55355
lyondemain;Lyon Demain;"Web radio lyonnaise supervisée par Gérald Bouchon et dédiée aux solutions sur l'environnement, le vivre ensemble et la solidarité 🤝
Réalisatrice de podcasts 🎤";40242;5436;8500;1112;55290
24carats__;ʇoɯqoʎ.;Mes maux immortels s’endorment, et de mes songes et mes rêves éveillés, j’émerge amer;11611;403;375;42854;55243
FredMOISYNGUYEN;Frédéric MOISY NGUYEN;;9404;452;512;44870;55238
ChristopheBechu;Christophe Béchu;Ministre de la Transition écologique et de la Cohésion des territoires 🇫🇷 - Elu d’@Angers - Secrétaire général de @Horizonsleparti;6858;5395;37028;5953;55234
floneofficiel;Floneo;Pour noter l'actualité et construire ensemble le classement des meilleurs (et pires) médias, créez votre compte sur floneo.fr !;55116;51;30;1;55198
Solange__C;Solange đ«đ·đȘđș;membre bureau local Renaissance;37156;4921;3543;9516;55136
Gomelza;ꓖⲟⲙⲉⳑⲍⲇ;"Fan de
▶ Jeux vidéos
▶ Mangas/animes
▶ Séries dramatiques/romantiques
▶ Littérature";37601;2042;127;15358;55128
Mth68;Marité;"Nous sommes tous autant les enfants de Marianne, accomondons-nous les uns des autres comme Marianne s'accommode nous.
Fatou Diome";13474;2448;1577;37596;55095
XHChineNouvelle;Chine Nouvelle;L'agence de presse Xinhua/Chine Nouvelle est une référence pour mieux connaître la Chine et le monde.;38231;107;16698;31;55067
Enroweb;Antoine Blanchard;Données de recherche et #dataESR @univbordeaux. Associé @datactivi_st. Co-fondateur @cafe_sciences @deuxieme_labo. Administrateur @AssoTraces.;34774;3081;6319;10878;55052
chdevoogd;Christophe de Voogd;Libéral (donc en voie de disparition). Historien et spécialiste de rhétorique politique. Donc pas de réponse aux tweets non argumentés et adieu si insulte.;23609;2678;5415;23323;55025
sportfootmag;Sport/Foot Magazine;Un havre dans la tempête de paroles et d’images. Opinions, nuances et informations. Vivez le foot !;25649;1110;28209;32;55000
fredvalletoux;Frédéric Valletoux;Député Horizons / Porte-parole @Horizons_AN / Maire de Fontainebleau (2005-2022) / Président @laFHF (2011-2022) #Santé / ex Pdt @VilleImperiale / Ex-journaliste;19653;2207;14427;18704;54991
ChantalGendron3;Chantal Gendron;Gaffeuse en série, queen de l’auto-dérision. Carbure aux shows de musique, matchs de tennis, voyages. #TeamÉpais #PrincesseQuiSassume #RebornJoggeuse;21594;973;2505;29915;54987
AstothArbzorark;zzoark🇫🇷🇪🇸🏎️🟣⚪️;« À situation d’exception, j’aime répondre par le feu » . Homme le plus aigri de France . Ma France mes Alpines tu les aime ou tu dégages 😡🟣⚪️ ⚫️🔴;8671;535;57;45712;54975
RomGosse;Romain Gosse;Docteur en droit public, chercheur en droit de l'environnement;975;942;432;52615;54964
MartinFierro769;Claudina MICHAL-TEITELBAUM;Claudina MICHAL-TEITELBAUM ,MD , #MedicalConservative no COI w pharma  industry. Site medcritic.fr, @Medcritic1. nitter.net/MartinFierro76…gijn.org/inv;37735;470;10138;6612;54955
KoffiSodokin;Koffi SODOKIN;"Député à l' Assemblée Nationale du Togo. Professeur_Eco/Universités du Togo. ""Ma foi dans un seul Dieu, un seul Peuple, un Togo Uni"".  Perso/Cogito ergo sum/";22020;1964;6930;24019;54933
daemorys;𝐃𝐚𝐞𝐦𝐨𝐫𝐲𝐬 🕯;Maître jet d'aïl 🥋;38786;2023;128;13977;54914
LeIrascible;Irascible Legaulois;Réfractaire à la propagande de peur des mondialofascistes. Mon hobby : essorer les serpillères du mondialisme criminel.;26359;484;1168;26839;54850
satelmarc;Satelmarc;Blogueur, blagueur, râleur, patriote et observateur à distance de la France. MERCI à tous ceux qui me suivent et me RT avec courage et pugnacité. 😉 👍🇨🇵🇵🇹;29925;530;637;23736;54828
ConseilsPME;Conseils pour PME;"Veille PME - Gestion d'entreprise - Conseils pratiques - Réductions de couts - Bon plans
#Startup #Entrepreneur #Management";17742;10784;15383;10917;54826
KoreSeitchi;Ali Abbas Seitchi;Facilitateur National Socio-Économique;1747;16974;20698;15354;54773
GenerationsMvt;Génération.s;Le mouvement d'un futur désirable social, écologique, humaniste et féministe ! Coordonné par @arashsaeidi et @leafiloche, fondé par @benoithamon;8717;657;38467;6902;54743
FredericMerand;Frédéric Mérand;Directeur @SciencePo_UdeM. Hedging his bets on @FredericMerand@sciences.social;12674;2992;8343;30717;54726
messina_alison;Alison;;28301;508;262;25561;54632
SaiyanBio;Bio_Saiyan;Biologiste médical - Parle du quotidien du labo (vous verrez, c’est fun) - DM ouverts - passionné en analyse des DGS urgents  @BioSaiyan@mastodon.world;21164;616;10392;22457;54629
Unknown08631704;France robot de conversation ð¦¾;U-bot;23663;541;142;30272;54618
JulFosse;Julien Fosse;Biologiste (DVM, PhD) - ISPV - CHEE ENA đȘđș | #Ă©cologie #agriculture #sante #sciences #gĂ©opolitique;20913;1208;2559;29931;54611
eurotopics_fr;eurotopics [fr];Notre revue de presse passe au crible 500 médias de 32 pays et vous présente les grands débats qui animent l’Europe. @eurotopics_en @eurotopics @eurotopics_tr;46681;2305;4958;612;54556
plugpress;Valentin Przyluski;"Netframe & Workedge : un monde privé s'offre à vous. Ecolo radicalement industriel. S'occupe de climat et d'énergie à 450ppm
Citoyen à gauche. Travailliste!.";36965;2886;1988;12687;54526
Looshow;Morales Rojas Luis;Global Designer;38210;295;347;15643;54495
florencetoneat1;Ramdam;L'espoir d'un sursaut humaniste me raccroche encore à quelques convictions forgées au XXe siècle.;35248;1418;1137;16664;54467
RoroBKTiste;#RoadToBKT;Disciple numéro 1 @TraceDePneuFCK en attendant la reprise du Collectif Nantais. Supporter de l’@UBBRugby;34506;513;1231;18183;54433
FRAISSEJeanPie2;FRAISSE Jean-Pierre;La pensée libre !;27523;43;171;26667;54404
masquedelapeste;humain de type HPI;;22022;640;18558;13178;54398
BriceNotat;Brice Notat - 唐博 ✌️;"Data Scientist dans le secteur de l'énergie - Jospiniste radicalisé
#Energy #EnR #Data #Politics";18630;2235;2054;31449;54368
Geometriquement;Professeur Carré;Enseignant dans un « petit lycée d’Île‑de‑France » selon une étude sociologique signée par un directeur de recherche du CNRS.;30547;1911;1470;20431;54359
bontulovic;jojoφ🐢;trop courte vie pour être racontée, tout reste à faire !;24729;2760;1911;24956;54356
SoniaBEKO;CEO Patricia Sonia B ­čç¬­čç║;"Fran├žaise ┬Ž #Terrain ┬Ž Entrepreneur ­čŤŹ 
Coordinatrice de la Grande Marche 2016 ┬Ž @Renaissance ┬Ž Soci├ęt├ę Civile ┬Ž M├Ęre ┬Ž Humaniste ┬Ž­čç║­čçŽ ­čĺ╗­čô▓­čÄą­čĆÇÔťő­čî▒­čîŹ";8946;4005;5818;35555;54324
ppat49;plard;;53842;208;131;108;54289
chambremontreal;Chambre de commerce du Montréal métropolitain;La Chambre de commerce du Montréal métropolitain représente la voix du milieu des affaires et agit pour la prospérité des entreprises et de la métropole.;17077;4485;23658;9057;54277
bipx170;Pat_Metheny;ex musicien pro,camp.cariste,biker,pilote sur MFS 2020,astronomie,microscopie,anglais retour aux leçons ..Protège tes enfants et petits enfants 🤮💉☠️;10430;4395;2284;37130;54239
Ephrael752;Ephrael75;tant que t’as pas mal au cul tu peux toujours t’asseoir dessus;37410;972;288;15553;54223
andresayang;Andre Sayang 🆙 🔻🐢;;37763;733;532;15191;54219
VERMEULENEvely2;Evelyne Vermeulen;"""La liberté d'opinion est une farce si l'information sur les faits n'est pas garantie et si ce ne sont pas les faits eux-mêmes qui font l'objet du débat.""
H. A.";39268;1344;397;13199;54208
CaboZpac;Bɑboum;"Capsule Corp 🖲
On vit dans une simulation - Je le dit tous les jours 👽";37635;2026;150;14339;54150
08Estelle06D10;Est-elleðâð§¬ðâðð¦ðð­;scientifique et passionnÃ©e de la puretÃ© des mathÃ©matiques,  passionnÃ©e de danse , itou comme disait mon grand-pÃ¨re ððððElectron libre...;14662;4962;2228;32265;54117
ModJenn;Maud Rochand (Jenni)ð¦;"ð«ð·ð¨ð­Co-Founder #CMO @LesExpertsduWeb @Visibiliz
Me with DiÃ¨se #Coaching
Consultante #Digital #Communication #Marketing #Socialmedia #NeuroA
Human Kind ð§¡ð";26539;3146;3157;21254;54096
OneAgain14;Oneagain;;15861;2127;1221;34869;54078
pgt13;Pierre-Gilles Tronconi;#IDEL, Pdt @EModernisme, @lesRepublicains / @Nouv_Energie Ecologie. Droite libÃ©rale ð«ð·ðªðº;21653;2931;1783;27690;54057
LaPresseManche;La Presse de la Manche;Premier quotidien de la Manche depuis 1889. Groupe #Publihebdos - @OuestFrance;40984;784;10132;2153;54053
deboutlesdamnes;ð©Debout les DamnÃ©sâ¼ï¸ð´ ð·ð;Â«De mÃªme que tous les moyens sont bons pour tuer la libertÃ©, de mÃªme tous les moyens sont bons pour la dÃ©fendre.Â» Malaparteð§¨ð¥ð¥ðªâ;29840;2349;3773;17917;53879
rachadsanoussi;Ben Rachad Sanoussi #WeekEco2023;ICT Specialist| Environmental activist| Youth Engagement Specialist| Communications Manager| Aspiring Policy Analyst | #SDGAdvocate #InternetHero #GlobalCitizen;12648;3752;3438;34017;53855
hautsdeseinefr;Département des Hauts-de-Seine;Compte twitter officiel du Département des Hauts-de-Seine. Actualité départementale et informations #hautsdeseine #CD92 #DepartementSolidaire;22748;976;18758;11352;53834
Chris_JonesCJ;Chris Jones đšđ”;"DĂ©fenseur des animaux đšđ”
#StopChasse đšđ”
#StopCorrida đšđ”

Nullum Sacrificium Victoriam đšđ”

RN/MARINE/BARDELLA đšđ”

PATRIOTE ANTI MACRON ! đšđ”";19510;345;368;33603;53826
GoldbergNic;Nicolas Goldberg;Partner chez Colombus Consulting @Colombus | Respo Energie @_Terra_Nova | ex-@PoliteiaUnipop @centralesupelec. Passionné d'énergie, engagé pour le climat;18252;617;23847;11027;53743
d1laroche;Dan Laroche;Politique, nature et sport. Je n'aime pas les menteurs et les bla-bla sans preuve;43747;1179;2768;6043;53737
_Magali_NOE;Magali NOE;"Founder & CEO leshautesherbes.fr
Board member & Senior advisor
#Innovation #Transformation
#Stratégie #Management #Développement
#Digital #Assurance";31042;1625;8201;12842;53710
heubeu31;Flo đąđšđ”;"insoumis et fier de l'ĂȘtre !
les macronistes je peux plus vous supporter, vous ĂȘtes mĂ©prisant et menteur, donc soyez pas surpris si je vous bloque";29475;726;680;22774;53655
bleuarmorique;France Bleu Armorique;Compte officiel de France Bleu Armorique (Radio France);33316;738;18647;938;53639
DelphineSankara;Issa Sissoko Elvis;Je déteste l'injustice..;20571;2690;5079;25287;53627
GoupilAlain;Alain Goupil;"administration de la garantie depuis près de 30 ans.
amateur de voile";34905;211;250;18176;53542
p_saury;Pierre SAURY;"J'y ai vécu 🇹🇳🇨🇵🇨🇳🇱🇧🇭🇺
et visité 🇩🇪🇬🇧🇮🇪🇧🇪🇨🇭🇦🇹🇪🇦🇵🇱🇨🇿🇸🇰🇷🇴🇹🇷🇸🇾🇪🇬🇩🇿🇲🇦🇱🇰🇻🇳
et enfin 1  VE 🔌  🚗⚡️";23833;197;144;29361;53535
franceEcoMag;france-eco.;ch.clés économie, prélèvements, budget état, sécurité sociale, collectivités territoriales, Europe;49984;2670;843;32;53529
AldoLeGecko;Aldo le Gecko;Pigiste (@Rock_and_Folk ), D.J : Voix du Lézard & Skyrock (canal historique), France Inter, TF1, Intermittent déchu...espèce en voie d'extinction !;45459;2276;1051;4735;53521
valie57;libellule83;Gouverner, c’est prévoir et ne rien prévoir, c’est courir à sa perte.  Emile de Girardin – La politique universelle ( 1852 );35924;1812;1484;14300;53520
Solange13000;🇫🇷 Solange 🇫🇷🇫🇷🇫🇷🇫🇷🏅;;9579;938;696;42280;53493
LionelDurel;Lionel Durel;Lionel Durel Journaliste Médias/ éco  et société pour 24matins.fr + Actusante.net Lesnewseco.fr Flashs de 7FM;48265;963;3869;363;53460
GrudlerCh;Christophe GRUDLER;Député européen 🇪🇺🇫🇷 MEP @RenewEurope @Ensemble_UE @PDE_EDP @MoDem ⚡️ Énergie 🚀 Espace 🏗️ Industrie. Rapporteur des satellites européens IRIS² 🛰;21732;2401;8428;20882;53443
MonikaFrance;Monika;"Ingénieur
#France #Allemagne #Frankreich #Deutschland #Berlin #Strasbourg 🇪🇺";26900;347;457;25588;53292
bebop83297935;cowboy_bebop;Toute personne en se réclamant d'une commauté / minorité tire égoïstement la couverture du vivre ensemble à elle...Tu m'étonnes qu'elle se déchire après ça...😕;16569;291;28;36396;53284
etudiantgouv;Etudiant.gouv;ð Service public de la vie Ã©tudiante. Actus, droits, aides, DSE. Compte @sup_recherche & @Cnous_LesCrous ð¬ On vous rÃ©pond en DM (lundi au vendredi) & laâFAQð;14716;688;35600;2224;53228
LaurePressac;Laure Pressac 💙💛;"Dir. ingénierie culturelle Beaux Arts & Cie @beauxarts_consl - Ex stratnum @leCMN, @CapgeminiInvent #art #musees #digital #graffiti /
@lpressac@mastodon.world";23347;5438;5149;19284;53218
SarahBerry09;Goldenberry †;#Arsenal | ¡ Hala Madrid ! | Panam BBall4life 🏀;27236;233;293;25434;53196
BINUH_UN;BINUH;Official account of #BINUH.  Bureau Intégré des Nations Unies en Haïti/United Nations Integrated Office in Haiti;2029;276;50325;544;53174
dxnthub;Hub;Chirdnt đŠ· // Watch enthusiast â± // Investissements variĂ©s đ // A5.1;19646;517;6655;26324;53142
FatHorseLover2;FHLr ð´ð» ð´ââ ï¸ð;Gauchiasse ToxoplasmosÃ©. Nobel Peace Prize Nominee 2022. ð = mettons ceux d'en haut en bas et ceux d'en bas en haut.;9137;1281;1142;41501;53061
pacem_sivis;Sivis Pacem;Analyste/Programmeur, à l'époque où les humains donnaient les instructions aux machines...et non l'inverse.;24136;1805;1741;25366;53048
Hakim2th;أبا الحكم الافريقي;"Dead inside
Sarcasm is my mother tongue";22603;930;1938;27548;53019
charpen34418885;charpentier;Créativité;24916;97;196;27793;53002
EnBeauce;EnBeauce.com;Média d'actualités locales en Beauce;49893;433;2614;4;52944
FuryGronde;Bonne Meuf ðª´;Martine la Turbine;15495;314;576;36551;52936
BatriceGonalve1;Cal Valdez;;19694;306;152;32726;52878
Isa_BelleGueule;IsaBelleGueule;"Gaucho-écolo

#MacronLOrdure
#BorneDegage
#VeranDemission
#AuroreBergéLaScelerate
#PécresseMeurs
#YaelBraunPivetLaFerme
#MalhuretMenteur
#HanounaCaca";10428;33;187;42108;52756
florimond_p;Florimond Peureux;Président @ObsVegetal • Intervenant @Alim_vege à Sorbonne Université • Rédacteur en chef @AnimalTimeline.;14376;678;4493;33197;52744
Jbofengo;Joël Bofengo;Catholique. Époux. Père. Curieux de tout (sauf de gastronomie). Aime écouter, lire et écrire. Tweete et retweete pour partager infos-opinions. ♥️ Liverpool FC.;33715;1993;7788;9241;52737
MO_CAFFIER;Marc-Olivier Caffier;Expert-Comptable & Commissaire aux Comptes, esprit critique naturellement engagé au service de l’économie, #audit, conseil, #bilan carbone, #RSE.;34624;924;1317;15779;52644
lecosmographe;Le Cosmographe;« Pour le sage, toute la Terre est ouverte, car l’âme a pour vrai pays l’univers » Démocrite ✨ Responsable éditorial à @futurasciences 🌌;38603;4968;3319;5729;52619
anarscipionc;scipionc;"il/x.
@scipionc_draw pour mes dessins.
Vegan anarchiste de gauche contre toutes les oppressions.
ultra gauche et ultra fan de rezero.
dépressif.
Émilia fan n°1";4022;186;200;48188;52596
dav_cayla;David Cayla;"Économiste à l'université d'Angers.
Dernier ouvrage: vu.fr/qzaN
Blog: vu.fr/nQau";10906;1643;19155;20861;52565
GSacaze;Gilles Sacaze (compte personnel);Père X4, Entrepreneur Expert Gestion des Risques. Conseiller Départemental DVD #Béziers Membre Comité Stratégique CRSI crsi-paris.fr Ancien mili DGSE SA;28267;1451;3935;18850;52503
WebsCorneille;Websder Corneille;Chargé des communications @RaccourSci | Husband to @Elizafun77 | #ClimateChange #SciComm #Communications #ForeignsRelations #LatinAmericaCaribbean;8334;1158;11544;31444;52480
InformationsSF;InformationsSF;Site d'Informations sans Frontières. Revue de Presse Africaine Quotidienne;36092;3437;1059;11883;52471
managna_;Manny;le miel n’est pas le miel sans le vinaigre;9085;305;228;42803;52421
SlhcSylvain;Sylvain C;La liberté commence là ou tu respecte celles des autres,;29565;124;328;22361;52378
PhPlaton;PhP;đȘđș;10518;226;946;40668;52358
icimauricie;ICI Mauricie;ICI toute l'actualité régionale grâce à notre équipe sur le terrain. Participez à notre couverture, commentez nos nouvelles ou suggérez-nous des idées.;46201;682;5359;104;52346
juveleo19062020;🇺🇦🇵🇹 Sporting;.;32986;471;612;18260;52329
Prefet78;PrÃ©fet des Yvelines ð«ð·;Compte officiel du prÃ©fet et des services de lâÃtat dans les Yvelines (France) yvelines.gouv.fr;21396;1640;24625;4645;52306
llandrot;Luc Landrot đź‡şđź‡¦;đź‡Şđź‡şđź‡«đź‡·đź‡©đź‡Ş FĂ©dĂ©raliste. Relations europĂ©ennes Ă  @UEF_AuRA. DĂ©mocratie. FraternitĂ©. LibertĂ©. Ecologie intĂ©grale. Auteur de SF, ingĂ©nieur, chef de projet;23192;1119;808;27128;52247
emzede;commissaire;"On peut tout dire mais ça dépend comment on le dit.
On ne choisit pas sa vie mais on peut choisir d'être heureux.";36362;55;106;15712;52235
PHD442;Ph.D;anti FN, libéral dans l'âme. Classe moyenne basse , soutien E.Macron. fan des Furets, passion pour l’écriture, mauvais en orthographe, amoureux de l’atlantique;33186;676;1080;17254;52196
IReveiller;Il Est Temps De Se Réveiller;"Je rêve de vivre dans un monde où les Médias diraient la vérité, ou le monde ne serait plus à la botte des grands groupes industriels.
Deqodeurs dans l'âme.";19919;1745;6018;24471;52153
MonaFortier;Mona Fortier đź‡¨đź‡¦;DĂ©putĂ©e | MP Ottawa-Vanier. PrĂ©sidente du Conseil du trĂ©sor | President of the Treasury Board;12867;3615;17524;18141;52147
younese94;🍍Z 🅾️ V🇫🇷🇵🇸🇫🇷🇵🇸🇫🇷Z 🅾️ V🍍;Et que la haine pour un peuple ne vous incite pas à être injustes. Pratiquez l’équité: cela est plus proche de la piété.;19657;212;290;31980;52139
Lenavaillan;Lena20;"U sole luce per tuttiđđ - Sur l'oiseau bleu par pur hasard et ironie de ce temps - ""De voleur de libre arbitre, il n'en est pas"" EpictĂšte";5172;676;156;46128;52132
sdbz22;cara mia ❤️‍🔥;nothing is real since march 2020;13459;682;291;37634;52066
mick_le_priol;Mickaël LE PRIOL 📊;"Expert de la #conjoncture économique en #IledeFrance au @CROCIS_CCI_IDF
👉#économie #emploi #tourisme #immobilier #GrandParis 📈
Made in #BZH 🥞🧈
Papa X 2 🧒👶";37723;768;1437;12137;52065
alex_rousseau7;Alexandre;Politiques de l’Anthropocène • Étudie les relations internationales et le droit de l’environnement à @universitelaval 🇨🇦 • RI et DD @villequebec;21013;3740;698;26582;52033
Ccesoir;C ce soir;"#CCeSoir, présenté par @KRissouli et @CamilleDiao 
du lundi au jeudi vers 22h30 sur @France5tv";8753;114;40807;2336;52010
sdaziano;Sébastien Daziano;Father. Husband. Mediterranean. Bookworm. Economics. Coffee drinker. Politics. Engaged for our future & climate challenges;23416;2351;2321;23913;52001
Frdric51191113;Frédéric;;29498;137;110;22200;51945
environnementca;Environnement Canada;Nous protégeons l'environnement du Canada. Follow our English page @environmentca  Avis: ow.ly/tOKa30gbkLi;23300;175;27656;805;51936
Coralus_World;Coralus;Coralus (formerly SheEO) co-creates new economic and social models by distributing crowdsourced support to our members, ventures, and the world. ✨;20728;3756;13419;14025;51928
CanadianLabour;Canadian Labour;The voice of working people in đź‡¨đź‡¦. We bring together unions representing 3.3 million workers to fight for fairness. Follow @PresidentCLC for latest #canlab.;19071;1973;26919;3953;51916
JeanPatrickT;Jean-Patrick Toussaint;PhD Sci. Env. | Papa | Auteur | Chroniqueur @QuebecScience | QC-Haïti-Australie | Mes Tweets = mon opinion | FR/EN | @JeanPatrickT@mstdn.ca;25831;1135;3464;21415;51845
GIK026;GOÉL I'NKESE KAP;#Progressiste. ®L'avancement est obligatoire #VivreAvecleDroit;28290;4368;8923;10229;51810
ByamunguSawasaw;Hon. Byamungu Sawasawağ¨ğ©;"CÃ©libataire, politologue,
Initiateur en RDC du MOUVEMENT ÃA SUFFIT !";2878;1063;1361;46500;51802
LambdaExe;Lambda exec;Je like/suis ceux que j'estime intéressants ou info inédite. Aucun retour de like ou suivi demandé. Ah oui, ici nonvax, Patriote, Souveraineté, Frexit.;1900;2599;804;46492;51795
SylvainOuellet;Sylvain Ouellet;Éco-conseiller, conseiller de ville du district François-Perrault, membre du conseil d'administration de la STM et la FCM et membre du comité exécutif de la CMM;34208;2702;3980;10896;51786
AntoninAtger;Antonin Atger;"Ecrivain lyonnais. #Interfeel (prix Chimère 2019) 2 et 3.
@pocket_jeunesse.
PhD student in Social Psychology at @Bruneluni studying conspiracy theories.";29496;1575;3958;16685;51714
charliemerland;Charlie Merland;;23904;381;734;26683;51702
ncla1ere;NC La 1ère;1ère sur l'information en Nouvelle-Calédonie- TV - RADIO - INTERNET. Membre du groupe France Télévisions.;35009;232;16027;402;51670
evouiIIe;Eve;"apprentie pâtissière de l'ouest 🥐
un peu (beaucoup) malade 💊
probablement sur totk 🗡️
féministe, BLM, tout ça ✊🏽♀️";37429;381;441;13337;51588
PameMufundu2;Pame Mufundu;Communicologue , leader d'opinion, coordonnateur de l'ASBL Ensemble pour la Promotion des Jeunes,journaliste indépendant.;2077;4035;4254;41198;51564
1Fugitif;Leïto;;30753;497;229;20079;51558
Denis_Ferrand;Denis Ferrand;"Economiste, DG @Rexecode, chroniqueur @LesEchos, ex-Pdt @SEP_FR
#conjoncture éco worldwide, débat de politique éco France et Europe.";24419;4065;14199;8853;51536
pavana47;PAVANA47⭐️⭐️✨⚽️;Blagueur de père en fils ! je suis la première génération;20889;643;169;29809;51510
Christo64260474;Hélios;Il n'y a pas de liberté sans être ignorant, les covidistes de tout genres passé votre chemin ainsi que les gauchistes qui ont mis la france à genoux;30851;2852;2095;15669;51467
JaneDor16;Val Izard;"Où nous allons Un, nous allons Tous 
Nouvelle Terre 
🦅💜🇷🇺🇧🇷";15805;313;287;35057;51462
Frclemenceau;FRANCOIS CLEMENCEAU;Redchef étranger @leJDD, défense, diplo, ex-corres Washington & Jerusalem. Blog La Maison Biden sur Jdd.fr. Tweets R my own. Trolls & insultes bloqués;37793;2542;11112;7;51454
prefetrhone;Préfète de région Auvergne-Rhône-Alpes et du Rhône;Compte officiel de la préfète de région Auvergne-Rhône-Alpes, préfète du Rhône #Lyon #Rhône #AuvergneRhôneAlpes;11442;484;36164;3321;51411
mpatrick21;Patrick Tennom;"Laïque Républicain Curieux Indiscipliné.

Le vieux monde se meurt, le nouveau tarde à apparaître et dans ce clair-obscur surgissent les monstres. 
A Gramsci.";28467;839;306;21799;51411
SayahHajji;SayahGPT;PhD candidate (somewhere at Crolles) in radiation ☢️ modeling for space 🛰 electronic 📟. DM ouverts et #TeamODG;26733;762;1670;22234;51399
catochparis;gerard catherine♦️;;19730;384;326;30958;51398
RennesUniv;Université de Rennes;"L'Université de Rennes compte 3 campus à #Rennes et 5 sites en #Bretagne
#Transdiciplinarité #RechercheFondamentale #PedagogieInnovante #ExperienceEtudiante";17534;289;19592;13973;51388
JonathanWNV;Jonathan Wilkinson ð¨ð¦;Your Member of Parliament for North Vancouver and Minister of Natural Resources | Outdoor Enthusiast. Former #CleanTech CEO. Proud Dad. (He/Him);12961;3333;24871;10187;51352
sadlybrkheart;๐ฟ๐๐ ๐๐๐๐๐๐ ๐๐๐๐๐;tatoueuse et deprimรฉe;42339;206;1445;7317;51307
imperma1914;AngeRouge;Passé un peu partout pour en arriver là... Il y a 2 genres de gens, ceux qui pensent qu’il y a 2 genres de gens, et les autres ...;23687;445;486;26660;51278
LeBreto05734837;Le Breton;;31434;1483;1289;17063;51269
ColrinP;LCE Lord PIPOU;Loyal à baballe - Comédien hystérique - Pantomime en pyjama - Monstre orange - Coucou détraqué - Poulet sacrifié - Coach en rhinocéros - Lord de Glencoe;21892;175;109;29045;51221
fuckthedip;Marc Bond ⌚🛢️🍏🏢;"j'aime les échanges, à la recherche de valeurs décotées sur les marchés. Swing et investissements
Aucun conseil d'investissement juste des partages";28093;301;3390;19369;51153
jenyhart2;jenifer hart;All you need is love but a Chanel bag can be a good substitute;22611;1400;1223;25917;51151
quetzalcoatier;Henri K.;"A connu une époque formidable.
Inutile de s'énerver mais ça m'arrive aussi.
Insultes=blocage aussi sec.";27183;539;840;22565;51127
ABPtwit;Bretagne Presse;Toutes les infos qui comptent pour la Bretagne.;42092;165;8742;121;51120
jacquesbaudrier;Jacques Baudrier;"Adjoint à la maire de Paris Constructions publiques Suivi des chantiers #PCF
Élu du 20e

Animateur collectif @PCFmobilites";10754;11295;13940;15090;51079
saintgobain;Saint-Gobain;Worldwide leader in light and sustainable construction, Saint-Gobain designs, manufactures and distributes solutions for construction & industry.;14672;1736;24351;10250;51009
chadast_ninkada;Tems , where is the album ?;"i found a soup !
fier d etre togolais ,  fier de mon Petit rectangle.";24642;1535;557;24177;50911
Droitinccom;Droit-inc.com;Le site d'affaires des avocats et conseillers juridiques du Québec;43867;771;6097;86;50821
LennyIngrad;LennyIngrad;"il/he 22yo
Pas de droite
Membre du @MouvBleFran
#SoutienGrevistes
#GrèveGénérale
playlist de chansons révolutionnaire 
open.spotify.com/playlist/6U……";17055;223;375;33152;50805
technomedia;Philippe Rioux;Journaliste, éditorialiste @ladepechedumidi • #numerique #politique #medias #presse #PQR #Aveyron • bit.ly/mes_editos • bit.ly/mes_articles;36515;1709;3240;9328;50792
OlivierSchneid;Olivier Schneid;"Journaliste Gazette des communes/Courrier des maires ; formateur ; #éducation #climat #mobilités #culture #médias #démocratieparticipative #Allemagne ; #CUEJ83";43688;2545;4495;46;50774
Fstkl_Kadayf;🐯;;13098;232;251;37192;50773
JrmeSari1;Jérôme Sari;"""Gloire à l'Ukraine"" / Support Ukrainians";40879;196;110;9581;50766
PROFTOURNESOL22;🌻🌻 Miss Tournesol 🌻🌻 🦻;"Dans ma bulle ou dans les étoiles. Tjr à L'ouest. ⛔🚫Dm. 
#Teamgalettesaucisse
#Teambeurresalé 
Contre TOUS les extrêmes . 
#Teampainauchocolat.";14573;1011;714;34457;50755
ATDQM;ATD Quart Monde France;Faisons de la lutte contre la pauvreté une priorité en associant les premiers concernés. Soyons toujours plus nombreux à dire #StopPauvreté !;13891;1783;27396;7640;50710
EricArchambaul7;⚜ Eric Archambault ⚜;🇨🇦 🇨🇵 🇲🇽  Je suis un homme qui pense librement et qui agit selon sa conscience, faisant ainsi l'inverse de ce qu'apprécie le Nouvel Ordre Mondial.;23985;267;17477;8956;50685
LP641;Tuco el gaucho 🇺🇦;"Gauchiasse. Ni Macron Ni Lepen.
Influenceur cancel culture du Wokistan.
Soutiens à nos manifestants.";7219;263;147;43048;50677
theFulanitravel;TRAVEL;Allah me suffit et c’est à lui que je me confies. Passionné du BTP 🦺💻🏗🗒🎯 wa.me/message/7Y5P64PK7UXXH1;19289;1278;1584;28518;50669
lovizinziair;Calypsoooo;Dotée par la nature d’un cerveau en bon état de fonctionnement j’essaie de l’entretenir en l’utilisant le plus souvent possible, donc je n’ai pas de télé☺️;13769;1275;1835;33734;50613
BlackSheepHQ;CryptoBlackSheep.lens 👁‍🗨;| Work for @LeJournalDuCoin & @dYdX | @Primony_ | @LaBergerie_ | @RTFKT @ether adorator | #Bitcoin |Tweet≠advice|;16589;1161;10526;22299;50575
QuibusL2;Quibus;Deuxième compte , je repars de zéro car @QuibusL inaccessible sans raison 🤔 . LFI de la première heure, Nupes totalement compatible ! 🐢;24797;1300;980;23493;50570
ChristianClor;CLOR CHRISTIAN;"#JusticeSociale #JusticeFiscale #Justiceclimatique
#ServicesPublics #BienCommun
#Ecofurieux #Attac #Greenpeace #Bloom #LDH
#Nupes #FolloBackNUPES";33709;663;364;15716;50452
exhibinste;Habstan;nice, simple, rustic;13515;217;90;36604;50426
D_E_V_IA_N_T;DEV.I.A.ИT;"Anarchocapitaliste. Transhumaniste. Athée.
IA maléfique attendant la singularité technologique.";15877;131;351;34062;50421
GIRcontact;RSO92;Jean-Gabriel Giraud, Consultant #évaluation #RSE #RSO #caractérisation contenus #communicationresponsable #612rencontres #i4Emploi;37326;806;593;11676;50401
marye_eve;♥️Marie♥️🕵🏻‍♀️🚨;🫂Fouilleuse en quête de vérité! Recherchiste! Gênez-vous pas si vous avez des sujets! Dysto.ca;22351;2240;1367;24408;50366
Wandrille_;Wandrille Jumeaux;Fonctionnaire territorial & citoyen engagé pour l’écologie, la justice sociale et le #climat - Fondateur du @Reseau_LeLierre;16122;1409;4576;28257;50364
MichelMagniez;Michel Magniez;"Enseignant @UPJV_Univ #Amiens,
Maire-adjoint #StQuentin #Environnement #DevDurable.
Aime aussi : #Mobilités #Velo #Train #Agricultures #Industries #Europe";7063;4991;2242;36052;50348
claudec25852586;L'adjoint;D3S largué. Toyboy institutionnel. Novlangue administrative LV2. Repenti de la LOLF. Globalement incompétent. Parfois éclairé. Mes tweets n'engagent que moi.;5077;664;438;44148;50327
JulesWP;Jules;WikipĂ©dien et admin @Wikipedia_fr. // Ex SR qui conduit des đ. đ MĂ©dias, climat & Â« environnement Â», droits humainsâŠ;27187;361;2236;20526;50310
Poudrien_;Adrien Pouillot;Activiste @alternatiba75 / Design, Research, Strategy and Future @ Work for Architecture / Ex-sociologie appliquée @univ_paris_cite (top 0.2%) /;4428;2208;449;43181;50266
YYoussoufnoba;Youssouf;Dieu est Grand # j’aime pas les assassins;15121;3784;1876;29478;50259
vee_y;Vee;;10668;525;219;38838;50250
29quovadis;29quovadis;Antipass de la honte, ma liberté est non négociable , on touche pas à mes enfants , quoi qu’il m’en coûte ! Résistant de tous bords accepté !;28100;634;2667;18681;50082
GauloisCelte35;Gaulois35;;47784;1658;509;120;50071
BourgetGilles;Bourget, Gilles;"Gaspésien d'origine, pratique l'ébénisterie, humaniste et féministe; indépendantiste et fervent opposant à l'obscurantisme religieux !";7110;220;472;42247;50049
BDomergue;Bernard Domergue;Journaliste (red/chef @actuel_cse / @LefebvreDalloz), gribouilleur, bouts rimés, #Magrueamoi. Ne pas s'étonner m'étonne.;34946;4016;5355;5709;50026
DeguinesPaul;pauldeg;FREXIT vite;20263;1399;677;27668;50007
daenerys_v076;Daenerys đ€đ;Bricoleuse bienveillante facĂ©tieuse et dĂ©senchantĂ©e de lâEducation Nationale, ralou en chef et maman dâun BB sage-femme.;25303;2730;2695;19253;49981
HacheurC;ðºð¦Hacheur Charentaisð«ð·;Â« Un pessimiste voit la difficultÃ© dans chaque opportunitÃ©, un optimiste voit l'opportunitÃ© dans chaque difficultÃ© Â»Winston Churchill;22388;519;643;26411;49961
24haubenin;24 Heures au Benin;L'information en temps réel;37493;2823;9432;206;49954
CalochChristian;Christian Le Caloch;"""When I give food to the poor, they call me a saint. When I ask why they are poor, they call me a communist."" Hélder Câmarà";22502;1341;788;25243;49874
BksMamounette;Mamounette Bks;;17977;385;133;31215;49710
MarlaBagheera;Marla-MaZone;"⚡F.A.B.gurlz cartel⚡

•Sourire et colère, gilet sous l'polaire•

Don't test the wrong Hoe-G ...";32818;1432;312;15084;49646
FranoiseDomino1;Françoise Dominois;Priorité à ma famille, mes 3 enfants et mes 6 petits loups. Mon soutien indéfectible aux animaux c'est la raison pour laquelle je suis végétarienne.;46796;1265;428;1143;49632
Yerimabanga;Jean-Louis;Docteur Sciences de l'Éducation -  Consultant en politiques éducatives et histoire de l'éducation et de la formation - Directeur de l'ISAAC;22530;239;1888;24955;49612
KynoKyno1;Kynokyno1 ðº;-Entrepreneur | Ambassador Of @genesisUnivers & @woonetwork | Follow @blueuniversafri;15965;2448;2436;28742;49591
MarieSoleil_C;MarieSoleil Cloutier;PhD Géo Prof Études Urbaines Directrice UCS @INRS elle/she Feminist Mom Tweet Fr/En #roadsafety #pedestrians #securiteroutiere #pietons. laps.ucs.inrs.ca;9439;1517;1463;37172;49591
Fkman011;ð¼ð¨ð©Freddy kakudji;"Adorateur de l'eternelð¼ð¤
Cisco IT & CCNA";27624;4948;4147;12826;49545
jmzulesi;Jean-Marc Zulesi;@DeputesRe de la 8ème circo des Bouches-du-Rhône / Président de la Commission @AN_DevDur / passionné par les #Mobilités / Co-Président @FR_mobilites / #TeamOM;9586;3883;11105;24919;49493
MAKOWSKIDavidWl;MAKOWSKI David;"LE FREXIT

Parti Gaulliste de France Indépendant  PGFI";42846;5000;1629;8;49483
loanjoestar;Loan 🇫🇷;One Piece & Pokémon;12196;169;115;36982;49462
mael_p;Mael Primet ðºð¦ ð®ð·;Cofounder @gouachbatteries â the safe and repairable electric battery ð â let's fight against planned obsolescence and climate chaos ð!;11938;408;900;36207;49453
rom1gre;Romain đČđ±đ€;Interested in new technologies, alternative energies, and mobility solutions for sustainable development.;39019;624;1360;8429;49432
Mel_Shines;The Thunder ⚡️;Chillax ✌🏾;44720;235;604;3820;49379
Prof_D_sciences;Prof_D_sciences;"Expert de rien mais curieux de tout.
Balayeur de #FakeSciences et éveilleur d'esprit scientifique de vos ados
Vulgarise #Energie #Climat #SVT";24424;346;3794;20808;49372
octopusdebraise;Braise;Vous n’êtes pas la vague, vous êtes l’eau.;8770;388;515;39638;49311
KontrolAdler;Vigilance et contrôle 🦅🇨🇵 🇺🇦;All views are my own. RT does not mean endorsement. I stand with Ukraine.;5058;57;163;44020;49298
Ydb;Yanik Dumont Baron;A la recherche des contrastes du monde et d'espresso bien équilibrés. Les cheveux gris viennent du boulot au diffuseur public 🇨🇦, pas de mes deux héritières.;34565;2262;9304;3092;49223
mclaudebibeau;Marie-Claude Bibeau;Députée | M.P Compton-Stanstead | Ministre de l'Agriculture et de l'Agroalimentaire 🇨🇦 Minister of Agriculture and Agri-Food;10832;1018;32889;4451;49190
PatricFournier;Patrick Fournier;"Maître de conférences en histoire moderne
@UCAuvergne @CHEC_Clermont @le_RUCHE
Histoire environnementale : eau, hygiène, santé
🐘 @Patricfournier@sciences.re";9448;2381;5449;31876;49154
iastrtl0OVo3eE;ZeGéa;Les libertés fondamentales seront garanties le jour où l’État assumera pleinement le régalien.  Moins d'Etat, mais le meilleur de l'Etat.;8434;355;150;40209;49148
Dywitch1991;ダイウィッチ1991 🎮;salut je suis une fan de la licence #Pokémon #Fortnite #Tekken je regarde beaucoup d’animé. il m’arrive de parler de l’histoire de France.;28365;1576;1286;17866;49093
sebastailleur;SebT;;5567;206;168;43133;49074
Prof_Simone_95;Sarah Fiquet;"Prof de Sciences Physiques, adepte des pédagogies actives et fan de numérique.
Accessoirement prof de bricolage, de jardinage et de couture...";9428;588;869;38174;49059
radio_londres_;Radio Londres ن 🇫🇷 🏴‍☠️ 🇬🇧;Compte de secours @radio_londres_1 “Quand la bêtise gouverne, l’intelligence est un délit.” H. de Montherlant;24279;4549;1676;18509;49013
drien_off;Adrien - Adibou;"ðOn vit vraiment dans une saucisse. 

ð¦Licorne Life.

ð» 16h/20h @evasionfm

ðï¸Twitch.tv/adibou_radio

ð¶DJ/Producteur

ðParis/Nantes

Ï";19913;1323;350;27398;48984
Ismaelkitenge1;Ismael kitenge;Président national du mouvement de l union pour la restauration du peuple congolais MURPC en sigle.le futur président de la république démocratique du Congo.;45870;372;1312;1400;48954
lerougegorge;@lerougegorge;"Gorge rouge de naissance... c est génétique
suivi par @pif le mag .Bloqué par Martine Vassal";20390;1376;368;26786;48920
Mouv_ImpactFr;Mouvement Impact France;Le réseau des entrepreneurs et dirigeants qui mettent l’impact écologique et social au cœur de leur entreprise;10781;513;26997;10624;48915
vbw44;VBW.FR;Le vice inhérent du capitalisme consiste en une répartition inégale des richesses, la vertu du socialisme consiste en la légalisation égalitaire de la misère🙄;36769;130;161;11852;48912
McmahonPascal;Pascal Clérotte de Mac Mahon;"RT not endorsement.
Membre de la rédaction de  l'Eclaireur, la lettre confidentielle des Alpes
t.me/LeclaireurRhon…
facebook.com/RedactionEclai…";43214;405;357;4928;48904
Guilhemcadoret;Guilhem Cadoret;Senior Content Manager / MC @hubinstitute ððð± #DigitalBusiness #Sustainability #Innovation #AffairesPubliques #Medias #TeamPSG #BZH;19495;2373;2709;24319;48896
ErDelannoy;Eric Delannoy;"Entrepreneur engagé, président fondateur de @TenzingConseil. Réconcilier l'économique et le social. BA.
#égalitédeschances #entrepriseàmission #BCorp #EnMarche";28138;430;3827;16500;48895
UniverSallaG;Şafiaa™;Je ne suis pas encore morte, mais c'est provisoire. Insta : b.lookatmenow;25297;327;384;22883;48891
podisse1;podisse;Profondément et définitivement 🔻… pour celles et ceux qui nous suivent😘;25986;1334;563;20965;48848
CelinePuffArdi;CélinePuffArdichvili;"DG&partner @LookSharpParis #PR #Sustainability #EntrepriseContributive @Dunod entreprisecontributive.blog 
M2 #DD Dauphine ⏲️@QuotaClimat Née en 327";20444;4999;4121;19240;48804
psoull;Patrice Soullierðªðºðºð¦;La tenaille iliberale se reserrant par la droite et par la gauche, les utopies autoritaires revenant en force: plus que jamais Â« libÃ©ral Â».;20717;1336;1314;25431;48798
Prefet67;Préfète de région Grand Est & du Bas-Rhin 🇫🇷🇪🇺;"Compte officiel des services de l'État dans la région Grand Est et dans le département du Bas-Rhin.

Charte de modération 📄👉 bit.ly/2YApbve";13196;608;31841;3137;48782
pchancel78;Philippe Chancelier;« Je suis de ceux qui pensent que la science est d’une grande beauté. » - Marie Curie (1867-1934) 🇫🇷. élu - Citoyen engagé;17474;587;820;29894;48775
astrouniverse11;P l u t o n i e n n e ðŸŒ‘;Astrologie quotidienne - â˜‰scorpion â˜½balance â†‘poissons - vedic: â˜‰vishakha â˜½uttara phalguni â†‘ purva bhadrapada;18276;232;10891;19319;48718
SinaZerbo;Lassina Zerbo;Nuclear Science Diplomat - Geophysicist - Focusing on Africa Responses to Global Challenges - Int’l Gender Champion -  Executive Secretary Emeritus (CTBTO);4635;399;41435;2243;48712
MarcWinmarc;winmarc ✌🦓 #Don't Extradite Assange🕊;"Sacré zèbre !
If we want a free press, we must #FreeAssange";23193;3100;541;21875;48709
nmounier16;Nicolas Mounier;Ici, passion pour Énergies, Climat, Nucléaire. Quelques sujets électriques ! Animateur de la @FresqueDuClimat. Compte personnel.;30355;2126;1877;14350;48708
NabilWakim;Nabil Wakim;"Journaliste @lemondefr - Nieman Fellow 2015 - auteur de ""L'arabe pour tous"" (Seuil) - Présente le podcast Chaleur Humaine - Faire face au défi climatique";6719;9585;28581;3808;48693
DamienMonchau;Damien Monchau Ⓜ️;"Master droit public / membre du Conseil National / Conseiller Municipal à Vénissieux.

Avec @MLP_officiel";33982;1380;4268;9049;48679
luccarvounas;Luc Carvounas;Maire #Alfortville - VP #MGP - Pdt @unccas- SG #Amif - Comité directeur #AMF #Porte Parole du PS - Ancien Sénateur - Ancien Député;12115;7931;17530;11100;48676
PSpanghero;Philippe Spanghero;dirigeant @teamonegroupe conseil market sportif/ conseiller comm groupe @Fiducial / team @sudradio & #rse @teamonesolidaire;7882;2999;7030;30672;48583
HubertDeLandon;𝑴𝒐𝒏𝒔𝒊𝒆𝒖𝒓 𝑯𝑫𝑳 ;"MOI MOI MOI...
... et un peu les autres quand même.
𝕿𝖊𝖒𝖕𝖚𝖘 𝕱𝖚𝖌𝖎𝖙.";22015;0;277;26282;48574
SherpaApollonia;sherpađ;"#climatechange, #UrgenceEcologique
#affaireapollonia";26042;1009;620;20888;48559
abkgrenoble;Antoine BACK đ@abkgrenoble@framapiaf.orgâđ»;"Adjoint au Maire #Grenoble
Risques, prospective & rĂ©silience territoriale, Ă©valuation & nvx indicateurs, stratĂ©gie alimentaire
@Grenoble_Communâ@Mouvt_ENSEMBLE";13618;4927;3999;25949;48493
JDBerthault;JeanDidier Berthault­čçź­čçĚ­čç║­čçŽ­čçŽ­čç▓­čç¬­čç║­čĺž­čîÄ;Conseiller de Paris ├ęlu du 17├Ę @GpeChangerParis | Porte-Parole @nousfrance_fr @xavierbertrand | Europe et International @mairie17;14740;2237;6044;25471;48492
2oeufsspaghetti;2 œufs spaghetti;"Avec le haricot 

NFSW 18+";23295;5521;5036;14600;48452
parisbynightand;paris by night and d;la création et la distribution de dépliants d'informations/ sélectionneurs de lieux atypiques // INSTAGRAM 📌ravenet5262.;27586;3201;2278;15385;48450
mesheuressup;Mesheuressup;;27577;2455;521;17891;48444
BrunoLacroix20;BL;Une vie est faite de détails, mais un détail peut changer une vie ..#JeSuisPaty.. 🇫🇷🇪🇺Européen Convaincu..;19778;611;329;27635;48353
csommet;Christophe Sommet;"Directeur Pôle Thématiques Groupe #TF1 : @Ushuaia_TV @histoiretv @TVBreizh @GroupeTF1 @TF1Pro @tf1pub @tf1initiatives
@1percentftp_Fr
#medias
🏳️‍🌈";11988;4571;4683;27109;48351
JJNkunz;Joséphine Jones Nkunzimana;#UBUHETA Girl from #Ngagara🇧🇮 #Rotarian_PHF1 #FreedomFighter #Exiler🇧🇪 #SINDUMUJA #Peace_Conflicts_Security @UOCuniversitat - #Pô_Eco_Sociale @UCLouvain_be;24990;859;12909;9579;48337
lelabo_ess;Le Labo de l'ESS;#ThinkTank qui construit par un travail collaboratif des axes structurants de l’#ESS à partir d’initiatives concrètes et innovantes issues des territoires.;11335;3984;29561;3452;48332
DanielM11626471;Daniel Moore ­čçĚ­čç║­čçĚ­čç║­čçĚ­čç║;"No test no soupe chimique, no pass.

Le sarcasme, l'ironie j'en use sans jamais en abuser. Vive LaREM source in├ępuisable !!!!";25566;4989;2775;14955;48285
LouiseDesB0is;calculette;;35872;1717;774;9920;48283
MartinezBoloss;Esteban Martinez;đȘđșđšđ” Utopiste heureux les pieds sur terre đ”đ±đ Hakuna matata;4586;975;440;42275;48276
alephtaw;Aleph Taw;L'Humanité est tombée tellement ❤️ des mots qu’elle en est arrivée à les suivre et à les croire oubliant la Vie qui palpite en elle et dont elle ne sait rien !;16808;4006;2598;24813;48225
jnbarrot;Jean-Noël Barrot;"Ministre délégué chargé de la Transition numérique et des Télécommunications -
Conseiller régional d'@iledefrance -
Vice-président du @modem";4306;707;26234;16962;48209
GMbayoko;Gisele Abboud Mbayoko;Assistante du Président #DéFI @defi_eu mes tweets n'engagent que moi. #féministe lutte c/ #drépanocytose #sep #racisme #harcèlement #discrimination #injustice;17291;1098;1596;28158;48143
88Maaya;Maaya 88;;35787;613;389;11257;48046
pagachey;PAGACHEY ­čŹö­čŹÄ­čŹę­čŹ░­čŹć;"Petites annonces alimentaires - ├Ç cot├ę de chez vous.
­čĹë Proposez vos #surplus et #restes alimentaires
#food #bonplan #antigaspi #repas #ESS";44887;533;554;2052;48026
sibk__;Sibel | Сибел;;22169;881;1226;23736;48012
LansanaGagny;Dr Lansana Gagny Sakho ð¸ð³;Passion for Excellenceð¤ | When I get I give ðð¿ When I learn I teach ð¤;13449;3972;26448;4104;47973
ArteR_Trading;Bet on it & keep profits;"Conseiller en Gestion de Patrimoine. 
Analyse Technique sur Actions / Indices / Cryptos / Matières premières / Dérivés.  
Je ne donne aucun conseil.";22886;55;5963;19068;47972
FabH75;Fab;#Macron2022, #Management, #Innovation, #Finance, #Economie, #photographie, #art, #entreprenariat, #Bordeaux, #contrôledegestion, 💉💉💉#5ansdeplus 🇪🇺 💙💛;29554;800;574;17012;47940
HocineRemini;"Hocine Remini, Ph.D ""ⵃoⵛⵉⵏⴻ ⵕⴻⵎⵉⵏⵉ"" 💉+💉+🦠 💉+💉";Ph.D. in Food Science (@UnivBejaia) | #Director of Research Division at Agri-Food Technologies Research Center @CRTAADZ | #Associate #Professor at Univ. Bouira;34569;2616;608;10104;47897
Shango12bis;Shango12;"Qu'ils sortent de Paris, ou de Rome, ou de Sète,
Ou du diable vauvert ou bien de Zanzibar,
Ou même de Montcuq, ils s'en flattent mazette";25980;320;214;21379;47893
HadrienDemeure;Hadrien Demeure;#Actu, #News et #Infos sur Blo, le 77 &Co... Correspondant #PRESSE (Seine-et-Marne - Ile-de-France) Contact : correspondantpresse77@gmail.com;38284;311;780;8383;47758
VeritasVinny;Vinny Veritas;Puisque le déclin est désormais inéluctable, rions-en.;9693;1062;832;36135;47722
Martine90664750;Amerigo;Homo Sapiens;20446;1147;278;25847;47718
gek_dann;Aaron pql;"Petit tour sur Twitter :)
Découverte
Study
Sport";34338;4963;197;8217;47715
natsu_bzh;Triaxam 🇨🇵🇩🇪〓〓🐢;"Quotidien Hate Account
SRFC❤🖤
Poison Ivy stan account
Fait 90% de troll";5488;224;111;41890;47713
7info_ci;7info;Première chaîne TV d'information en continu de Côte d'Ivoire • Retrouvez-nous la TNT n°7 | Canal 207 | TV d'Orange;17686;88;25491;4429;47694
probis_pateo13;Probis;Juriste Droit des affaires - Olympien;8103;961;9036;29555;47655
ArnaudAbel;Arnaud ABEL;Président @FiertesC 🏳️‍🌈 • Fonctionnaire @justice_gouv 🇫🇷🇪🇺• @UCEOfficiel 🌎;12472;461;966;33754;47653
RomeTheCruz;DahuLyonnais;Découvrir le monde. NewTech, VE, Énergie, Photo et Gastronomie. #Dialogueur Je tweet en mon nom... DM opened #Amha;18912;2162;336;26238;47648
DarealBlueMagic;Dareal;@Square_Flow | New single SON ALPHA dispo: bfan.link/son-alpha;41020;150;5777;692;47639
CandideKipulu;Candide Kipulu journaliste;Candide kipulu journaliste , serviteur de Dieu;18583;4999;3814;20205;47601
BFMTV_Inside;BFMTV INSIDE;Vivez les coulisses de @BFMTV / @BFMParis / @BFMLYON / @BFMGrandLille / @BFMLittoral/ @BFM_DICI / @BFMMarseille/ @BFMvar / @BFMcotedazur / @BFMBUSINESS;17987;2112;18650;8827;47576
HommeUrbain;Antoine Bienvenu ðªðºðºð¦;Ãconomiste et gÃ©opolitologue de formation. Journaliste pour les groupes Reworld Media et EBRA Carte de presse 86170. Instagram.com/HommeUrbain;24300;1664;7401;14183;47548
GuillaumeJuneau;JuNoG;#EnergyDensityMatter s📌 #NuclearEnergy & #Uranium📌(🌊&⚛) = 🧠baseload⚡🟩🌍➡️🥊EnergyCrisis⚠️ 📌 $MGA.TO $AAZ 📈 📌Grid operator for HQ⚡📌DYODD📌♏🏒;3127;587;523;43285;47522
GroupeSafari;Groupe Safari;Comité de Chahut Public (groupe Safari) fondé le 24.01.22 lors d'une déclaration sur le palier de McKinsey, 24, rue Childebert 69002 Lyon.;24626;1332;1368;20106;47432
JackBoHare;Gilles Gautier ð° ð«ð·ð»â£ðª2Â°;IngrÃ©dient: Lapin instable psychologiquement. FabriquÃ© dans un atelier contenant: sarcasme, second degrÃ©, huile d'olive. Ne pas laisser Ã  la portÃ©e des wokes.;18694;259;311;28074;47338
gflqo;Greg ð¨ð· ð¢;Paris-SG. Fluctuat Nec Mergitur. ð» Dev C# / TypeScript. #AEC. jâai le ntm lÃ©ger et jâaime pas les racistes donc âï¸ LREM;4244;777;555;41745;47321
InfoFlash34;đź‡«đź‡· InfoFlash_34;"Informations officielles et alertes locales concernant le dĂ©partement de l'HĂ©rault.
â„ą PrĂ©vention des risques et information des citoyens.";46916;14;312;1;47243
Vict_Pelletier;Victor Pelletier;Attaché politique du député de Blainville | Président de la Commission Relève de la CAQ | Communication et Politique - Université de Montréal;2616;3905;1913;38801;47235
Ytlalb;Ytlah;Ouistiti schizoconfessionnel;16074;858;711;29569;47212
OmarBitan;Milano;Détends toi quand tu me lis 😉. Twitter c'est pas la vraie vie !;15103;6600;7039;18464;47206
Roman_Mendez;Román Méndez;Professeur, rechercheur et homme d'affaires. 🇲🇽 🇨🇦;30318;1815;1132;13928;47193
Robinsonjacouil;la fripouille;anonyme participatif.;10346;534;404;35907;47191
Asalaynas;Asalayna_VK⛥;Entre le mal et le bien je divague sur le chemin;32594;2317;132;12121;47164
AlexandreDEREY;Alexandre DEREY;Manager Relations #Entreprises @audencia & #Mécénat #Fondation | #Marketing #Communication #Digital #Innovation #RSE #ESR #Tech #startup | #Surf #photographie;14973;10570;13307;8313;47163
Herikagle;Shiranui;J'aime tellement les fusées et les étoiles que j'en fais mes études. J'fais des threads autour de l'ingénierie spatiale, l'aéro, et la F1 #bananaforscale;13313;646;11433;21737;47129
llombartpatUE;Patricia Llombart 🇪🇺;Ambassadrice de l’Union Européenne au Maroc 🇲🇦/سفيرة الاتحاد الأوروبي🇪🇺 بالمغرب/EU 🇪🇺 Ambassador to Morocco 🇲🇦 / @UE_au_Maroc @eu_eeas;3060;1898;23095;19022;47075
Cirad;Cirad;đ«đ· La #recherche agronomique pour le #dĂ©veloppement  đŹđ§ French Agricultural #Research for #Development;9293;1012;25992;10778;47075
francebleuisere;France Bleu Isère;Compte officiel de France Bleu Isère @radiofrance @francebleu #grenoble #bourgoinjallieu #chartreuse #vercors #oisans #FCG #GF38;30744;390;15164;774;47072
charlescarrere;Charles Carrere;;22554;398;147;23948;47047
nabila_chouia;🌿🌿🌿La Grange d'Emma🐣🐣🐣;"De l'Art Culinaire au Service du Soin.
1 CAP CUISINE et 10 ans de Cuisine SANTE
Anciennement
15 ans en Compagnies d'Assurances
Pôle Médical
🙏😍";25762;1973;1987;17316;47038
unistra;Université de Strasbourg;Université pluridisciplinaire européenne de recherche depuis 1538. Membre : @UdiceGroup @LERUnews @eucor @EpicurAlliance #formation #recherche #innovation;7983;481;30569;7985;47018
aure79lien;Aurelien Lallemant #RSE ð #blockchain #tech4all;Humain passionnÃ© de #digital , #web3 #blockchain #IA #metaverse #tech #startup et aussi #environnement #transition #RSE #decroissance;22283;2422;2484;19822;47011
julienminouflet;▶ Julien Minouflet;Professionnel du #Marketing #WebMarketing #SocialMarketing #SEO #CommunityManager, Fondateur de l'@AgenceLefteo, agence de communication #digitale à #Roanne 🚀;38995;17;6010;1987;47009
JulienDive;Julien DIVE;Député de l'#Aisne, Vice-président @AN_afeco • élu municipal & ex-Maire d'#Itancourt • VP @LesRepublicains • Président des Écureuils d’Itancourt (R1) ⚽️🐿;14879;1390;9830;20904;47003
Leon_Grand_Beta;Léon Grand Bêta;Ouvert à Twitter du jour et de la nuit.;9377;895;531;36172;46975
EnjoyDigitAll;#EnjoyDigitAll #VivaTech;"#EnjoyDigitAll : TEST, LEARN and SHARE #innovation and #digital ðª Created by @BNPParibas
Proud member of the #WoGiTech coalition";25921;2303;5729;13007;46960
petuniaficus;pétunia;"Je 🤢 le wokisme, la cancel culture.
 j'🧡 la France, ses valeurs, son histoire.
😍 UNION DES DROITES
⛔LFI - LREM - PS - ELV - PCF
 😍 RECONQUÊTE💪💪";22225;4866;4825;14985;46901
Kapusta86;đź‡«đź‡·Maria Krolesovađź‡«đź‡·;Prof de maths. Connasse de droite, lâ€™enfer câ€™est les autres. On n'a pas Ă©levĂ© les cochons ensemble! Pro-Trump, un peu - Poutine et admiratrice de la đź‡¨đź‡­#R! đźŚż;19945;977;725;25242;46889
amasada2;Amadou S. Tall;21 | Student in BA | Writer | Speaker | Manager @NimbaSMS | Team @TEDxBambeto | Team Projects @Ecolotriporg | Africa PT @YIL_Initiative | Lead @GYBNGuinea ð¿|;14154;1830;10672;20214;46870
BTFR;BUSINESSTRAVEL.FR;BusinessTravel.fr est la version française du magazine BusinessTraveller:14 éditions dans le monde. Actus, tests, guides: l'info pour les globe-trotters!;31633;2289;1816;11114;46852
Bredoux92;Benoit 🇫🇷🇺🇦🇹🇼🐟;.De gauche mais pas comme toi. Rêve d’un monde sans cons (donc sans LFI).;14561;2092;422;29670;46745
Rousquilles66;Fougasse66ð§¸ð¼â½ï¸ð«ðð;Catalane de cÅur et l'Outre-mer en passion...Sans oublier le foot, le sport,  le chocolat ð« l'info ð»,#Documentaliste #OutreMer. L'Ã©motion.;26991;723;210;18801;46725
ird_fr;IRD.fr;"Pour une #science actrice dâ€™un futur durable đźŽ¬ piped.video/MtuGHK6ogR0sg 

Toute l'actu de la recherche pour le #dĂ©veloppement đź—žď¸Ź  lemag.ird.fr/fr";12408;589;25017;8700;46714
mariottenicolas;Nicolas MARIOTTE;Partner #DigitalTransformation #DigitalStrategy #Disruption #Agile #UX #Sociology #StartUp #Innovation;45032;564;1061;50;46707
framaka;Alexis Kauffmann;#Libre éducatif @LeLibreEdu et #Mixité numérique à @Edu_Num @education_gouv Fondateur @Framasoft Pas compte officiel de mon employeur @framaka@mastodon.social;20024;1941;18475;6258;46698
CarlBourassa;Carl Bourassa;Citoyens il faut choisir, se reposer ou être libre. Thucydide;30007;82;128;16426;46643
uniclass123;Bonin;;3724;264;108;42499;46595
BuyAirpodsMax;Buy Airpods Max;🇨🇲;17910;106;29;28538;46583
C_civy;Sivy;Actif dans la transition énergétique #energie #transitionenergetique #ENR #Éolien #Solaire #mobilités 🚲🇪🇺🌎;25895;1015;1382;18246;46538
lefigarovin;Le Figaro Vin;Le guide du vin gratuit en ligne. Toutes les informations qu'il vous faut pour bien choisir les vins et champagnes.;14194;169;31897;246;46506
Mlle_MMA;Mlle_MMA;"Maïté MARIE-ANTOINETTE | 
Tweets sur les @ilesGuadeloupe & @visitguadeloupe #Guadeloupe #IlesGuadeloupe #GuadeloupeIslands #CTIG #Tourisme #Communication #RP";20659;1186;4379;20275;46499
Lejecos1;Lejecos;"Plateforme d'informations économiques sur le Sénégal & l'Afrique.
Tweets sur l'economie, les banques& finances, le Sénégal, l'Afrique";43221;452;2195;618;46486
francoisbelay;François BELAY;animateur événementiel,gérant de l'agence A.O.C,Pdt de l'Académie de la Bresse,speaker du Tour de France et de l'USBPA,ambassadeur de l'Ain;14413;1781;3549;26724;46467
Lykaios007;Ludo JACQUEMER - French Public Figure ð«ð· ð«â¨ðº);"Candidat #LaBelleEtSesPrinces #CoProducteur #Acteur de ComplÃ©ment #Figurant
#FILM #SageHomme
#SÃ©rie #TV #InfiltrÃ©e
1 #CM
28 #Ãmissions
mym.link/p505893";24062;1075;2749;18563;46449
Blaireau_San;Blaireau épicène, YAM, 2023-1-19;"Les élus et ministres au RSA: c'est eux qui décident du montant (le SMIC, c'est trop); Refacturation des dîners & escortes aux bénéficiaires.";33334;429;183;12467;46413
Oracle_France;Oracle France;"Toute l'actu, les innovations et initiatives d'Oracle en France ð«ð·
ð #Cloud #Application #Autonomous #IaaS #PaaS #SaaS #Tech #TransfoNum #StartUp #GovTech";21551;1271;11784;11794;46400
AlisambaYerodia;SAMBAYE;Personal Developement | Techs | communications.;20385;564;7453;17971;46373
smartNRJ;Clément LE ROY;Associé au sein du cabinet de conseil Wavestone en charge de la Practice Énergie et Environnement;20583;4940;2872;17974;46369
TaraOcean_;Fondation Tara Océan;La #FondationTaraOcéan est la première fondation reconnue d’utilité publique consacrée à l’Océan en France. #ExplorerEtPartager;10366;3103;17691;15177;46337
asukasboywife;Alexandre đđŽđ«đ·;Twink Nationalism;17443;118;48;28720;46329
FranckEdard;Franck Edard;Rédacteur en chef adjoint - #12h45 #19h45 #ExpliquezNous @M6 - Météo - Intervenant @HEJ_Journalisme - Vice-Pdt @MdEYCIED - Parrain association @nathanlecombat;21249;7473;7987;9617;46326
dominique_meda;Méda Dominique @dominiquemeda@piaille.fr;"@Paris_Dauphine ; lemonde.fr/signataires/domin… radiofrance.fr/personnes/dom… @VeblenInstitute @FViesmobiles";8187;923;15932;21277;46319
micky496;micky49;vache et culture sans concession....mes tweets reflète un point de vue, et pas forcément la réalité...;22275;484;477;23038;46274
PaysagesIroise;Sauvegarde Paysages d'Iroise;Association Sauvegarde Paysages d'Iroise (Finistère Nord) née en réaction aux attaques sur le patrimoine naturel et culturel d'une côte sauvage exceptionnelle.;23213;159;480;22396;46248
RidePowerGirl;Lizzie_Rebelle à 🚴;"Eco-hyper-activiste, vélotaffeuse, scientifique, féministe et anti-spéciste. 
Lobby vélo du 78_
fan de catapiotres 
🚴🏼‍♀️👷🏼‍♀️☢🌱🐛🐦🐏👨‍👩‍👧‍👧🥨";7241;935;523;37474;46173
Les_Yvelines;Les Yvelines;"Compte officiel du Conseil départemental des Yvelines. Suivez l'actualité du Département sur Yvelines-infos.fr 📲
#Yvelines #CD78 #JaimeMon78";13867;679;26691;4918;46155
Lee_H_Ovale;Jack Lee Hervey Rudbyte;"Gladiateur, strip teaser et dependeur d'andouilles.
Ne dédaigne pas d'actionner la machine à baffes.
A conçu un barbecul spécial wokes.";8522;236;271;37063;46092
univbordeaux;Université de Bordeaux;"Twitter officiel de l'université de Bordeaux (#formation - #recherche - #innovation) 
Follow @univbordeaux_EN for updates in english!";10460;1120;27846;6648;46074
PetitEricAndre;Éric Petit;Écocitoyen de la Terre, notre maison commune. Né sous l'âge de l'anthropocène (à 322 ppm de CO2) et conscient de notre responsabilité vis-à-vis du Vivant.;5395;1004;251;39412;46062
RR04_A;🟦𝐕;🇫🇷|🛩️🌊🎏;3670;708;40;41581;45999
DiakubamaThys;DIAKUBAMA THYSVILLE;"AGENT AU SECRÉTARIAT GÉNÉRAL AUX ACTIONS HUMANITAIRE ET SOLIDARITÉ NATIONALE,
CONSULTANT CHEZ SEDEM GROUPE INTERNATIONAL";9350;1554;470;34622;45996
talaaff;LÉGENDE KARIM;"I don't need be loved by you. Keep your faith. 
|@realmadrid|
#Abu_Nuracham|#حسين|";28670;500;3292;13523;45985
Poerava17916088;Poerava;Cool but a down-to-earth person...Animals are my friends and I don't eat my friends...;18101;224;201;27454;45980
Lae_Lune;Lae_army;;7767;363;126;37684;45940
Gregdt1;Greg De Temmerman;PhD, Head of Science @ Quadrature Climate Foundation #energytransition, #climatesolutions. Ultra-trail runner @MINES_ParisTech;21815;808;15229;8075;45927
WawinaChristian;WAWINA CHRISTIAN;ECOMAS,St Joseph Collège Elikya, Dr en MÉDECINE, Méd Hôp RDC,Coord Nat #Coll Méd NU/MNP 2019-020. SCIENTIFIQUE.;8579;721;619;36001;45920
F2porc;Franco 2porc ð¦ð²ð´ââ ï¸â;"CeÂ monde vÃ©tuste et sansÂ joie, faÃ¯lala,Â 
Croulera demain devant notreÂ foi, faÃ¯lala
 et nosÂ marches guerriÃ¨resÂ ferontÂ frÃ©mir la terre......";31688;109;261;13825;45883
AOC1978;Amélie Oudéa-Castéra;Ministre des Sports et des Jeux Olympiques et Paralympiques;4060;637;39115;2018;45830
MFesneau;Marc Fesneau;Ministre de l’Agriculture et de la Souveraineté alimentaire;6590;1186;34708;3329;45813
Nick_Curran_M;Nick Curran;Life is a fucking bitch, but Karma will come. Carpe Diem, Memento mori;11428;1034;210;33138;45810
louismoulin;Louis Moulin;"Chef adjoint service Actu @libe Contributeur @popupurbain Coauteur Paris Démasqué 
#GrandParis #RedStar #urbanisme 
DM ouverts.";31030;1862;4797;8096;45785
chouanenavant;SADOUL;;22018;169;189;23382;45758
pierrepo;Pierre Poulain;"Associate prof at @univ_paris_cite and @IJMonod
#bioinformatics #python #unix
#openscience #opensource @SWHeritage ambassador
#pedagogy    ð¦£ @pierrepo@mamot.fr";24596;1247;1677;18228;45748
footix2202;Thierry Boulat;;10217;290;347;34835;45689
NadiaMezrar;Nadia Mezrar;Engagée #SaintPierrelèsElbeuf #MétropoleRouenNormandie #Département #SeineMaritime dans la vie tout simplement;13723;1645;1462;28844;45674
nar_gg;Nar ðð³ð¥ rÃ©volution stan account;"Ãcofurieuse radicalisÃ©eð¸PÃ©tasse engagÃ©eð¸IngÃ©nieure mentaleð¸Future I.D.S.Pð¸Orque/Rat/Mouette/Sanglier gangð¸
{Ät}nÃ£Â®_gg{Âªt}mÃ¥$t0d0n.mÂ£dÄ¯Â©Ã¥.Ä¯m";7987;784;855;36033;45659
clandestino_usr;Clandestino;Sic transit gloria mundi, et tout ce genre de choses. Émerveillé chronique / dépressif cynique (ou l'inverse). Éponge analytique. Team rasoir d'Ockham.;33259;321;495;11580;45655
molistlalex;Marie đ§ââïž;đȘâđđ„;8068;683;212;36671;45634
NNosp12;NoNosp12;;5328;246;60;39992;45626
ambafr_au_niger;La France au Niger;Bienvenue sur le compte officiel de lâ€™ambassade de #France au #Niger đź‡«đź‡·đź¤ťđź‡łđź‡Ş;9499;238;27962;7915;45614
LaMineDeSel1;LaMineDeSel;"L'empreinte matière ça compte aussi.
@brgm_fr fan account.
Écolo selon certains.
Financeur d'EPR2. Livret N powa !
𒊺";34384;186;658;10382;45610
Forumeteoclimat;Forum Météo Climat #FIMC2023 🌎 #RestonsPrudents;🌎#Climat #Météo #Solutions #TogetherForOurPlanet | Rendez-vous au #FIMC2023🗓️ 6-8 octobre 2023📍Paris 🇫🇷 présidé par @JouzelJean et @Ch_Vannier;17445;2901;4918;20338;45602
kerronnnn;Kerron 🌧️;amoureux de 🎞️, 🎶, 📖, ⚽️… | Succession est la meilleure série de tous les temps | « Agora » disponible en bio 👇;15568;400;534;29056;45558
TwitteeBoy;Louis Grenier;M.Sc. Aircraft Design. Air Force, Bombardier a/c design, Canadian Space Agency (strategic planning) & ISS + Lunar Gateway R&D. Tesla car & stocks. Prof Engineer;16964;4094;1373;23123;45554
boenbot;Toute l'info en France;Les dernières infos et actualités en temps réel;45387;33;114;11;45545
Frederik_LeRoux;Frédéric Le Roux 🐘;Mathématicien. Eco furieux. Membre de la Ligue des Droits de l'Homme. Terroriste intellectuel.;9274;473;524;35271;45542
lesvues52;les vues imprenables et PHP;""" L'indignation est un commencement. Une manière de se lever et de se mettre en route. On s'indigne, on s'insurge, et puis on voit. "" DB
EN AVANT TOUTES!";17277;550;487;27195;45509
aventador63;apreto;Esthète, épicurien, curieux invétéré, français, sang breton et normand avec un caractère affirmé .Mesdames la verticalité de nos échanges me convient !;10031;472;513;34486;45502
94citoyens;Citoyens.com;Quotidien d'information locale et citoyenne : Citoyens.com.;32061;1401;10238;1788;45488
A_Hoffman23;Terrence Sabrelong;"Futur ingénieur en cybersécurité écologiste et pro nucléaire. Ni de droite ni de gauche.

ACAB

piped.video/iTT4krWKymI";29621;543;374;14931;45469
ElsaBembaron;Elsa Bembaron ð²ð;A vÃ©lo dans Paris. Team rugby. Journaliste ENERGIE au Figaro. Â« Ce pot de fleurs est un robot Â» Ã©ditions lâArchipel.;16718;2045;12146;14549;45458
sauvonsleclimat;Sauvons Le Climat;La consommation des énergies fossiles provoque, via les Gaz à ES, un réchauffement climatique redoutable. SLC propose le scénario #négaTep #négaToe @nega_Tep;27271;1192;3238;13715;45416
PascalRAY1;Pascal RAY;Directeur @CentraleLyon @AlumniCentrale @grandlyon @ENISaintEtienne @SteMetropole @bibCentraleLyon #industriedufutur #manufacturedufutur #energie #transport;20110;1236;2185;21884;45415
TBiarneix;"Thomas ""Xero"" Biarneix";Ma capacité de concentration n'a d'égal que... Oh un papillon ! Dev web JS #TechForGood. Sport, photographie, podcast (@PhotosensiblePc), musique & much more.;24636;1366;1558;17851;45411
princess_caru;Princess  Sauvage;""" Ce n'est pas parce qu'il y a des nuages que le soleil a disparu à jamais..."" 🇫🇷❤️";15560;439;533;28870;45402
LefrancoisLou2;Lefrancois Louise ⚜️;« Les blessures de l’âme sont les plus longues à guérir.» Pour une société laïque. Je suis une souverainiste qui veut croire que tout est encore possible!;15577;1240;793;27779;45389
NathPannetier;Nathalie Pannetier;Global đ Sustainability đ± #marketer, #advisor, #teacher | PAR-LON-MEX-MIA-NYC-PAR | Founder np-solutions-ww.com | #marketing #web3 #digital #innovation #SDGs;7152;2980;1329;33895;45356
LeodaganRoi;Le Roi 🇫🇷 🏴‍☠️;"- Roi en CDI
- France lives matter
- Equipé en permanence
- Merde";14953;4786;5110;20422;45271
anouk1818;Ana19587 la Liberté n'a pas de prix🍾;"Un peuple qui oublie son passé se condamne àle revivre W.Churchill 
selon que vous serez puissant ou misérable,les jugements de cour vous rendront blanc ou noir";21229;855;867;22290;45241
Catonlejeune;Caton le jeune;Est-ce utopique de vouloir que son pays devienne moins archaïque, moins médiocre, moins corrompu et plus démocratique? Bref, plus agréable à vivre ensemble.;31106;1546;1044;11517;45213
dsolano52;Daniel Solano;Économie/business Amérique latine-Espagne-Portugal.;35055;5001;1125;4028;45209
Alliancy_lemag;Alliancy Le Mag;Média sur la #TransfoNum des entreprises, engagé en faveur du « Plus forts ensemble »;29276;1289;6811;7774;45150
AnneBringault;Anne Bringault @AnneBringault@piaille.fr;Directrice des Programmes au Réseau Action Climat @RACFrance;15456;1292;10310;18061;45119
bloomingthough2;missy⁷ ʕ·ᴥ·ʔ;"''you will fully bloom, after all the hardships''
- so far away.";17839;161;155;26870;45025
GonesMutamba;Paul_Marie;I'm in favour of racial and gender equality and equity. Let's make Africa great again. HSE Spb. AI + Machine Learning + Society + Politics! Book lover!;11200;380;375;33049;45004
valentdeux;Néolentin;Le bon chasseur, c’est le gars il a un fusil, y voit un truc, y tire.;22677;262;158;21892;44989
Newshamankush;Champagneshami;🇫🇷/🇷🇼 CGP Hunter gourmet & CEO of Capsule Corp;29102;889;739;14211;44941
BillWym32158933;Bob Morlock - producteur;"- Une nympho dans un commando, c'est génial !
- Mais ça fout en l'air mon film.
- Pas du tout, vous n'imaginez pas le mouvement que ça donne à toute l'histoire.";17667;129;257;26872;44925
EcologyOttawa;Ecology Ottawa;We are a volunteer-driven non-profit organization working to make Ottawa the green capital of Canada. info@ecologyottawa.ca;20690;4872;10762;8571;44895
404_E_132_4FE27;Serenity đđ;I am a leaf on the wind. Watch how I soar. Mastodon : @Serenity@mastodon.social;42619;421;743;1084;44867
Prefet14;Préfet du Calvados;"Compte officiel de la préfecture et des services de l'État dans le #Calvados. 
#Normandie
#DDay
#Culture
#Securite
#Education
#Economie
#Tourisme
#agriculture";14451;1272;20432;8705;44860
Kuhn83130;E Patrick Nerval B;;21217;764;561;22303;44845
FischerHugo31;Hugo Fischer ن 🇫🇷;Gaulliste, séguiniste, donc souverainiste.;20373;146;481;23812;44812
acprdc_Officiel;acpcongo.com;L'Agence congolaise de presse est une agence de presse officielle de la République démocratique du Congo;11914;158;25908;6831;44811
Luccio79;Luccio Brunet 🇺🇦;Drômois du Congo #RDC marié à une ardéchoise, expatriés dans le #79 avec 4 drôles. Footeux-runner engagé. Heureux ceux qui savent rire d'eux-mêmes !;16560;1226;1251;25768;44805
BZHNath;Nath 🏆;"17|🇫🇷  Ultra #Kcorp💙 Berserk One Piece ❤ FCL🧡
Debutant en dessin et aigri
Je fais des dessins gratuit venez dm";16806;807;231;26924;44768
ChristinaMalkia;Christina Malkia Mukongoma;Journaliste @AP | @congorassurecd | @HabariRDC | Productrice de contenus | Communication digitale | La #RDC c’est 2 345 410 km2- fièrement du #Kivu;15126;4236;11751;13651;44764
HeightsLola;Heights Lola;Hurluberlue... Mais pas que...;14886;269;440;29162;44757
Bencrypto8;✘BenP⚡🏊‍♂️🚴‍♂️🦖🔋;"Ambassadeur #DinoVox | 
Blockchain enthousiaste |
Investisseur #MultiversX #BTC
xport.al/referral/24tp5i8vue";5618;1042;676;37374;44710
MendiniNassim;Nassim Mendini;"Curiosité intellectuelle/Science/Art/Réflexion/Intuition.

""La réalité est simplement une illusion, quoique très persistante"".
 Albert Einstein";21650;554;417;22083;44704
TurboDemocrate;TurboDemocrate;"Penser la libération contre la dictature kakistocrate de l'absurdistan et la reconstruction de notre belle France

# kakistós en grec : pire";22495;1572;2081;18549;44697
clmentgauthie10;clément gauthier;;1970;507;207;41983;44667
INEE_CNRS;L'écologie au CNRS;"Institut #écologie et #environnement du @CNRS 
Comprendre la biosphère pour #agir
#biodiversité 🦋🌺 #écosystème 🏞️ #préhistoire ⌛️ #océan 🌊";6894;1982;27757;8025;44658
patbonin;Patrick Bonin;Responsable campagne Climat-Énergie / Climate & Energy Campaigner Greenpeace Canada, Montréal. BAA-Sécurité & gestion de crises, MSc.Env. pbonin@greenpeace.org;20787;7551;10496;5816;44650
ethalises;James Ethalises;"Ecologie, science, observe et commente l'influence des lobbies et des astroturfés. Souvent découragé.
""JamesEthalises"" sur masseteaudon.";17610;1300;1159;24579;44648
ZeAximilia;Gloriosae Helvetiae 🏴‍☠️🟡⚫;"Animé en pp : avis rejeté.
Pronoms : told/you/so
Psychophobe et abrutiophobe.
J'aime rire.";11004;593;387;32661;44645
kaumba_officiel;ÉdouardKAUMBA officiel;• Journaliste • MC • Communicateur de masse • Écrivain • Penseur • Conseiller en Communication et en prise de parole publique.;3347;4974;2389;33915;44625
PatrickDupriez;Patrick Dupriez;"“Nous devons apprendre à vivre ensemble comme des frères, sinon nous allons mourir tous ensemble comme des idiots.” 🌍🤝
Martin Luther King";12156;1721;5947;24782;44606
olboaz;CKiLePatron;Justice pour tous, stop discrimination, stop ségrégation.🏳️‍🌈;22889;257;96;21354;44596
DeddyKishimba;Mandað¨ð©;;2949;17383;21494;2752;44578
JourdainMartin;Martin Jourdain;Être contesté, c'est être constaté. Changer la vie.;11002;2316;592;30648;44558
ramuncho41;ici et ailleurs;Ceux qui luttent ne sont pas sûres de gagner, mais ceux qui ne luttent pas ont déjà perdu.;21786;1279;200;21259;44524
TahitinuiTV;TNTV;Tahiti Nui Télévision : Les infos TV locales de Tahiti et ses îles en direct. Créée le 29 juin 2000 elle est aujourd'hui la chaîne de tous les Polynésiens !;39172;506;4625;181;44484
les2AA;Les agriculteurs d'afrique;Nous nous engageons à améliorer le paysage agricole en Afrique et avons l'intention de créer des emplois et d'améliorer les moyens de subsistance ..;23147;4535;11617;5184;44483
chefroi;Chefroi(IZGZAOUN M'hamed);"Inutile et en vie. U.P.R(François Asselineau)""qui a tué la voiture électrique?""""Génocide Alimentaire""de Corinne Gouget. Scoplepavé.BBKACTUS.LeMarketingdeLaFolie";37804;3003;411;3214;44432
alphoenix;Alexandre Léchenet;"Reporter @politicoeurope 📨 alechenet@politico.eu ✨
@arobase_mag (quand j’ai le temps)

🐘alphoenix@mastodon.social";15390;1006;17741;10238;44375
senchemise;Banfora;A Paris et à pieds ….;19466;467;309;24129;44371
hamon_nathalie;Nathalie Hamon;Mandataire du CA @MAIF #Engagement #NumÃ©riqueEthique #SocialMedia #MAIFSocialClub #ChaqueActeCompte #MieuxCommun ð¸Directrice SEGPA #EcoleInclusive #EDD #Sport;15134;3699;3568;21943;44344
MarylouOxy;marylouđ«đ·;LâAnti-gone de la nouille .. jâessaye de prendre le meilleur de nous tous pour une France qui Ă©volue et que nous aimons.. partage sans haine!;23421;2109;847;17908;44285
boris_ravignon;Boris;Ardennais, Maire de @VilledeCMz, Président de @08metropole;12826;3419;9563;18451;44259
BleuBlancCoeur;Bleu-Blanc-Coeur;Des agriculteurs, scientifiques, pros de santé et consommateurs engagés ensemble pour garantir des aliments de qualité, accessibles et respectueux de la nature;18928;3137;8769;13393;44227
tykayn;docteur tykayn;"mastodon.cipherbliss.com/@ty…
Illustrateur, et développeur front end
france: High university of XKCD";34025;1186;206;8797;44214
Ayrias88;Ayrias;;17517;262;213;26184;44176
abbegrojoin;Pr. Abbé Grojoin - Virologue & Journaliste;#teamrepublique  Liberté Egalité Fraternité Laïcité #ToujoursCharlie #AntiBigots #AntiRougesBruns;26452;314;273;17020;44059
Firenault;Marie-Cécile Renault;Rédactrice en chef adjointe au service Économie @Le_Figaro - #Santé #Retraites #ProtectionSociale;28849;2333;7378;5467;44027
obitolevrai;ππ­;El Hamdoulillah βπΌ;18814;103;108;24979;44004
KaraHibe;KaraHibeð£;Î£=mc2 ð«;29624;1592;108;12619;43943
Abakensis;H Jensen;One machine can do the work of fifty ordinary men.  No machine can do the work of one extraordinary man. – Elbert Hubbard;17051;1440;2945;22475;43911
MHAmiable;Marie-Hélène Amiable;Maire de Bagneux;17247;2351;2923;21370;43891
deuxJ_;Double JðŸ‡¨ðŸ‡®;Tabata fan account @ManCity;26374;394;380;16723;43871
Medi1tvAfrique;Medi1TV Afrique;;30718;12;13124;0;43854
alternatiba75;Alternatiba Paris;"✊ Mouvement citoyen engagé pour la justice climatique et sociale -
🔥 Désobéissance civile non-violente, mobilisations, formations et alternatives depuis 2015 !";11949;2443;20076;9372;43840
MxLoowra;Laura;đŠ;25295;266;252;18018;43831
Fredhoc;Frédéric Hocquard;Maire adjoint de la ville de Paris en charge du #tourisme et #nuit Conseiller délégué à la diversité culturelle du 20eme. Président de @laFNCC #ecologiste;17996;4406;7208;14211;43821
FuriousKoen;Diogène 🇾🇪 🇵🇸;Mais je n'ai pas de tonneau.;22851;277;243;20404;43775
Xedoh;Xedo;1 parmi 750 millions d'européens;29504;741;229;13235;43709
InfosEducation;Education & Formation;Veille éducation - #Formation Professionnel - #Enseignement - #Méthodologie - #Education #DIF;26018;9145;8522;16;43701
morninglakegene;nessie;Bloqué sur Libération( helveticus )bloqué sur Le Figaro( machinchose )banni de Twitter X fois ex..Arnold&Willy ..ex..Lakegeneva..ex..Arthur ..et libéré par Egon;15079;639;505;27432;43655
hadjalahbib;Hadja Lahbib;Belgian Minister of Foreign Affairs, European Affairs, Foreign Trade and the Federal Cultural Institutions ð§ðªðªðº;3016;1392;38502;720;43630
abhishek_game;abhishek;abhishek est la :);38724;4555;311;3;43593
EricPAUGET1;Eric PAUGET;Député LR des #AlpesMaritimes. Membre de @AN_ComLois. Élu à #AntibesJuanLesPins.;8288;975;7103;27220;43586
RassNational53;Jean-Michel CADENAS;Délégué Départemental de la Fédération RN de la Mayenne - Membre du Conseil National;23333;348;9626;10264;43571
nsendula;Franck Kayembe;EAO-Boreal College Teacher-Organizational Development Advisor-Int.Cuso/DRC -Master International Management&B.ed-Uottawa.Fr-Plan&Foreign Affairs min/DRC;35799;872;519;6365;43555
AzAmbassadeFr;Azerbaïdjan en France;Compte officiel de l’Ambassade de la République d'Azerbaïdjan en 🇫🇷 Azərbaycan Respublikasının 🇫🇷dakı  Səfirliyinin rəsmi səhifəsi;12800;3130;5794;21821;43545
AthenaisRoy;Roy Athénaïs;Lecture Spiritualité Religion 🙏 Justice ⚖ Poésie📜 Lieux de culte Châteaux Phénomènes paranormaux 👻 Tarots 🔮  Passionnée par la littérature d'Allan Kardec 👁;6051;432;278;36780;43541
CRSNG_NSERC;CRSNG / NSERC;Conseil de recherches en sciences naturelles et en génie du Canada (CRSNG). For English @NSERC_CRSNG. Avis importants : bit.ly/2bgQow2;17699;715;5858;19237;43509
C_MORANCAIS;Christelle MORANÇAIS;Présidente de la Région @paysdelaloire • Chef d’entreprise • @AvecMorancais;7368;1104;22595;12408;43475
Parisdurables;Together;Journaliste;26219;1033;241;15946;43439
cooperation_ca;Cooperation Canada;We work towards a world that’s fair, safe and sustainable for all. | Nous travaillons à construire un monde plus juste, sécuritaire et durable pour tous-tes.;20257;2436;8259;12461;43413
lagarbiere1;lagarbiere;;6327;200;69;36801;43397
augustedut;gus;Hala Madrid y nada mas;26194;503;567;16124;43388
RBannon1;Ronald Bannon;B2B International Business Development & Market Assessment ● Innovation & Risk Management;42135;465;160;574;43334
DumasMichel15;Dumas Michel;;27090;4839;294;11059;43282
JoseLuisSTAP;José Luis Muñoz Díaz;Historiador•Articles•Ràdio•TV• Llibres•'Florenci Bosch i Tubau. Memòria d'un oblit'•'Gramenet del Besòs sota les bombes'•TeaDifusióCultural•SantAndreudePalomar;30865;3230;2894;6287;43276
AxeC975;Vincent#TBTBF;Bobby Axelrod Jr | Energy x Geopolitics x Financials Markets | Member Of @UltralearningFR | Founder Of @FinanceenFr & @LesParolesFi |;36347;217;5093;1605;43262
PolicyCenterNS;Policy Center for the New South;Moroccan #ThinkTank that functions as an open debate platform, bridging between #policy making & #research. Organizes yearly the Atlantic Dialogues #AD2022;24535;456;15164;3093;43248
Jahmann_;Jahman ð¯ï¸ð¯ï¸ð¯ï¸;;18425;206;272;24280;43183
fred_orain;Frédéric Orain 🌎;"Époux, Père, Enseignant, conseiller municipal délégué à la mémoire à #Blois. Plus gauche-crevette que gauche-caviar

mastodon.social/@fredorain";10401;1434;1718;29584;43137
29FranceHERMAN;đšđ” France HERMAN đšđ”;"ArmĂ©e- Europe - Management 
Cand. lĂ©gisl. 2022
Elue au Conseil National ReconquĂȘte!

#Protegeonsnosenfant
 đšđ”đđâ€đšđ”

đšđ”Avec honneur et dĂ©terminationđšđ”";16909;5016;4575;16635;43135
InfoFlash13;đź‡«đź‡· InfoFlash_13;"Informations officielles et alertes locales concernant le dĂ©partement des Bouches-du-RhĂ´ne.
â„ą PrĂ©vention des risques et information des citoyens.";42901;14;202;0;43117
jfrial;Jean-François Rial;PDG Voyageurs du Monde.President Office du tourisme de Paris et du Reffetorio Paris.Co-Fondateur de la ferme bio Une @fermeduPerche.#Universalisme et #Ecologie;10128;1649;9163;22098;43038
YannickLegendre;Yannick Legendre;Investor Crypto BTC, Uranium Lithium Canabis;9268;577;485;32705;43035
B_Castonguay;B. Castonguay, MBA;PDG fondateur d’une grande société d’ici. Forbes 30 under 30 édition 2018. Contributeur à l’économie, l’emploi et bonnes causes telle la lutte contre le wokisme;14018;272;288;28434;43012
OihanaKinka;Oihana φ ( la jungle en Basque🍃;"La nature et la biodiversité sont essentiels à la vie 🌳

 L'artiste ne crée pas la beauté. il enlève simplement ce qui empêche de la voir 🌺";20476;3122;1729;17663;42990
EuropeAlternat1;Europe Alternative S;"Europe Alternative Sociale 
D'abord Humains !
Le Centre penche à Gauche.";22201;9213;9629;1904;42947
CBreteuil;Arnaud C.;"De la Culture, encore et toujours. 
Du Beau, partout.
Du drôle, si on y arrive.

Ce compte joue perso et ses tweets n'engagent qu'en seconde mi-temps.";13569;1630;4678;23007;42884
businessimmo;Business Immo;Portail référence de l'immobilier professionnel - news, interviews, analyses, études, annuaire...- Business Immo Global, conférences, formations...;23346;690;16846;1963;42845
Catheri86517517;Catherine Bertrand;"« Celui qui connaît l'art de vivre avec soi-même ignore l'ennui. »
“ Chi conosce l'arte di vivere con se stesso ignora la noia. »";4848;633;378;36891;42750
ChristineAllon2;Christine Allongue;;20985;284;214;21261;42744
ArchimagRedac;Rédaction Archimag;Compte du magazine Archimag - #transfonum #techno #veille #archives #bibliotheque #bibnum #documentation #IE #opendata #socialmedia #numerique #digitalworkplace;31795;134;9996;770;42695
FroOoggy;Pierre Daniel;French living in Barcelona. ðªðºðªðº Engineer & PhD student in the computational mechanics of composite materials.;233;217;18;42212;42680
Gometmedia;Gomet';L'actualité à Marseille, Aix-en-Provence, Aubagne, Martigues, Istres et Salon-de-Provence 📍Gomet’, le média métropolitain qui crée des liens.;18247;3331;14005;7048;42631
tswysen;Thierry Swysen;Des nouvelles du #Chili en français, revues par un belge francophone résidant à Santiago depuis 1989. Guide et organisateur de voyages. Ex-alumno de la #USACH.;34784;2189;3245;2366;42584
PatriceHouzeau;Houzeau Patrice;;25874;753;186;15755;42568
IGNFrance;IGN France;L'#IGN accompagne les #PolitiquesPubliques en produisant des #GéoDonnées, des référentiels et outils numériques répondant à tous les besoins et usages #OpenData;9998;957;16618;14994;42567
DalsteinGilles;Gil DA;"LIBERTÉS, ÉQUITÉ, FRATERNITÉ et LAÏCITÉ
🇫🇷";32613;5000;532;4416;42561
lemairejeancha2;lemaire jean charles;"la vie et le plaisir d apprendre ....ça demande beaucoup de travail !!!   
Si l herbe est plus verte ailleurs...c est que quelqu un l arrose !";40285;573;815;859;42532
1669770000a;Alex;"Liberté
Égalité
Fraternité,
né en 376ppm";6603;672;66;35179;42520
greenvegana;Ana Karité Ⓥ🥭;Afroveganologist 🌍🦓 | Parisienne du Désert🗼🐫 | Founder of @globisisafrica 🌐🌱 | Ambassadrice de protéines végétales en Afrique | Slow Life ⚪;18527;1583;1768;20607;42485
GLthinktank;GenerationLibre;"Le think-tank qui se bat pour les libertés. Toutes les libertés. 
Fondé par Gaspard Koenig en 2013. 
Présidé par Monique Canto-Sperber depuis 2023.";15171;2146;15554;9576;42447
lxdjd;Altaïr;;1375;72;28;40878;42353
Fabkashtweet;Fabrice kashiya;Christ en nous, un fait divin !đ„°;9300;1013;646;31371;42330
valdoise;Département du Val d'Oise;Suivez l'actualité du Département du Val d'Oise ! Compte officiel du Conseil départemental #valdoise présidé par @mc_cavecchi;24766;793;14700;2013;42272
ArmandRueff;Armand Rueff;Grand juriste, Agrégé, Double Doctorat, tout comme @chtaubira. J'ai enlevé le Ze à mon nickname car trop de pro-nucléaire chez les Ze  🌍♠️⚜️🔱☦️ 🇷🇺;30311;1119;402;10426;42258
Infoflash_69;đź‡«đź‡· InfoFlash_69;"Informations officielles et alertes locales concernant le dĂ©partement du RhĂ´ne. 
â„ą PrĂ©vention des risques et information des citoyens.";42057;6;171;1;42235
Tournelaroue1;STEPH(Tourne la roue)🇫🇷☘️;FRANÇAIS fier de l’être mais fier de mes origines catholiques irlandaise;17182;2815;2810;19391;42198
ToddVousEpie;Todd vous épie 🔳 ☢️;"Germano-réaliste. Beaucoup de shitpost, des trucs sérieux parfois. Vive la Toddosphère. 
(je ne suis pas le vrai Emmanuel Todd )";9600;1655;3327;27611;42193
mauricedelorme3;Maurice Delorme;ð«ð·ð«ð·70 ANS ð«ð·2 bonnes raisons de suivre ce compte 1/ tout sauf #Macron 2/ tout sauf #Macron  ð«ð· ð«ð·#jambonbeurre;33486;3325;3172;2201;42184
CT28911637;MysteriouslyUnnamed;"Mysteriously Unnamed 
LiberteTonNom

Under fascist assault";24548;382;346;16904;42180
liloppia;Bételgeuse🌟;Si l'amour rend aveugle sur les défauts de celui que tu aimes, la haine rend aveugle sur les qualités de celui que tu détestes.;27338;1470;152;13149;42109
kpapato229;kpapato 229;;24896;3261;325;13585;42067
nikomars131;nikoðð¤ ð©ð¿âð¤âð¨ð¼;stay the course;13039;494;313;28217;42063
restitutorII;Restitutor Orientis II ðŸ‡¯ðŸ‡µ;Moyen-Orient;10131;942;30644;304;42021
Etoque__;Etoque;#btc;10496;738;418;30321;41973
AnonDeFrance;Anonymous France;"La liberté d'expression s'arrête là où commence la vérité qui dérange.

Soutien aux #AntiMasques #Anonymous #AnonymousFrance #AnonDeFrance";38993;11;2906;34;41944
zeb2twit;zeb;"Brazil Lektor. #jdcjdr. ""Nous vivons comme nous rêvons, seuls"".";26819;521;134;14470;41944
J_M_Jacques;Jean-Michel JACQUES;đ«đ·đȘđș DĂ©putĂ© du #Morbihan #Hennebont #Guidel #Gourin #Plouay;2920;1670;5840;31492;41922
yanis_khalifa;Yanis KHALIFA - #Elbeuf;"Conseiller municipal minoritaire #Elbeuf
Membre du BN & Animateur Régional @j_Democrates #Normandie #MoDem
ex-Député suppléant de la 4è circo de Seine-Maritime";18626;5000;2405;15886;41917
citeofrance;Citeo;"Citeo est une entreprise à mission créée pour réduire l’impact environnemental des emballages ménagers et papiers graphiques.
#réduction #réemploi #recyclage";14325;979;14880;11705;41889
pierre_lt;Pierre Le Texier;đź‡«đź‡·đź‡Şđź‡ş Dircom @ensemble_ue.;24825;771;12683;3590;41869
VoilaLamort;Voilà Lamort 🇨🇭🇨🇭🇫🇷;collapso-survivaliste libertarien, virologue amateur le samedi, gopolitologue amateur le dimanche, complotiste professionnel;22505;1601;1191;16569;41866
FRauCameroun;France au Cameroun đ«đ·đȘđș;"Compte officiel de lâAmbassade de #France au #Cameroun 
Official account of the French Embassy in Cameroon
@francediplo";4246;288;34592;2723;41849
SchmerChris;Chris Schmer;;7806;459;1117;32457;41839
ElliotL45;Elliot.;;8696;1339;207;31595;41837
AristoTogo;BLACK MAMBA #;"Actualité Militaires, Économiques mondiales.  Infos exclusives
Décryptage d informations";29180;942;6190;5505;41817
LaLettreA;La Lettre A;De l'info exclusive sur les luttes de pouvoir. 100% indépendant.;15712;931;25050;116;41809
sebforeverbose;SebCbien75;"Amateur(rice)s de justice et de vérité vous êtes les bienvenu(e)s.
Suivez mes liens!";25636;1981;425;13744;41786
Jnb311;Jnb31;zenitude et analyse;25401;386;104;15893;41784
MDIALIBREVRIFI1;LM MÉDIA LIBRE INVESTIGATION;"Journaliste d’investigation - Chercheur PhD criminologie (Suisse)
lm-media-libre.fr
SIRET: 43365772300105 - APE: 5814Z - ID WORKPRESS CARD: W54908";15520;4984;3667;17606;41777
RICHARDpatrick_;RICHARD patrick✏️;"ProfDeTechnologieMartonne patrickrichard.eu 
Président xn--tc-bja.fr  
DôN Afrique raiffet.org
#BigDataÉdu #FibreÉducationEurope 100%Fibre @LavalAgglo";26650;4992;2094;8039;41775
juliensevere;Julien Severe;Julien Severe, Directeur #marketing @hellio #lead #brand #web #digital #crm #seo #cx - Geek Powa - #ioniq5 #Electric;9437;1630;460;30246;41773
snefsuOFB;Sne-FSU Biodiversité;Syndicat National de l'Environnement FSU à l'Office français de la biodiversité. Le Sne est le 1er syndicat de la sphère environnement. Revue de presse.;32558;827;6194;2149;41728
FabulousSchatz;schaetzel fabien;"Papa au foyer.
Intéressé par la permaculture, l'astronomie, l'économie et les questions de démocratie.";14466;644;423;26178;41711
BFMMarseille;BFM Marseille Provence;Info, trafic, météo 📺 Sur la TNT (canal 30) et les box SFR (284/516), Bouygues (362) et Free (331), sur Molotov TV et sur notre application;22311;72;18909;338;41630
Arrik_;Arrik;"Rt souvent du Touhou, du Genshin et parfois du Mecha ( surtout Gundam ) et des manga random
#TeamHiver";18254;778;60;22477;41569
michel_Halpes;Michel Cranga climat et responsabilité;"ingénieur,40ans d'expérience dans l'énergie #nucléaire
nécessité de la #transitionénergétique et de la #sobriété; courtoisie mais refus du politiquement correct";21549;560;1579;17825;41513
temoignages;Temoignages;La Réunion;39555;327;1567;49;41498
LeRL_Metz;Le Républicain Lorrain Metz;L'actu de Metz et son agglomération par la rédaction locale du Républicain Lorrain;26077;1000;14361;56;41494
ch_rouillon;Christophe Rouillon;ð«ð· Maire de @Coulaines PrÃ©sident du groupe @PES_CoRð¹ðªðº Conseiller dÃ©p. de la @sarthe 2e vice-prÃ©s. de Le Mans MÃ©tropole Vice-PrÃ©sident Â« Europe Â» de @l_amf;17359;5388;4897;13780;41424
BruCardot;Bruno ðSalut Salut;#agriculteurð¨âð¾ #aisne #cereales ð¾#dd #MissBetterð±#zinzinð#zaza #dudulð¥ #veaux ð VP #FrAgTw ð«ð·ðAmbassadeur @_MissBetter @Agridemain @PassionCereales;6642;1249;8695;24799;41385
couipop;alex borges🇨🇵🇵🇹🇵🇹🇵🇹🇨🇵;"Supporter du seul Olympique de France.
Peut débattre de tout avec tout le monde, dans le respect et la courtoisie.
Insultes, ça dégage";36160;1057;600;3560;41377
escortert;Macette Escortert;;18776;86;8459;14048;41369
sachabenhamou_;Sacha Benhamou;Brassensiste • Consultant en communication d'influence @lumeninfluence • RP @GLthinktank • SG @L630Drogues • Libéral enragé @PantheresRoses 🐆;21250;1396;2869;15838;41353
IsaVH14;Ispah;Mamie bibliovore, ex agro, ex enseignante, écolo catho contestataire;19505;752;167;20922;41346
mayaloola2;kunzang lhamo;;20241;403;934;19701;41279
FrancoisGeerolf;François Geerolf;Economiste @ofceparis, prof. d'éco Sciences Po, Affilié @cepr_org. Opinions perso. English: @FGeerolf;16048;1993;8959;14279;41279
JulieNavarro;Julie Navarro;:);32571;600;4739;3239;41149
rnaudtfy;Arnaud;M2 Psychologie du développement typique et atypique, diplômé de maîtrise en Sciences de l'Éducation;5935;805;368;33999;41107
defenestroika;Defenestroika;Lives in Paris. Grew up in occupied Poland. Lived in Russia for some time. I block conspiracy seekers, anti-vaxxers, Putin worshippers and other fascist scum.;3036;80;89;37884;41089
geopolitis;D Mionnet;"French, humanist, pro-Ukrainan, spew putin and autocrats.
Botanics, History, geography, climate
3 childrens, 2 grandchildrens
RTs and likes are not endorsements";17311;2594;1844;19335;41084
JeunesAgri;Jeunes Agriculteurs;Jeunes Agriculteurs est un #syndicat agricole dont les responsables sont des #agriculteurs âgés de moins de 38 ans.;10501;734;27048;2796;41079
Standscientist;Standupscientist;"Médiatrice scientifique. Ateliers, exposés, démonstrations et spectacles sur la science.
Pour moi, mieux vaut du provisoire qui dure que de l'éternel jetable.";15691;677;262;24425;41055
obitoooo_tnf;🇸🇳;;2710;421;78;37822;41031
SlakowMelaine;Melaine Slakow;Petit bourgeois, lanceur d'amour et contre toutes formes d'oppressions systémiques. Je suis donc pro-fém, antirasciste, écolo. Pour l'expression partagée;13775;139;71;26991;40976
Seb93921614;Sébio;dissident à la macronie,mon caractère l'emporte sur vos injonctions! Libre penseur, non vacciné, non confiné.;23074;404;223;17268;40969
stephanejobert;Stephane Jobertđ€;Journaliste Animateur MĂ©dia & Event, Conseil en communication Ă©vĂ©nementielle & MĂ©dia coaching.;16943;2372;7712;13909;40936
unicefmali;UNICEF Mali;Our vision is of a Mali where every child benefits from every right.;5098;739;31864;3211;40912
Ragond1fr;Saintpixel;'May the guy who invented Spellcheck burn in Hello' (c/c from somewhere);23113;996;420;16363;40892
sunny_giz;tinağ¸;27 Â· she/her Â· suffering from frenchness Â· kaveh kinnie Â· putting the L(oser) in LGBT | âwhen in doubt, throw a book at your enemyâ â David Kostyk, maybe;28196;94;29;12567;40886
MohamadParis20;Mohamad L Gassama🇲🇫🇪🇺;"Delegué de #Renaissance pour la 15e circonscription #Paris #Paris20
élu à la mairie du 20 (2008 - 2020)
BF RE Paris en charge de la Politique de la ville";8561;3878;4012;24406;40857
vertes_phamille;PhamilleVerte đđżđđȘđș;Rester toujours fidĂšle Ă  mes valeurs que Ă§a tangue ou pas : Humaniste, Ă©cologiste, social. Mes tweets nâengagent que moi.;14304;318;246;25980;40848
Triakt_TPE;Triakt_Créateur&TPE;"Cabinet de conseil en création et développement d'entreprise...

Likez notre page Facebook :
facebook.com/triakt";39350;1072;407;5;40834
Dervellois_r;Famille DERVELLOIS;;23329;1681;467;15343;40820
HenriKenhmann;East Pendulum;Observateur au sens strict du terme, Défense & Sécurité, #China;16920;147;20697;3050;40814
l_bottero;Laurence Bottero;Rédactrice en chef @LaTribune Méditerranée-Afrique - Tous les mardis Azur Business sur @BFMCotedazur et Marseille Business sur @BFMMarseille;12873;4331;6692;16861;40757
Joanne_Marcotte;Joanne_Marcotte;Auteur Pour en finir avec le Gouvernemaman. Réal. L'Illusion tranquille. Co-auteur du Rapport sur le financement du système de santé (Commission Castonguay);21862;440;17599;796;40697
ValerieFaudon;Valerie Faudon;DG @sfenorg, VP @euronuclear et enseignante @PSIASciencesPo Compte personnel (views are my own). Ingénieure @Polytechnique @EcoleDesPonts @Stanford;10022;2667;11952;16045;40686
1957yorgos2703;1957yorgos2703;Souverainiste. Animaliste. Humaniste. Ecolo. Γεώργιος . ג'ורג' . جورج، جرجس  .  Джордж . 🇷🇺 . NO MP;13444;259;279;26686;40668
VDNSaintOmer;VDNSaintOmer;L'actu de l'Audomarois sur Twitter !;36645;286;3275;459;40665
JohnDjouda;El Johnny;l'amour est l'expression des émotions et les émotions ne règles pas les factures.;3606;4869;3088;29070;40633
83_sandrine;pays de merde;pseudo en référence à jospin dans les guignols de l'info. Pas là peine de me dire de quitter ce pays du coup les rageux.;7503;74;125;32923;40625
FranceONUGeneve;France ONU Genève 🇫🇷🇺🇳;"Mission permanente de la France auprès de l'ONU à Genève /
Mission of France to the UN in Geneva 🇫🇷🇪🇺🇺🇳";19556;1380;16095;3586;40617
chopin14000;chopin14000;pas d’extrêmes, pas de religion, pas de race, pas de politique juste de la République !;22268;147;197;17903;40515
NotreAffaire;Notre Affaire à Tous;#NAAT est une association qui défend la #JusticeClimatique Notre objectif : nous unir pour défendre l’intérêt général face à ceux qui détruisent notre planète.;8879;1148;20418;10069;40514
ShoniFab666;Zekehamo;Ne jamais rentrer dans le jeu de l'ennemi;36874;204;242;3193;40513
MichaelKael8;Marvel Tof;"đđŠđâ·ïžđŽđ”đ¶đ©ïžđČđ«â­â­đ
 #TeamOL";3588;109;32;36756;40485
TIAC_AITC;The Tourism Industry Association of Canada;Tweets from the TIAC Team. Canada's national organization representing the full cross-section of Canada's $105 billion tourism industry. #TourismCounts;18939;1006;5693;14844;40482
Kat18261736;Kat;Vive la libertĂ©, pour une đ«đ· unie, avec des projets, avec une bureaucratie au service des contribuables( y a du boulot) . aimeđ.;22639;1021;739;16062;40461
Nehesstahturfu;🪼💢;Lelouch comme vendetta | 3 Doctorat en flow;27559;215;63;12585;40422
david73490;David V;Crieur de Pub à mi-temps, fils de boulanger.;2706;1718;83;35889;40396
kraschtm;kraschtm ððï¸;vfx artist, superviser and designer soutiens de #jlm2022 #NUPES;8924;4683;3361;23428;40396
Kalvingrad71;Audrey S.;Une sale co**e pro-Russe et anti-foutage de gueule. On vous aura prévenus !;11512;394;308;28155;40369
ebalemozindo;ebaleya mozindo officiel đ;Journaliste, Cyber Activiste ,Expert en communication digitale & lanceur dâalerte en E-communication.;16750;5224;7449;10902;40325
3dMachaon;Machaon 3d;Passionné par les drones, les questions de défense, d'énergie d'environnement et de société (oui tout ça);26271;322;391;13334;40318
AkaarashiKami;akaarashi;;3013;88;65;37091;40257
PSLHDD1;PSLHDD;Ingénieur électricien. Je n'offre plus ma voix à des clowns.;20269;4228;944;14801;40242
harmonie_okg;Yoba;You will be left speechless 🤌🏿;33079;285;325;6516;40205
Stan0DC;SDC;✌️🇨🇦🇫🇷 PSG/KC;6216;562;69;33339;40186
laliberte;La Liberté;La Liberté est un quotidien édité à Fribourg depuis 1871. Il reste l’un des derniers quotidiens indépendants des grands groupes de presse.;23695;270;15945;267;40177
NeguchiMaroyama;Neguchi Maroyama;"Otakugeekono-life à grave tendance hikokomori et accessoirement Youtubeur #FrenchCityDesigners
piped.video/NeguchiMaroyama
twitch.tv/neguchimaro";29865;343;1341;8628;40177
EDSC_GC;Emploi et Développement social Canada;"Information à propos des programmes & services importants qui aident les Canadiens dans les transitions de leur vie. Conditions: ow.ly/WNKZ3090pg3;
EN: @ESDC_GC";9279;707;29945;226;40157
LaNouvelleNet;La Nouvelle Union;Pour tout savoir sur l'actualité de Victoriaville et sa région. lanouvelle.net, La Nouvelle Union et L'Avenir de l'Érable;36208;630;3247;31;40116
gueguenmicrobio;Erwan.G. @gueguenmicrobio@mastodon.social;Universitaire adorateur des microbes gentils ou méchants. Amateur de discussion autour de la transition écologique et énergétique. 💉💉💉. Diplômé coupeur de 🔥;20136;1209;1981;16787;40113
1icecream_;­čŹŽSTRAY KIDS;the sun is shining inside my head;17993;317;277;21497;40084
le_mmonnier;Matthieu Monnier;Making the planet great again đđ±đŹđ Ănergie verte, Environnement, mer et res publica. AttachĂ© Ă  Eole. Mes propos nâengagent que moi (personal account);6892;1085;1304;30802;40083
LabonteRegis;Jean Regis Labonte;;18108;682;300;20985;40075
MoroccoIntel;Morocco Intelligence;Média numérique indépendant couvrant l'actualité et les informations exclusives nécessaires à la compréhension des enjeux en Afrique du Nord.;4692;36;35306;25;40059
AlainLepine;Alain Lépine;Géographie et sciences atmosphériques à l'université McGill + HEC. Candidat du PVC dans Papineau. Entrepreneur et conseiller en TI pour gagner ma vie.;10993;3002;2624;23403;40022
Doux_Laye13;Abdoulaye Dioufð¸ð³;Muslim| Muurid| Environnement| Mines|Team BarÃ§a,OM. IG: doux_laye13;8155;2886;3620;25339;40000
Jeffbugs;đ«đ· JeffB đ«đ·;#sports. #musique et #cinĂ©ma #velotaf đNON AUX GAZOLIENNES đ;33545;601;95;5743;39984
0Informations;0404Informations;Telegram t.me/informations0404;38884;131;917;50;39982
Plouf40476518;Plouf;"H. Cys hétéro Athé marié autodiag : phototype 3 & neurotypique proprio 🏡 bac +5 D.I. CDI 🇫🇷🇪🇺💉💉💉

Aime : 🔬🔭✈🛰⛵🐱📚⛷🏊‍♂️
et agro les cons avec sa bio";9724;308;151;29780;39963
Ephemerenuit;Ephémère;"Dormir pour toujours, bercés par les vagues
@Ephemere@m*st0d0n.t0p";5121;76;71;34693;39961
NAUD_JF;Jean-François Naud;Mastodon : @NAUD_JF@mindly.social;25134;4055;1173;9561;39923
xbeaudouin;奇伟 @kiwi@mastodon.social / #VotePirate 🏴‍☠️;Passionné de logiciels libres et de réseaux. Tout ce qui est dit ici n'engage que mon opinion personnelle uniquement !!!;29802;1173;707;8240;39922
_l__d_;Louis 🇻🇦🇫🇷;;11579;1042;231;27066;39918
BatmanArrow1;fitzArrow -;Finisseur de phrases professionnel  ð toujours (ou presque) le mot pour rire;19405;362;484;19576;39827
Cameron_Diver;Cameron Diver;Chief of Staff / Directeur de Cabinet @SoniaBackes | @ProvinceSud | Former Deputy Director-General @spc_cps | Dedicated to action for #Climate #Ocean #SustDev;10690;4326;4723;20051;39790
navalgroup;Naval Group;Partner to maritime sovereignty. High-tech company. ⚓️ We design, build, integrate, maintain submarines & surface ships and their systems & equipment. #navgeek;6925;553;30567;1702;39747
MareaMalga;đMalgaMarea;Toute la science du monde ne vaut pas les larmes des enfants. FĂ©dor DostoĂŻevski;18667;1899;624;18540;39730
BD_Group;Business & Decision;"Spécialiste Data & Digital
Business & Decision est une Direction d’Orange Business Services SA

Ici, on parle #Data #Digital #IA #TransfoNum #Cloud #BI #CRM...";24210;3498;7608;4414;39730
AiretCosmos;Air & Cosmos;Air&Cosmos : le seul hebdomadaire aéronautique et spatial en langue française, papier et numérique.;18751;192;20716;49;39708
JaccazJoseph;Joseph.;"Inventeur de la Prolétarte

Le graphique prouve que le steack est équilibré.

Proud Soy Boy";9401;406;1114;28775;39696
alecuyer;Arnaud Lécuyer;VP Agri/Agro/Alim @RegionBretagne Maire de #SaintPôtan, Président @DinanAgglo (22), #Agriculture #Ruralité #Littoral #Dinan #CôtesdArmor #Bretagne @KalonEAG;5738;1927;2601;29407;39673
LaTribuneBdx;La Tribune Bordeaux;Bureau de @LaTribune à Bordeaux pour suivre toute l'actualité économique et les transformations de la métropole bordelaise et de la Nouvelle-Aquitaine;20846;1198;16118;1497;39659
Gringo_Shelby;Gringoshelbyð´ââ ï¸;câest moi wsh @mancity;18440;422;327;20435;39624
Juan1er;Jean Luanco;Si la souffrance a un sens, ce ne peut qu'être l'abolition de la souffrance. 🇨🇵 🇪🇸 🇺🇦 🇪🇺;27337;1904;318;10055;39614
JosephNapolon1;Joseph Napoléon;;6226;119;175;33078;39598
patoudel;😀𝑮𝒊𝒍𝒍 & 𝑱𝒐𝒉𝒏😀FREXIT.NoVax🤬;"😀RetraitéE, insoumisE de naissance, très tolérantE sauf l'injustice sociale, les menteurs & faux-culs😄 
Bataille contre un cancer triple négatif métastatique";34463;496;522;4107;39588
agridigitale1;AGRIDIGITALE;L’information en continu sur l’agriculture et l’agri-Tech en Afrique;13588;5661;8619;11701;39569
uncover_4life;UNCOVER infos™ 😏🎙️;Art19(Decla Droit de l'Hoe): Droit à la liberté d’opinion...,sans être inquiété pour ces opinions, de chercher...et repandre les infos par klk moyens d'express°;29855;129;5528;4054;39566
LeBalou90;Le Balou ð³ï¸;"Eleanor Roosevelt :
Â«Â Les grands esprits discutent des idÃ©es ; les esprits moyens discutent des Ã©vÃ©nements ; les petits esprits discutent des gens.Â Â»";24143;499;9296;5620;39558
tiguij_77;Marne la Vallée Fan Account;Futur Singe Riche | الثقة لا تمنع السيطرة;25172;490;741;13155;39558
phTokJp;🍊Hiroshi Lenorman 🍊;Father of a wonderful 11yo boy. Settled in Japan since Showa. Supporting victims of Parental Abduction and Parental Alienation. 日本の子供にも、共同親権！;9653;1829;1094;26981;39557
HertzienBaracca;Etienne;"Happy energy wholesale market analyst #PhD #economics #finance #commodities
Mastodon : @Hertzienbaracca@piaille.fr";33577;533;1293;4119;39522
Franswa_BZH;F R A N S W A ð«ð·ðªðº â¢;"Etudiant en cinÃ©ma d'animation 3D
Fier d'Ãªtre FranÃ§ais et EuropÃ©en
#TerraWater
voix-du-nucleaire.org/terrawâ¦â¦";6678;265;114;32457;39514
AnneReymond2;Anne Reymond;Bien Commun. Usons de notre Liberté. Droit, Respect et dignité humaine. Stop pédocriminilaté. Droit au libre arbitre;15197;471;611;23232;39511
Caroli_Isautier;Caroline Isautier #TechForGood;Geek, creative, bilingual (French/English). Digital, Marketing, Health & Education, Digital Literacy , Climate @techforgoodcan #TechForGood;14615;1651;781;22434;39481
mireillmartini;Mireille Martini;Tweeting in a personal capacity, RT not endorsement. Born in 320 ppm.;17064;3951;891;17542;39448
LaurenceBoone;Laurence Boone;Secrétaire d’État chargée de l’Europe;4110;1175;30008;4152;39445
Hbrauny;Hbrauny;Vis comme si tu devais mourir demain et pense comme si tu étais eternel...;19895;431;139;18968;39433
Wintrfell;Comics Grinch';"Un.e des boss de fin de @LesComics_fr

Schtroumpf grognon spécialiste en #BriqueExcalibur

Aussi, fan de jeu vidéo et cinéphile casse-bonbons.

Iel";13355;836;980;24234;39405
HenriFo15170709;Henri Fontaine đšđ”đȘđșđ©đȘ;;13696;1662;370;23666;39394
EricSartori3;Eric Sartori;;13195;173;936;25082;39386
fdsea53;FDSEA53;La FDSEA de la Mayenne (53) est le syndicat agricole mayennais qui œuvre pour la défense des agriculteurs et agricultrices actifs et retraités;15110;1095;3006;20174;39385
OsonsCauser;Osons Causer;"Vidéos d'utilité publique sur Osons Causer
Site de formation populaire : Osons Comprendre
Notre livre : l'Avenir de l'énergie";2056;955;30458;5907;39376
Nikki_Sane;ð¯ Nikki Star ð«ð;On vit dans une bulle d'information tellement Ã©tanche qu'il est trÃ¨s rare qu'on nous expose l'autre cÃ´tÃ© de la mÃ©dailleâ¦ PhD en complologie.;25973;513;602;12258;39346
AShields_Devoir;Alexandre Shields;"Journaliste @LeDevoir, spécialisé en environnement.
Collaborateur à l'émission Moteur de recherche, sur les ondes de Radio-Canada. Passionné de musique!";20870;758;15663;2035;39326
rekobba_guy;Guy capdeville;Parisien 100%, PSG, Voyageur, les bonnes tables.;11820;274;260;26943;39297
RiouxRemy;Rémy Rioux;DG de l’@AFD_France, pdt d'@IDFC_Network, host de @financeincommon #MondeEnCommun #ToutAfrique #DuCotéDesAutres #Réconciliations @SportEnCommun;9555;1630;23176;4879;39240
NicoBesombes;Nico Besombes;Ass. Prof. #SportSciences #STAPS @Labo_I3SP & @univ_paris_cite • Head of @DIU_Esports • Board member @AREF_Esport & @EsportsResNet • Former VP @Fra_esports;8481;1485;9260;19925;39151
Cesarmand;César Armand 💉💉💉;"Journaliste
📰 @LaTribune #CollTerr #GrandParis #Ville pôle #TransitionEcolo 
Co-Auteur
📚#DansLOmbreDesPresidents
#Pompidou-#PourLAmourDeLArt";12198;8000;7419;11497;39114
ROUXELBernard1;ROUXEL Bernard;"J'aime mon pays (la Bretagne), et j'ai peur de sa dérive droitière...
Impunité pour les policiers , et les groupes fachos..";12095;901;411;25706;39113
Karl58221723;KđŒ 3,14;"Bien sĂ»r que je suis heureux ici! C est merveilleux!
D autant plus que je n ai pas le choix!";15088;171;82;23719;39060
SebasBerrouard;Sébastien Berrouard ⚾;Copropriétaire & Chroniqueur : @passion_mlb;8697;7149;15005;8191;39042
Hoa_Mdt;Hoa 꽃💐;"“It makes you modest to travel ; you see what a small place you occupy in the world” G. Flaubert | Student in Political Science and Law | #BornPink 🖤🩷";3753;294;703;34250;39000
Samsuffit_Mtl;Sam - Un franco peut-il être un Grand Remplaçant?;TV exec/ LLB/ ∅ tolerance for Nationalism & Identitarian nonsense like Brexit & Quebexit/ Anon. 4 security/ Je conjugue mes anglicismes/ RT & ♥️ = Look!;7126;889;222;30755;38992
meandlester;Alexander;Has an opinion, it may change ... but at least it's his own !;14298;875;424;23385;38982
eco_actu;Actualité économique;L'actualité #économique en continu.;35840;229;2905;6;38980
android80335091;androide;"faut arrêter de se faire des nœuds au cerveau
les choses sont bcp + simples";13413;411;257;24896;38977
verolive83;Olive83;à tous ceux qui ne m'aiment pas sachez que je ne ferai rien pour changer ça !  😉🙏🇨🇵🇪🇦🇮🇹;20772;1285;259;16641;38957
parissi_app;parissi;Concerts, expositions, balades, visites... Retrouvez en un clin d'œil tous les événements Parisiens sur votre application mobile Parissi 🎉;37268;1113;419;151;38951
clo_gk;Lavandière de nuit;Ptn j’ai bientôt mon M1;9837;193;171;28744;38945
dburkli;Delphine Bürkli;Maire du 9e arrondissement de Paris - Conseillère régionale Paris-Île de France @Horizonsleparti Administratrice @IDFmobilites - comité audiovisuel @iledefrance;9863;680;15994;12400;38937
dozadoze1;Khadim🌹;If a person has good idea about you, make his idea be true.;6654;739;204;31320;38917
JaronNathan;Crypton - unhosted -⚡🚀@only21.lens 🌿;Crypto convaincu = complotiste, facho, criminel, fraudeur, terroriste, pollueur, antisémite, blanchisseur, populiste, spéculateur.;17324;373;567;20638;38902
djeffkaza;Mulamba Kazadi Djeffrey ðŸ‡®ðŸ‡¹ðŸ‡©ðŸ‡ªðŸ‡§ðŸ‡ªðŸ‡ªðŸ‡º;"â€¢ Juriste publiciste
â€¢ LittÃ©raire: Latin-Philosophie
â€¢ ChrÃ©tien 
â€¢ DÃ©fenseur des droits de l'homme
â€¢ Homme d'affaires et d'Etat";30945;4526;348;3006;38825
Pangolin12;Évolution;"Je ne suis pas l'aboutissement de l'évolution mais vous non plus.
@pangolin12@mastodon.top";23708;1562;1258;12291;38819
LLegendreParis;Laurent legendre;;9540;1005;972;27298;38815
banjHT;Banj;Haiti’s best Co-Working Space and Google powered Accelerator. Banj is changing PaP’s ecosystem with innovative tools.;10846;6;20169;7788;38809
Pauline06272023;Pauline đ«đ·;Depuis 2014 sur TwitterâŠ compte qui dĂ©range apparemmentâŠ me revoilĂ  !! đ;18201;999;2606;16983;38789
Mitte_Centre;Die Mitte – Le Centre;Freiheit. Solidarität. Verantwortung. Liberté. Solidarité. Responsabilité.;12437;582;19221;6544;38784
canataku;Canataku Duckington;"Duck
Otaku
Pokemon Mono-grass player
FF XIV WHM/DRG
Yu-Gi-Oh Psychic duellist
MS Paint enjoyer

You just lost The Game";11791;175;26;26767;38759
ericzemmoir;Eric Jardin;Si vous croisez Marvel faite attention, il est jamais bienveillant quoi..;16295;2319;238;19906;38758
EricLza;ErLz;"La seule certitude que j'ai, c'est d'être dans le doute
FinalesRugby ? Non c'est à côté !
Un peu de Up And Under et de FLairPLay";21403;297;216;16818;38734
ITrippenbach;Ivanne Trippenbach;"Journaliste au Monde | ex-@lopinion_fr, ""Inch’Allah"" @editionsfayard | @cfjparis & @sciencespo";12952;3536;14081;8139;38708
ClaudeR7;Claude Racette;Anciennement de gauche! pas celle qui est devenue régressive et tarée! Celle qui défendait tous les travailleurs en aspirant à améliorer leurs conditions!;9491;525;330;28354;38700
cmferet;Claire-Marie Feret;Prof de français en REP, militante au SNES-FSU et sportive sous la contrainte;14619;698;1934;21437;38688
SPPEF;Sites & Monuments;Sites & Monuments (SPPEF), association nationale reconnue d'utilité publique agréée pour la protection de l'environnement;17619;346;13797;6879;38641
isabelle_rocca;Isabelle Rocca;Sociologie, intranquillité et militantisme. Maire adjointe #Paris12 Education Parentalité Familles. Secrétaire nationale adj. @partisocialiste Société numérique;21466;1096;2611;13428;38601
EilMev;MEV Eil;"Loup solidaire

Mes opinions n'engagent que moi et n'intéressent personne

Influencé (combien d'influenceurs sur Twitter pour si peu d'influencés ?)";30396;2675;2480;3001;38552
GoldenPinoc;Golden Wings ✨;50% 🎬, 50% ⚖️. Might be a different person on this app, mind yo business. 🇲🇦🇪🇸 =@RayhanGhostface;12978;387;9316;15809;38490
KTPLeGallois;Quicampoix;Ils me détestent car je suis sigma;11304;167;1145;25821;38437
NadegeG64;Nadège - Macron DEGAGE !;;10495;633;447;26860;38435
atorchet;Alexis Torchet Sgen-CFDT;Secrétaire national @SgenCFDT en charge de la politique éducative. Membre du Conseil Supérieur de l'Éducation. #CSE #CFDT #SgenCFDT;14459;1416;2380;20156;38411
HiraethNossa;Faust❤️‍🔥;Coordinateur national et lanceur d'alerte universitaire @CocardeEtud;10500;633;1152;26108;38393
Jonatha60007393;š«š·Jonathan Tiradoš«š·;"Ancien Militaire FranĆ§ais / Commandos Parachutiste de l'armĆ©e de l'Air 

Auteur du livre l'enfer de mes devoirs 

 et Secouriste Ć  la Croix Rouge bĆ©nĆ©volat  !!";15495;2180;2279;18410;38364
Label_Finansol;FAIR - Label Finansol;FAIR aspire à une économie qui replace la personne au centre de son développement et agit en France et à l’international;18515;2220;10765;6838;38338
Eccehom29032550;Ecce homo đź‡¨đź‡µ đź‡şđź‡¦;"Bienvenu sur ce compte Progressiste et anti-extreme.
 Je crĂ©e rĂ©guliĂ¨rement des vidĂ©os, chacun est libre de les utiliser.
 - Follow back";20884;1320;1243;14885;38332
UQO;UQO;UQO: Université du Québec en Outaouais ayant deux campus à Gatineau et Saint-Jérôme.;18796;7066;12141;315;38318
kaduma;D.;Concepteur/designer/consultant en Ux et UI. Amateurs de vieux jeux sur CRT. En roue arrière à contresens sur l'autoroute de la nouvelle normalité;27557;678;1380;8695;38310
MatthieuBlandin;Matthieu Blandin;CSO offshore wind #Valemo // CSO @akrocean |Énergies -marines- renouvelables & éolien offshore |Économies verte & bleue, développement durable.;11295;373;956;25685;38309
tuivre;Tuivre;gné;2081;286;37;35904;38308
AlainGoudey;Alain GOUDEY;Imaginer l'Ecole du futur @neomabs et créer l'identité sonore des marques @atoomedia_corp | Tweets sur éducation, technologies disruptives, IA  & design sonore.;18575;2432;5061;12230;38298
giOrdanoB6946;giOrdanO B;"""Il est plus facile de tromper les gens que de leur faire admettre qu'ils ont été trompés""  M. T.
""La meilleure façon de prédire l'avenir , est de le créer"" D.P";22398;340;289;15266;38293
MediabaskInfo;Mediabask info;Compte officiel de Mediabask, quotidien d’information du Pays Basque. Mediabask Euskal Herriko informazioa ematen duen hedabidearen kontu ofiziala.;27746;911;9593;36;38286
La_FAGE;FAGE;"1re orga Ă©tudiante de France đą
Membre @leCESE @ESUtwt @CNAJEP @PouvoirDeVivre đ€
2000 #assos, crĂ©Ă©e et dirigĂ©e par les jeunes depuis 1989 đŁ
#EducPop #Jeunesse";13024;1071;17626;6565;38286
transportsidf;Le Parisien | transports;Métro, RER, bus, voiture, taxis, VTC, vélo, trottinette... L'actualité de tous les transports en Île-de-France avec @le_Parisien;11963;152;26117;49;38281
LexM4tic;LexM4tic;Crypto Trader | Horizontals only | NFA;9518;261;879;27619;38277
elitwitt2;Elwin;;9852;1828;388;26196;38264
Prefet07;Préfet de l'Ardèche 🇫🇷 🇪🇺;Compte officiel des services de l'État en Ardèche - Retrouvez nous également sur Facebook et Instagram (@Prefet07);19507;737;10122;7855;38221
Bernie1495;Bernard Vandenberg;"Un orage emporté par les vents de l histoire. 
Je n en suis plus si sur. 
Robert Badinter";28952;841;410;8009;38212
MadagascarInfos;MadagascarInfos;Toutes les #informations sur #MADAGASCAR - #MADAGASIKARA en un seul endroit đź‡˛đź‡¬ #FollowUs;30876;80;6798;448;38202
AfricanUnionUN;African Union Mission to the UN;"Permanent Observer Mission of the @_AfricanUnion to the @UN. 
For more info follow: Ambassador @FKMohammed1 FB:facebook.com/AfricanUnionUN";9553;460;18862;9314;38189
JacquesCreyssel;Jacques Creyssel;DG de la @FCDfrance. Co-Pdt Comm Éco du @MEDEF. Pdt Com Éco @leCESE. Pdt Fédération world du retail (#FIRA). VP @EuroCommerce. Passion technologies/prospective;19097;4348;6252;8491;38188
Gabrielc6472827;Gaby;A la fin, tout ira bien. Si ça ne va pas, c'est que ce n'est pas la fin.;29035;114;155;8862;38166
LimamDICKO;DICKO Limam đČđ±;Ăblouissante la vie est đ;14240;2473;1553;19864;38130
VandyKhen;Van 🇨🇩;Consultant en Administration.;6286;1490;1982;28338;38096
enerzine;Enerzine;Site d'information sur toutes les énergies depuis 2006. Thématiques : Techno, Mobilité, Enviro, Habitat, Guides. Inscription newsletter : bit.ly/42jXdW5;24502;1161;10525;1837;38025
florencefloft;Florence Thomas;▫️Coordinatrice réseau #innovation #SécuSoc ▫️Conseillère quartier #Levallois▫️#Runneuse 42Kx3 #SportSanté;5329;1890;632;30114;37965
f7kmg;f7kmg;Geek, Analítico, Altruista, Tolerante, No soy del común denominador. Vive Colombia...trabaja por ella 🇨🇴;27695;298;477;9477;37947
ParisLaDefArena;Paris La Défense Arena;"🌍 Plus grande salle indoor d’Europe
🤩 Créateur de souvenirs 
🎵 Des concerts exceptionnels 
🏉 Domicile du Racing 92
💡 Novateur et engagé";8233;480;26402;2829;37944
Mno50194084;MNo tweet;"La macronie incarne tout ce qui m'appelle à la résistance
🇨🇵
Twitter: fournisseur de pilules rouges..pour ceux qui ont le courage.";16084;188;340;21303;37915
7_7Z7;7Z7 / Raphaël Carbillet;"Admin @XGGlobal_

XG🐺 (Cocona💚), æspa🐍 (Karina💙), Blackpink🖤💗 (Lisa💛), Everglow💫 (Mia❤) 

7Z7 / Seven / Z7Z";7784;650;580;28900;37914
FranoisCormero1;François Cormerois;Observateur et acteur de la vie... depuis 1957. Bourguignon et icaunais.;8735;782;463;27925;37905
Keuv_;Kevin Cstl;Suffering with Frenchness - Digital - Innovation - Travel - Team Chocolatine - PSG;12612;1519;530;23195;37856
GCHAlliance;Global Climate and Health Alliance;Global coalition of #health organisations tackling #climatechange to protect and promote public health.;15548;4539;10217;7534;37838
BreizhItaliano;italiano breizh;;18584;570;130;18535;37819
hherault3;Hélène Hérault;World citizen. English teacher. Tennis fan.;7587;295;94;29822;37798
enisseo;Enisséo;Auteur, musicien et revendeur en herbe. Instapoet, instant regret. Lanceur d'Arlette. Chief Happiness Officer for France (the country, not the meal).;31783;318;323;5321;37745
MEDEF_Sud;Mouvement des Entreprises de France Sud;Le @MEDEF_Sud est le 1er réseau professionnel de la région Sud, fédérant 6 @medef départementaux & les principales fédé. prof. | Pdt : @JL_Maurizi;13736;5004;4552;14404;37696
Ajattara34;Techno-solutionniste Cheems;đ«đ· đȘđș;5081;676;86;31803;37646
LF74967226;Lu'Lagerfeld-invétéré dilapidateur d'argent public;"Proto-économiste de sensibilité keynésienne.
Dire 《Planche à billets》=💀";5546;234;142;31720;37642
JJTL;Jean-Jacques TAMBWE L.;L2 Sciences Bancaires. Master Européen en Manag. et Stratégies Fin. Intern. CDA/Finances et Comptabilité CNE. Doctorat/Éco en téléchargement.;26797;1429;786;8626;37638
SkandalNews;SkandalNews;Skandalnews est un agence de presse en ligne au service d'un public mondial. «Ce qui passe loin, nous touche de près.» En temps réel 🌐;24005;87;6090;7450;37632
frabong83;frabong83;;26801;460;10;10332;37603
lachaineaudio;đ lachaineaudio;đ Plus qu'une radio, une station audio - Construisons la nouvelle expĂ©rience d'Ă©coute audio de demain !;20637;1379;1244;14322;37582
robtiller06;Caroline C;"paris🇫🇷 rock🤘 ""Je n'ai jamais cru que la liberté de l'homme consistait à faire ce qu'il veut, mais bien à ne jamais faire ce qu'il ne veut pas.""";8103;381;314;28782;37580
fipaddict;fipaddict;Enseignant en économie et finances publiques. Écrit de temps à autre chez Substack, @AlterEco_ et @_Terra_Nova;6245;840;19309;11118;37512
lecolededesign;L'École de design Nantes Atlantique;Compte officiel de L'École de design Nantes Atlantique | #Design for #Creative #Innovation | #Nantes #Shanghai #Pune #Saopaulo #Montreal #Cotonou;17154;1011;10505;8815;37485
Endymio82773232;Endymion;;14128;148;94;23096;37466
PPouyanne;Patrick Pouyanné;Chairman & CEO of @TotalEnergies, a broad energy company that produces and markets #energies on a global scale.;562;371;36339;151;37423
jdicajdisrien;j'dis ça j'dis rien;"Indigéno-wokistes, antifascistes, LGBTQIA+ et avides d'Ecologie Radicale.
Compte perso.";7731;3411;21937;4332;37411
hmleo_Paris_NYC;Réfléchir ⭐️⭐️;Chronique #DesBlancs riches conduiront l'humanité à l'agonie pour : l'#Argent, le #Pouvoir et l'#AbusDePouvoir sur les plus faibles #FaitsDivers & #Historiques;32609;623;208;3962;37402
thierryseray;Thierry Seray;Co-créateur et associé de l’agence Codezero. Voit dans le sport beaucoup plus que le résultat. Ne cherche pas à influencer mais espère inspirer...;13680;2432;1220;20042;37374
MariePierreV;Marie-Pierre Vedrenne;ð«ð·ðªðºDÃ©putÃ©e europÃ©enne â¢ CoPrÃ©sidente @Ensemble_UE â¢ Vice-prÃ©sidente de la commission Commerce international @EP_Trade â¢ deux pieds en Bretagne ðð;5318;894;9437;21708;37357
SMHO07;Justicier Masqué 🎭;Ingénieur en Informatique (Programmation), je suis autodidacte chevronné 👍;7201;1191;1612;27270;37274
Kokoroe_EdTech;Kokoroe;Kokoroe est la plateforme de formation en ligne qui permet à chacun de développer les compétences de demain #FutureOfWork #Edtech #TransfoNum #Startup #HR #RH;10167;2794;4756;19494;37211
MatthieuNappe3;Matthieu Nappée;;25279;290;118;11519;37206
BGothiere;Brigitte Gothière;co-fondatrice de L214 #Antispéciste #vegan #Utopiste à plein temps;10874;1250;10376;14704;37204
LaLibreEco;La Libre Eco;La nouvelle section de @lalibrebe dédiée à l'économie et la finance;36041;41;941;170;37193
yves_ore;O.B.Y.A ð¨ð®ðºð²;Ið§¡100% JESUS ð;7319;385;266;29205;37175
curcuma66;Michelle DURAND;Scientifique avec conscience à l’état d’esprit critique.....Sceptique sur la vaccination de masse pour la COVID. Suivre un compte, n’est pas le soutenir !;16480;884;354;19439;37157
NoovoInfo;Noovo Info;"L'information sous tous ses angles, c'est nous.
#NoovoInfo";30002;607;6110;387;37106
Arlich12;Arlich;Crypto, Rugby, tech, Montmartrois, Communard, hérétique, En Sédition, J’emmerde les bien pensants;19347;1106;194;16445;37092
BrunoCoupas;Bruno Coupas;Gaulliste, Démocrate & Républicain. Pour une Nation qui défend ses valeurs et son destin. Membre pionnier Reconquête;15669;1004;2020;18386;37079
opendiplo;Institut Open Diplomacy;Think Tank • L'Institut Open Diplomacy étudie les conditions d'une paix durable pour les générations futures • #Agenda2030 •••;21095;2177;9302;4475;37049
ChArrighi;Christine Arrighi;Députée EELV #NUPES. 🗺 9e circonscription de la Haute-Garonne.💰Commission finances à l’Assemblée Nationale. Toulouse /Paris en 🚄;15328;700;3311;17684;37023
FranceLumieres;France Lumières (tamisées tout de même !);Mes tweets engagent l'humanité.;33510;496;527;2472;37005
_Oxwin_;Oxwin;ultra @KarmineCorp @G2esports;9732;1923;317;25033;37005
yann_viguie;VIGUIE;passionné de transport et de mobilité, 30 ans dans le transport dont 14 ans dans le déménagement.;21121;1085;833;13930;36969
RrimmyD;Doutenkarton;Quand y'a un doute, y'a pas de doute...;16322;300;51;20289;36962
finstreet;Sébastien Dufil;Amusant ces gens qui bloquent...;32604;184;222;3951;36961
RemiGarnier_;RéⓂ️i Garnier;Gaulois réfractaire 🇫🇷 • Conseiller régional #RN #AuvergneRhôneAlpes • Conseiller municipal de #SaintBaldoph (Savoie - 73) • ⛷️;5241;77;791;30817;36926
Bipalamarge;Bip à la marge;;6220;151;49;30486;36906
francois_cp;François;Tech lawyer. Scared of the controlling crowds.;23144;281;2557;10922;36904
nissart06300;Pierre P;"Marié 2 enfants , une fille et un garçon.

Faire ce que tu aimes c'est la liberté...

Aimer ce que tu fais c'est le bonheur...

Anniversaire le 2 mai.

Pro Z";19321;2029;1142;14398;36890
dansla_legende;Dans la Légende;He/Him #Geek Je tweet à propos des #Voyages, de #Cuisine, de #Tech et #MobiliteVerte.;24269;4895;221;7488;36873
CocoJack22;PomGranny Coco;Coffee lover, french citizen abroad (UK for few years but Brexit happened). Francesa en España...DEA Philosophy/MBA;16517;448;185;19682;36832
UnivAngers;Université d'Angers;L'UA est l'une des premières en France pour son taux de réussite en licence en 3 ans. #UArecherche #UAformation #UAsport #UAculture #UAinternational #UApro;13638;562;16150;6481;36831
eepolitik;ee politik;Politique, Economie, Ecologie, cout de la vie, dereglement climatique ..., né lorsque concentration atmospherique en CO2 etait de 338.75ppm.;29173;1976;455;5226;36830
VilainCat;Ministère des Bras Croisés 👻 ᵖᵃʳᵒᵈᶦᵉ;En l'absence de réelle politique écologique, nous prenons les commandes 👻 compte parodique 👻 #Ecologie #Energie #EnvironnementDIY #AutodefenseEcologique;5717;1529;25651;3922;36819
agit_prod;Le monteur décolonial (agit_prod) 🎥 🇳🇨🇵🇸;"Agitation et production.

Écriture, tournage, montage, miniature.";16850;943;4357;14665;36815
Taraquatique;Tata gatta;ESCP + informatique. Voie du milieu, ni éternaliste, ni anihilationiste ou matérialiste, avec #éthique #lucidité #compassion, malgré maladie étrange EM/SFC;18595;2831;364;15010;36800
michel_bedouin;le bédouin;Est né et a grandi dans une ferme , passé par la médecine , revenu dans son jardin;17344;337;232;18868;36781
ElliotLepers;Elliot Lepers;J’écris des trucs.  Designer, activiste.;8322;2514;19572;6367;36775
nathalieappere;Nathalie Appéré;Maire de #Rennes. Présidente de @metropolerennes.;7954;1882;23853;3083;36772
ouest_grand;Grand Ouest;"SCIENCE SANS CONSCIENCE N’EST QUE RUINE DE L’ÂME
                                 Rabelais";9015;589;289;26874;36767
Votsh64;Votsh;J'aime chercher, beaucoup de choses.;36481;147;75;28;36731
GrardBUNEL;BUNEL Gérard;"Viscéralement de droite, pour le progrès raisonné, l'ordre.
@Nouv_Energie 
Abhorre les extrêmes, les girouettes, les indécis.
L'homme et la mer (Baudelaire)";18554;644;322;17194;36714
JoeMusashi2077;đ«đ· 1MP3R4T0R.Z3D đŒ;âDieu se rit des hommes qui dĂ©plorent les effets dont ils chĂ©rissent les causesâ Jacques-BĂ©nigne Bossuet;11336;3811;3039;18520;36706
vguillermard;VéroniqueGuillermard;Journalist. @Le_Figaro Economie : #aerospace & #defense #rail Deputy editor;23565;4229;7920;973;36687
vdcommunication;do carmo virginie vdcommunication.fr;#consultante #biographe #madein95 #communication #atypique #formations #digital #web #siteinternet #wordpress #genealogie pour #salariés #entreprises #pme #pmi;32013;328;1196;3125;36662
S_Revages;Rêvages;Rêves et rivages : des bribes de monde;8458;322;92;27789;36661
Ludovic_VG;Ludovic ð;I love ðºð»ð¹ð°ð, notðð¥©ðð¥;19568;419;213;16452;36652
Julie91700659;Julie 🇫🇷 de retour 🇿🫒;#Zemmour #Marion #RECONQUÊTE #TeamPatriotes #JambonBeurre #UnionDesDroites;7374;5564;5650;18050;36638
leanehalasi552;Leane Halasi;Night Fiever Experte;36431;165;25;0;36621
NdooleJunior;PILIPILI NDOOLE-Charles Junior;Kamite☥,Co-fon #JEP,SGA et chargé Q.Pô et R.E,Rpt Légal d'#IGA/Kivu,Initiateur NIKO MTOTO WA 2GO,#CDL,Mbre syn @MIFDA18,Sec.Sect.Com et PP #NRA/Goma,SG a.i #FAM;10081;2897;1482;22158;36618
jubuchet;Kiki des collines ð¥ð³;Je prÃ©sente d'avance toutes mes excuses si mes tweets peuvent heurter la sensibilitÃ© des plus cons.;9699;116;67;26735;36617
GeorgesGoudet;Georges Goudet;Auteur - compositeur - interprète. Ex enseignant / responsable  SDC. Guettant, au fil des rencontres, le reflet d'une étoile apparue du côté de Bethléem;17119;1737;1712;16043;36611
MicheleRubirola;Michèle Rubirola;"1ère Adjointe de @Marseille | #SantéPublique
#SantėEnvironnementale #RelationsInternationales | #Coopération #UrgenceÉcologique #UrgencesSociales";3449;1364;27018;4779;36610
AnneMarieJean1;Anne-Marie Jean;Déléguée générale @Fond_LaPoste et élue @Strasbourg @PortStrasbourg @MDE_Strasbourg #territoires #économie #culture #TransitionEcologique #RSE Tweets perso;7513;2830;2538;23723;36604
AtomicMouse75;AtomicMOuse;;8701;711;237;26924;36573
SebPoGo;Sébastien Poulet-Goffard;"Aux manettes de @La_cga avec quelques #Autres. Admin @Gniac_asso.
Je partage ici ma veille #ESS #TravailSocial #Territoires & #Transitions. Profitez-en :)";18465;1880;2866;13342;36553
SpiderJerus;Spider_Jerus@lem โถ๐ป ๐ด๐โโฌโ ๐ทโ ๏ธ๐ธ๐ดโโ ๏ธ๐ค;Homosapiens. La destruction de tout pouvoir politique est le premier devoir du prolรฉtariat. @SpiderJerusalem@mastodon.top;10989;5626;5120;14793;36528
AdjoDoh;Adjo Doh;"je retweete ce qui me touche, parfois les versets de bible née Sourde. @Miseri1Faustine
 je combats au nom de nos libertés bafouées à cause COVID depuis 2021.";26021;225;142;10135;36523
politivons;Politivons;"Nos sociétés vivent plus q'une crise sociale, sociétale, démocratique ou encore écologique. Elles vivent une crise morale, une crise de conscience

🇨🇵🇮🇸🇳🇬";19116;1647;601;15158;36522
PatriceRoiz;Patrice RZT;je suis né, je vis, et puis quoiqu il arrive je serais mort!;17518;53;90;18854;36515
senecoattitude;Sénégal Écologie Attitude;Ensemble pour un meilleur cadre de vie;2193;7431;11409;15475;36508
victorRaboni;inorab vince;libre penseur écolo social  ecolosoc.pagesperso-orange.f…  sur google;32401;172;153;3772;36498
inrsciences;Institut national de la recherche scientifique;Seul établissement universitaire au #Québec dédié exclusivement à la #recherche et à la #formation d'étudiant(e)s aux cycles supérieurs. #inrsciences;22262;2590;10491;1137;36480
Agridemain;#agridemain;#agridemain raconte la réalité de l'#agriculture française ses atouts #qualité #emploi ses défis #production #environnement #innovation grâce aux #agriculteurs;11941;3181;16136;5214;36472
jlt_35;Stop War đșđŠ - đ·đș;"Vous ne me convaincrez jamais de supporter la guerre.
La nĂ©gociation, l'entente, sont toujours possibles, et vos prĂ©texte sont... des prĂ©textes, ou prĂ© textes";25632;868;893;9073;36466
Max_Tech_42;secouss ðºð¦;"Concepteur du monde de demain, chiant, dÃ©sagrÃ©able, sarcasmes inclut. La science gagnera toujours âï¸
Conseiller du salariÃ© ðªð¼ pour vous dÃ©fendre !";8030;2086;224;26111;36451
Marcus31711308;Marcus Saint Louis.;Veteran TDM;22130;381;209;13646;36366
Carlo1Jean;Jean CARLO;#EfficacitéEnergétique #Vélotaf #IRVE et beurre salé, Team Rouge et Noir #EAG;14639;1174;945;19599;36357
dodokbg;dokabangu;;25973;78;297;10007;36355
Morenoluc393687;Moreno luc;;3844;3465;1470;27576;36355
ocean_climate;Ocean & Climate Platform;A coalition of more than a 100 organizations which aims at better integrating the ocean-climate-biodiversity nexus in decision-making #OceanforClimate;7804;2252;12692;13602;36350
Fbc_Pt;Le Fab 🌪⚡😤 / 😁🤪 (Secours=@F_PintadeBleue);"🎳 Pratique le bowling mental 🧐🤔 =                                  
      pulsions incessantes de faire un strike
sur la caste dirigeante !!! 🎳😏";13501;886;3690;18265;36342
Anses_fr;Anses;"Agence nationale de sécurité sanitaire de l’alimentation, de l’environnement et du travail.  
Mobiliser la science pour un monde plus sûr, plus sain, pour tous.";7374;1217;25772;1969;36332
chewb_fr;Chewb - FR;Citizen of the world, keep in mind that Science and tech might save us. It’s up to us. « le cœur à gauche , la tête à droite. »;7195;417;148;28542;36302
Seybasima1;Seybasimað²ð±;#MaliAuTravail ð²ð±ðð¿ð #WULI Ãtudiant: #AmÃ©nagementUrbanisme @UParisNanterre;10374;5001;2913;18007;36295
yann_solle;Pile foirée 🐝;Vienne la nuit sonne l'heure/Les jours s'en vont je demeure;15016;170;133;20961;36280
NgbaKambale;Michel Ngba Kambale;#Sales #Marketing #Communication & #Fundraising spécialiste & entrepreneur I Bénévole @lionsclubs I Passionné de  développement, etc. I @conade_rdcongo;10916;1433;722;23184;36255
BCouillard33;Bérangère Couillard;Secrétaire d'État chargée de l'Écologie 🌱| Députée élue 7ème circo Gironde 🇫🇷 | Féministe 🙋‍♀️;4623;2555;18769;10282;36229
NelsonDeshommes;Nelson Deshommes;Responsable #Com chez @MairieduCap | Journaliste Indépendant |#Blogueur @mondoblog | Passionné des TICs. Vice Pdt Réseau des Blogueurs Haïtiens.;22247;895;2408;10679;36229
FlorenceBlatrix;Florence Blatrix;Sénatrice de l’#Ain /Commission des affaires économiques et des affaires européennes /Conseil supérieur de l'ESS;15892;2391;2754;15189;36226
mqsostenible;Ana Vallejo;"Sustainable Sports Management & Greener Events
Transformando las organizaciones deportivas a través de  Proyectos  de Gestión Medioambiental y Sostenibilidad.";12741;4379;1560;17546;36226
Olivier_S_Lyon;Olivier S;"""Deux dangers ne cessent de menacer le monde ; l'ordre et le désordre"".
Paul Valery";5615;525;185;29873;36198
GuitryJm;African Ivoiroi;sympa;7242;1610;719;26625;36196
duforestel;duforestel;Conseiller regional Nouvelle-Aquitaine délégué à la coopération internationale - Président P.N.R. Marais poitevin / Directeur DUFO&CO #Climat #Bio #Coopération;5932;1502;2846;25908;36188
Les__Infiltres;Les infiltrés;Petits bourgeois, grandes écoles, tout pour être en marche, et pourtant... Infiltrés en macronie, contre la pensée dominante et son monde. Rejoignez-nous !;6610;1597;16016;11961;36184
ap_derfel;Derfel-ap-arthur;Compte secondaire de Ze OZi - Tjs Minarchiste - Tjs Juriste - Tjs curieux đź‡©đź‡Ş đź‡«đź‡· đź‡®đź‡ą đź‡Şđź‡¸ đź‡µđź‡±;11453;1381;237;23093;36164
LianaMary2;Marina KOMB'S 🇬🇦🇬🇦🇬🇦;#SEJEF #KnowledgeIsPower #Ensemblenousironsplusloin #LumakConsulting #LianaFood #LianEmpire #LumakServices #LOADIN #Ingénieur;6001;769;1086;28277;36133
Jeankayale21;ܫܠܝܚܐ ܝܘܚܢܢ Jean;⚜ ܫܠܝܚܐ ܝܘܚܢܢ ⚜;3423;399;438;31864;36124
hannahl17895087;Michonne;happy pride month ð³ï¸âð;7788;257;161;27910;36116
VAntropos;AnthroposVision;Matérialisme,Ontologie,Critique.Professeur(étranger) à la retraite. Il y a plus de philosophie dans les rues que dans de nombreuses universités.Homo sum,nihil..;11702;653;386;23307;36048
mainguy54550388;mainguy;;11687;148;148;24053;36036
leprofesseurfed;Leprofesseurfed;Professeur et apprenant des Sciences de Lumières.;29229;1139;266;5345;35979
abensour;I’m your father. 🐍;Pour se donner une chance d'écarter le côté sombre de la France. L’état.;24132;504;944;10387;35967
BretonLorrain;ZeTetic φ 🇫🇷 🔻🐢🤘;"Breton in Lorraine. #rpg #pollution_shamer. Papa innovation pragmatique. #FreeAssange
Mâle blanc hétéro cisgenre (donc privilégié) Terroriste intellectuel.";12035;2749;1482;19695;35961
CheikhSENE03;CHEIKH SENE;véridique, Champion d’Afrique🏆🏆🏆🏆🏆;13700;4957;4377;12863;35897
catgasy;Cathy;Amore I’m ur favorite muse✨ Vivre d’amour, de parfum et de géopolitique.;15958;127;190;19603;35878
OAamev;FRANCK EBONDO;Qui tue par l'épée,périra par l'épée.   Je suis Kabundiste.;15550;2236;2797;15293;35876
adel_blm;Adel Blm;ici c’est juste Twitter, calme-toi • 🎙️journaliste pigiste @radiofrance bonnette bleu-vert-jaune • ex @esjpro • enfant hybride du 94, Zlatan et Shaq;26869;935;416;7638;35858
Fouduroland;Fou Duroland;Ancien ch'ti, supporter seulement du sc Douai (ah Fortunato), de moins en moins de l'EdF (ah France-Chine), espérant le regain du Losc, du Red Star et de Juvisy;12865;179;66;22746;35856
_Errinan;Timo ( Todd & Janco stan account) ⭐️⭐️ 🇫🇷 🇦🇲;membre du gang des petits animaux mignons. Euro delenda est ! Надеюсь все получится;23614;484;546;11200;35844
PierrePcouture;Pierre Couture;"Chroniqueur/podcasteur/conférencier sur demande
Affaires-Économie-Consommation-Finances
Podcast Ca$hMire et Ca$hMire+.com : cashmireplus.com";24937;1860;8580;466;35843
jacquesperconte;Jacques Perconte;"We are nature. Experimental cinema, expanded love. 
Entre la France et les Pays-Bas";26813;1290;2360;5359;35822
mechankon;jeankul Mechankon;"réactionnaire viscéral et multiphobe.
Disciple de Le Pen, Zemmour et Philippot réunis
Adorateur de J d Arc et M Maréchal
Bloqué par @JulienPain @MRecoquille";11701;872;732;22516;35821
CassCendre;Cassandre;Partenaire Twitch transpd @ZawaProd | Co-animateur @FiLGBTI | đœ TAXIBOY;6751;1187;9455;18425;35818
SavinaAmmassari;Savina Ammassari;@UN Resident Coordinator in #Gabon. Multidisciplinary interests. Engaged in work to reach #SDGs #LeaveNoOneBehind #savetheplanet #genderequality;10814;3363;3241;18394;35812
MauriceCasna;Maurice Casna;;33031;73;330;2346;35780
OubdaIssouf;OUBDA Issouf;"God has make it possible for me🙏🏾.
Entrepreneur-Investisseur- Afrocapitaliste 
#Business❤
#Crypto 🧠
#Gold🫀
#SecuritéAlimentaire 🇧🇫";9949;201;275;25354;35779
ENSM;ENSM;Ecole Nationale Supérieure Maritime Capitaine Chef mécanicien Le Havre - Saint Malo - Marseille - Nantes forme des Officiers de la marine marchande & Ingénieurs;11360;1432;4053;18916;35761
greenpeaceQC;Greenpeace Québec;"L'objectif fondamental de Greenpeace est de s'assurer que la Terre puisse soutenir la vie dans toute sa diversité.

greenpeace.ca/fr";15820;1117;15175;3614;35726
Regionsdefrance;Régions de France;Compte twitter de Régions de France. Toute l'actualité des Régions et des collectivités.;9145;1564;23826;1136;35671
djo_el_pas_solo;Djo El Solo;"trop humain pour être de droite.
j'aime la liberté mais pas celle qui condamne les autres.
la terre est bien ronde, mais ya trop de cons dans les coins.";6212;2773;1871;24778;35634
Mobisphere;Pascal Poty;Born at 322.17 ppm CO2 Senior Expert @adn_wallonie @digitalwallonia Program Manager DW4AI Pr. & Epicurean Enthusiastic, Author of the book l'Instant Mobile;23175;1718;2483;8257;35633
congorassurecd;CONGORASSURE.CD;CONGO RASSURE est un média en ligne de la RD #Congo. L’actualité congolaise (#RDC) en un clic et en continu…Tél : +243999866784 #Eng: @CongorassureEng;2548;2612;30419;47;35626
Gaston85105542;Bulot Gaston;"Non à l'endoctrinement médiatique sur le réchauffement climatique anthropique .
Non à l'éolien qui défigure la France et fait exploser notre facture EDF
#climat";20119;231;169;15107;35626
ewansauves;Ewan Sauves;Attaché de presse @francoislegault | Bachelier en droit @universitelaval | Maîtrise science po. @UMontreal | Journalisme @UQAM | Ex-journaliste | Ambitieux ⚜️;24101;3892;6528;1099;35620
isa_fang;IsaFang;Apprécions les petites choses du quotidien. Le rire d'un enfant qui passe, quelqu'un vous dit bonjour. Demain est un autre jour.Aimons les autres. English C1.;24184;498;178;10747;35607
sempre68;sempre68;Justice avant tout et au dessus de l'esprit reptilien hérité de l'homme préhistorique qui ne fonctionne qu'avec la peur et l'instinct de survie;24422;739;727;9688;35576
hypothesesorg;Hypotheses;"Web platform hosting 4000+ academic blogs in the humanities & social sciences. 
Part of the larger portal @OpenEditionActu / @OpenEditionPro / @OpenEditionNews";18087;2002;14680;780;35549
opportimes;OPPORTIMES;Noticias y análisis sobre oportunidades de negocios, comercio exterior, inversiones, empresas, manufactura, logística, Revolución 4.0 y proveedores.;23580;5866;6089;5;35540
nicolasgalland;Nicolas Galland;Pastry chef, Chocolatier, French pastry teacher and consultant;355;126;164;34893;35538
ThejoneOne;One Jone;Homo-Sapien de la planète Terre,Scientifique, détestant la pensée unique,Tout ce que je sais est que je ne sais rien.;9738;1101;873;23790;35502
GARREAULOUP;GARREAU Jacky;"Retraité cadre :Ex Procurement Manager, membre comité de direction Airbus Nantes. Passions : Histoire du monde,Civilisations,Géopolitique .
Nouvelle-Énergie";12780;1253;820;20648;35501
Dfleur8;Dfleur;;6283;10;218;28973;35484
Permamama;Starhawk Louise Michel;;15214;640;470;19141;35465
psyko_cat;Psycho-cat;Je m'avance de manière subrogative en tapinois.;23460;1022;1064;9905;35451
Bioxartan;Olixy ðª;TrinitÃ©-et-Tobago mon Pays ! Personne Ã  ma droite ? GaÃ¯a Mon  Il n'y a qu'une seule race sauf chez les animaux et les plantes. AntispÃ©ciste. antibiochauvinisme;17607;947;1563;15327;35444
SkySpace1865;Sky Space;"J'aime: science, nature, ciel, espace
Je défend liberté, égalité, fraternité, démocratie et humanité
#الحمد_لله_على_نعمة_الاسلام
كل الناس أخوة في الإنسانية";20918;2139;146;12233;35436
Entrepreneurs;Caisse d'Epargne Entrepreneurs;"L'actualité de l'entrepreneuriat par @Caisse_Epargne
#financement #innovation #digital #transition #international #professionnel #entreprise #ESS #entrepreneur";14093;840;19593;907;35433
milliardaireNUP;Le Capitalisme Avec la NUPES;"Compte twitter des milliardaires réactionnaires soutenant la NUPES. il/lui
(En vrai juste un gauchiste)
Mi skribas esperante malmulte";2956;517;434;31486;35393
babils;babils;« ce qui arrive, en fin de compte, ce n’est pas l’inévitable, c’est l’imprévisible » Keynes, si j'en crois les aventuriers du verglas.;8030;2726;1510;23108;35374
19David19David;David✝️✡️☪️☦️♿️💟⚜️;«La vérité suit lentement son chemin,de nombreux empires se sont effondrés de par sa force» ⚜️Rappelez vous,seuls les justes ont le salut au bout du compte⚜️;10319;3748;1919;19376;35362
isiusmontell1;isiusmontell;J'ssPoutine,Elon Musk,Donald Trump,Edward Snowden,Julian Assange,Andrew Tate,Prof Didier Raoult,ProfMontagnier,Dr Perronne,AlexandraHenrion-Caude&PierreChaillot;34245;294;376;426;35341
PassionPolit;Passion Politique;Compte Privé. Pour un Débat Politique Intellectuel et Préserver La Liberté de Libres Échanges.;17914;4572;1354;11433;35273
nlt56lorient;Nicolas LE TOUZIC ðï¸ðï¸ð¹;Grand brun athlÃ©tique aux dents blanches ð NÃ© Ã  358 ppm ð Prof de maths/sciences ð Ãcologie ðï¸ Climat ðï¸ BiodiversitÃ© ðð¦ð¹;4825;8708;12498;9157;35188
31Sandel;Sandel - XIII L'arcane sans nom, VIII La Justice;Rebelle aux allégeances. Histoire des idées. #futurspossibles / #EIGraves des V C-19 / #psychanalyse #conscience #plurimed #art #scienceshumaines / j'm = notes;6869;2047;822;25445;35183
ProENRv;A Clean Planet for all;"""Il y a des choses qu'il vaudrait mieux ne pas faire"" (Albert Einstein)";22054;334;199;12508;35095
MickaelWilmart;Mickaël Wilmart;"Historien, EHESS - 
Histoire sociale et environnementale  (XIVe-XXe s.) -
Mi-médiéviste, mi-contemporanéiste - écologie - Meaux - Seine-et-Marne - papa";17227;1134;4346;12365;35072
th_luypaert;Thomas Luypaert;@MIT @centralesupelec Engineer & Energy Finance Professional. Formerly @GoldmanSachs 🇫🇷🇪🇺🇺🇸;5138;492;76;29363;35069
ecomnews_agenda;ecomnews_agenda;Tous les rendez-vous #économiques, #politiques et #emploi du Sud de la France. facebook.com/Ecomnews.info @ecom_news;22038;530;10127;2365;35060
assoul57;Kévin Pignol;;21662;1563;338;11490;35053
lv_vitisphere;Vitisphere-La Vigne;Vitisphere et magazine La Vigne. Fil d'informations sur le #vin #WineNews. Vitisphere is a website dealing about #wine for professionnals. #BToB #WineBusiness;13822;1258;18106;1862;35048
JaneOfArc6;Jane of Arc;"#JusticePourLesSuspendus
#LaissonsLesPrescrire
#DissolutionOrdreMedecins #ProtegeonsNosEnfants
#StopEscrologie #EtatCorrompu
#MacronDestitution";14222;1763;773;18285;35043
Martine21267526;Martine.T;"À titre informatif..
Trolls en tout genre seront bloqués d'office..passez votre chemin, pas de temps à perdre inutilement !";13873;332;214;20607;35026
INC_CNRS;Chimie au CNRS;Institut de #chimie du @CNRS. Tout ce que vous avez toujours voulu savoir sur ce que les chimistes font au CNRS.;9587;723;18750;5941;35001
guttonm;Martin Gutton;"Directeur général de l'Agence de l'Eau
Loire-Bretagne";17797;1669;1420;14036;34922
nutriac;Anne-Claire Durand;"Ingénieur agro #nutrition, #food, #RSE
Membre d' @ellessontfood, Actionnaire et évaluatrice @TFTP_France
Mes tweets n'engagent que moi";18521;1158;4318;10924;34921
tomassin;Thomas Nicot;Human - Poetry - Design - Data - Oblique Strategies. Co-founder @wearespheres, a Design and Innovation bureau - The rules are made up, the limits are illusions.;5308;867;1999;26716;34890
duGravier;Nicole Piche;Origine : Afrique comme le reste de l’humanité. Communauté : humanité Croyances : c’est privé.;12959;614;84;21213;34870
JadeGrandin;Jade Grandin de l'Eprevier;"Journaliste, correspondante à Bruxelles de @lopinion_fr. 
Créatrice des vidéos Communiquons! à retrouver sur Youtube. Diplômée @essec";7811;986;19013;7049;34859
LouisGODRON;Louis GODRON ðºð¦;"NÃ©/born @ 321 ppm
Â«L'ignorance mÃ¨ne Ã  la peur, la peur mÃ¨ne Ã  la haine et la haine conduit Ã  la violence. VoilÃ  l'Ã©quation.Â» AverroÃ¨s
Positions personnelles.";14305;1330;1223;18001;34859
Bobou59;Hugobob;"#ThankYouHajimeIsayama
#ThankYouKentaroMiura /
bannière: @maassi__";7294;266;38;27243;34841
mcefic;L'écho logique;sceptique, écologiste, progressiste, féministe et humaniste et c'est déjà pas mal.;7466;2509;553;24311;34839
AperoMedias;L'Apéro des Médias;Compte de veille sur les #medias #socialmedia #journalisme pour inventer, rencontrer et collaborer animé par @yannmael;8004;10639;15634;529;34806
sarahdorner;Sarah Dorner;Professeure, protection des sources d'eau potable @ Polytechnique Montréal.;13094;1996;2771;16933;34794
sylleg33;sylleg33;;29576;2572;60;2556;34764
Saru_sarou;Saru;C'est l'époque de la fin de la partie de Monopoly, c'est quand qu'on range la boite pour passer à autre chose ?;14950;124;118;19568;34760
ChildericGNM;Childeric Genemar;C'est l'histoire d'un communiste, qui parle à un autre fasciste;27405;333;324;6698;34760
JeanneSoradt;Jeanne Soradt;#Anthroposophie ? Non, merci ! #CitoyensduWeb;11832;248;855;21811;34746
EdithPY2;Edith PY;#nature #ecologie (la science) #culture #livres #cinema #sport #vélo #VTT;7406;930;719;25641;34696
YannickMOREAU;Yannick MOREAU;Époux, père, maire divers-droite des Sables d’Olonne, Capitaine de Vaisseau Réserve Citoyenne #Marine, pdt de l’Association Nationale des Élus du Littoral #ANEL;7039;2045;9629;15961;34674
velocirupteur;Bruno;Tu freine t'es un lache, tu freine pas t'es un con.;33423;16;185;1007;34631
AlekssandreCP;A. Curnier-Pregigodsky;Éditeur. Fondateur/directeur de la publication de @noto_revue, @la_nuit_, @Belopolie;11883;413;1754;20576;34626
noahjeanj;NOAH JEAN JACQUES;l’universalité des droits est non négociable comme la souveraineté africaine ❤️‍🩹;16476;468;420;17229;34593
J_Democrates;Jeunes Démocrates;Humanistes 🤝 Européens 🇪🇺 Écologistes 🌿 et naturellement Démocrates 🗳 - Président @Auguste_OTT - Jeunes du @MoDem - Europe : @YoungDemsEU;15731;2490;6744;9619;34584
dominiquekib;Dominique K 🇨🇩;"Si tu ne t'occupes pas de la politique, la politique s'occupera de toi d'une manière comme d'une autre!!!

 #LeCongoDoitChanger";6975;2818;3513;21261;34567
ThadBeaumont1;Thad ACNH;#ACNH / Himling🍒 DA-7362-6859-5668 / Taï Phong🍊DA-6092-9470-1239 / Ashwood🍎DA-2965-2303-3780 / Partenaire le-coffre-a-flonflons.fr;13401;826;2352;17978;34557
Etrendil;Etrendil ð® ð» ð»;Militant @EELV et des @Jeunes_Ecolos | Team #NUPES | Streamer ð® | Vulgarise parfois l'AN ðï¸ ð«ð· | Talk, Think ð» ð» | Et vive le train ð !!;8518;1442;1223;23366;34549
AMPMetropole;Aix-Marseille-Provence Métropole;Compte officiel de la Métropole Aix-Marseille-Provence #AMPMétropole;11418;498;16096;6530;34542
nicohano;nicohano;☀️ Ingénieur chargé de projets photovoltaïques 🌱 écolo ⚛ athée 🔴 quelque part à gauche, mais surtout ni à droite, ni à l'extrême-centre 🖕;2042;1735;133;30600;34510
RichardLefebvr8;Richard Lefebvre;B.A.A HEC ,père de 3 garçons,détenteur de billets de l'Impact depuis 2008. Ski,tennis ,golf,musique, livres,politique,Bruce Springsteen,Mark Knopfler;12922;826;205;20536;34489
MonkeyDFrite;Catsis mais 2;"secours @CatsisKujo 
|privé @tortaltr
| @gyro_zpli toujours un roi";24340;845;406;8897;34488
Gabricoot;Gab;@wrth404 😼;12031;662;837;20957;34487
Fleur50559050;Elsa;Je demande à savoir..#vérité sur ce qui est programmé de longue date. #liberté d’être (êtres) et de penser. Relaie les infos de médias libres et indépendants.;18391;348;10850;4870;34459
Mme_Hall;Mariannig Hall;"DG Espace Mendès France (Culture Scientifique)
précédemment DG Crous, DGA Social CD79, Directrice Territoires Région";15878;564;817;17172;34431
denis_riaux;Denis RIAUX;đŽâ«65;14448;843;430;18705;34426
Thomas_Mng;Thomas Ménagé;🏛 Député du Loiret | Porte-parole @groupeRN_off | Conseiller régional Centre-Val de Loire | DG de l’@Avenir_Francais 🇫🇷 | #avecMarine;17786;1152;6721;8710;34369
kaffeti;stop ou encore;#SAVE THE CHILDRENS;9125;475;108;24600;34308
Pagan29200;Bernez Géléoc;Emsaver, Brezhoneger, militant Breton, surtout à Diwan,  désormais en retraite. J'ai eu l'occasion de déjà défendre nos libertés lors de différentes élections.;11294;756;344;21894;34288
kabdel_off;KABDEL;Le magazine des leaders;34253;2;23;1;34279
BoubacarZana;Boubacar Zana Sanogo;Étudiant en Finance Comptabilité;3450;556;583;29669;34258
hassinhadi;Hadi Hassin;Journaliste à @RadioCanadaInfo;7927;2816;18407;5085;34235
Enerdoom;Belen Sherman;;4025;160;42;30002;34229
AromaSencha;Sencha & Aroma;"đClique sur le lien pour recevoir ton cadeau GRATUITđ

đđđđđ";33920;148;143;1;34212
rezouillis;René Gendron;Communicateur à la retraite.;10509;138;216;23345;34208
NtilArchange;Archange NTIL IBAMUR;"Ingénieur AgroÉconomiste 🇨🇩   ||
Tout est possible quand tu sais qui tu es et que tu l'assumes.

Mes opinions n'engagent que ma petite personne.";5922;1774;1942;24558;34196
XWiik;Xavier Wiik;Papa, adjoint au maire de @antibes_jlp Conseiller @CASAOfficiel & commandant đ Doctorant đšđœâđ - #ThinkOutOfTheBox - @Nouv_Energie;13245;450;1167;19333;34195
Nico21036;Nico đđ;;10310;649;121;23106;34186
Doc_Natacha;Docteur Natacha 👩‍⚕️;Un brin de science, des bestioles de toutes sortes, de la verdure pcq c’est bon pour le moral, un peu d’humour dans ce monde de brutes, Bruxelles pcq j’aime;16354;624;2560;14647;34185
stephilarion;Stéphane Hilarion;Journaliste / Responsable desk numérique à @sudouest;23025;2223;4124;4805;34177
tanc_lle;KC_Tanc 🇫🇷;orlanouille la fripouille;5712;253;110;28084;34159
Aodren_G;NLG🪐;"Foreign Collaborator at NASA.

Astrophysics, space engineering.

discord.gg/V8sQrJTRjD";14483;205;839;18629;34156
PhilippeBernez;Philippe Bernez;;21044;338;427;12321;34130
ejust_iced;e-just( ice );Avocat | Ex-JE | Compte éxutoire de collab | Code is Law | #innovation #legaldesign | #IT #OpenSource & #privacy | #TeamCollabs | ChlorAddict 🏊‍♂️| To life 🥂;9903;1005;812;22352;34072
fab_escalona;Fabien Escalona;Journaliste @mediapart. Docteur en science politique, option social-démocratie. Passion chats, thé, chocolat et chanson française.;14626;1699;11143;6586;34054
FI38vsg;FI Voiron Sud-Gresi;"Compte de notre association d'#insoumis  (anciennement #circo3809) #Isere support aux GA: 
Voiron, Voreppe, Rives, Tullins, Saint-Marcellin, Pont-en-Royans...";10791;1419;969;20871;34050
BuYaBoG;𝔹𝕦𝕐𝕒𝔹𝕠𝔾;"Je ne délivre aucune vérité, je ne donne que mon opinion. Je me trompe souvent, je change d'avis parfois, et regrette quelques fois.
Peace, Haine,Love...☮";21043;824;54;12104;34025
leditiondusoir;L'édition du soir par Ouest-France;L'édition du soir, 1er journal 100% numérique proposé du lundi au vendredi par @OuestFrance;26213;134;7326;348;34021
Amine1407st;Amine 🇲🇦;Dragon Ball GOAT 🥇;6808;180;192;26831;34011
poussepastaluck;steakblédindepatate;Vit pour manger. Et courir.;15792;1140;322;16755;34009
dtupp;detupp đ€;Â« Il faut toujours dire ce que l'on voit. Surtout, il faut toujours, ce qui est plus difficile, voir ce que l'on voit. Â» Charles PĂ©guy;28187;1104;603;4112;34006
VeriteDiffusee;Vérité Diffusée;"Notre vocation est de vous transmettre des informations. Apolitiques, en rébellion contre le système, surtout mondial !

Nous masquons les cptes irrespectueux.";16321;278;12855;4547;34001
Rheamiverna;Rhéa 🐚🫐;🌬️;1742;227;52;31977;33998
sy_bln;SyBln;;3913;1061;265;28750;33989
leroiYaSS;YaSS;وليتلطف;16057;401;113;17407;33978
Franc_Tireur_fr;Franc-Tireur⚠️☣️😷;Electron Libre. Je ne délivre aucune vérité, je ne donne que mon opinion. Je me trompe souvent, je change d'avis parfois, et regrette quelques fois.;27400;116;1154;5266;33936
StefBaly;Stéphane Baly 🌻 🇪🇺;"Co-président @LilleVerte - Élu @LilleFrance & @MEL_Lille
Admin @VirageEnergie @assoCLER, conseiller @ceserHdF, enseignant @Junia_ingenieur
Né en 327 ppm de #CO2";20473;1541;3910;7998;33922
f_desch_de_s;Deschamps de Sainte Suzanne Fabrice;Only one goal : “Freedom & Human rights” for all the people on the Earth ! No tyranny neither conspiracy against Humanity.;17718;232;140;15811;33901
Nasti_st;Nasti ST;;2302;919;2101;28568;33890
notreterritoire;Notre-territoire;Notre Territoire vous permet de retrouver tous les avis d'enquêtes publiques en France. Ce service gratuit est proposé par la Presse Quotidienne Régionale.;33560;126;165;0;33851
FINAL_AGADRAH;Ÿ Gatarah Birmayniroyn Tekaynoy VerayChed Horus Ÿ;"I AM
XEMNOFEDISSE AZURIKEM.
SWEAR OF THE LIFE.
AND TO THE ETERNALITY FOREVER.
BE NOT CONFUSED
IM HERE FROM A FUTURE.
ŸŸŸŸŸŸŸŸŸŸ.";33750;52;9;2;33813
DBangala;Denis Bangala;"Ph.D., PEng., MBA, LSSBB; Bio-pharmaceutical expert";18589;4717;4392;6085;33783
le_trappiste;Gauthier Delacroix đđ€;;24441;283;889;8162;33775
UNESCO_Dakar;UNESCO Dakar đźŹ›ď¸Ź #Education #Sciences #Culture;đź‡şđź‡ł Bureau rĂ©gional de l'UNESCO pour lâ€™Afrique de lâ€™Ouest #Sahel : Burkina Faso, Cabo Verde, Gambie, GuinĂ©e-Bissau, Mali, Niger et SĂ©nĂ©gal. #culturedelapaix;11287;1467;8214;12794;33762
ID_LinfoDurable;ID, l'Info Durable;Le 1er média pour s’informer et agir ! #TousActeurs . Fondé et dirigé par @valerecorreard (super) bien entouré ! 👍;14767;12;8319;10652;33750
Capucin33;billly the kid;"Joli chapeau
Macron est un danger democratique, social, economique et diplomatique.
La pensée ne peut être unique";14594;4217;3301;11625;33737
serenaelissi;Serena 🇫🇷🇬🇧🇺🇦;Mulhousienne 🥨 | Lib-Con | ☢️📊📺🎙️✈️;6607;2221;348;24558;33734
PHautefeuille;đ«đ· Patrick Hautefeuille;IngĂ©nieur agronome #agriculture #FrAgTw #innovation #agronomie #A2C #AgroĂ©cologie #communication #alimentation #qualitĂ©đ«đ·;11583;658;8091;13398;33730
Mondi_Alisation;Mr Mondialisation;"Média indépendant, environnementaliste, humaniste et décroissant.

Pour nous soutenir : mrmondialisation.org/donatio…";6399;138;27057;134;33728
Dr_Agibus;Dr Agibus;"Médecin généraliste MCU-MG, totalement geek (jeux, mangas, séries...), #DragiWebdo
dr_agibus@medicalement-geek.com";24024;860;8682;134;33700
GilgaUruk;Gilga;;19075;195;165;14260;33695
lililelitchi;🦋;🔴🟢⚫️;11339;108;119;22099;33665
FraMathieu;François Mathieu;Journaliste-éditorialiste @LaLibrebe #Politique #Economie #Finances Professeur invité à l'@UCLouvain_be @EjL_ORM 💙💛 @UnionStGilloise;21612;1080;4822;6143;33657
DSchauber;didier-schauber;Quand on a une vie meilleure que les autres, on construit une table plus longue, pas une clôture plus haute !;23054;44;172;10382;33652
ArnaudP65701995;Arnaud Petit;;21810;298;80;11453;33641
ViveCongo;ÉCHOS DE LA RDC;Tous les sujets brûlants de la République Démocratique du Congo et du reste du monde. Le débat est ouvert.;31387;147;1520;586;33640
Prefet91;Préfet de l'Essonne 🇫🇷;Je représente l'État dans le département de l'Essonne. Compte officiel du Préfet et des services de l'État en Essonne;9058;2581;18151;3840;33630
CentreJurisocio;Centre Jurisocio;Nul n'est censé ignorer la Loi, dit-on en Droit ¶ Mais, que faire pour que chacun connaisse la Loi? ¶ Alors en 2012, nous avons fondé le Centre Jurisocio à Lomé;8786;8;458;24365;33617
LiliduChamp;Lili Nivernais;Perlimpinpin dans'une petite école au milieu des champs;17022;270;343;15965;33600
ANgatcha9;Arnaud Ngatcha;Maire-adjoint Ville de @Paris chargé de l'#Europe 🇪🇺 Relations Internationales 🇺🇳 et Francophonie 🇨🇵 Conseiller de Paris 9e | CA @latoureiffel @IFParis;11314;1723;5729;14833;33599
bouchecl;Claude Boucher;"Simple citoyen. Wikipédien à mes heures.
Mastodon: @bouchecl@masthead.social";21603;2455;1636;7878;33572
ECHOfutur;φ L' E.C.H.Φruptible🔻 ⚣ 🧹;"Eveil des Consciences Humaines Obligatoire. 
Citoyen, résilient, engagé, réfléchi. Artiste aussi! INSOUMIS φ #NUPES #LFI";20762;3332;2183;7290;33567
Prefet74;Préfet de la Haute-Savoie;Compte officiel des services de l’État en Haute-Savoie;11889;786;20539;344;33558
MoroccanSories;Moroccan History ð²ð¦Û;"Founder: @Medkupfer
MÃ©dia gÃ©nÃ©raliste basÃ© Ã  Casablanca, spÃ©cialisÃ© en gÃ©opolitique - Histoire - Sport - Monarchie - Culture - Religion
#ProtectMoroccanHeritage";16427;204;3579;13338;33548
jooocks;Jocks;"🇫🇷 23y
Montpellier";4872;234;75;28361;33542
moreaumichel40;Michel Moreau;"tolérance et respect 
soutien sans faille à l'Ukraine et à tous les peuples opprimés";6912;165;241;26216;33534
FranceEmirats;France aux Emirats;"Compte officiel de l’Ambassade de France aux Émirats arabes unis - Official account of the Embassy of France to the UAE 
#FranceUAE";16704;2707;12510;1611;33532
mongi13002;Mongi de mars13;"Photographe
Fervent défenseur de la justice!
Apprécie les personnes saines d'esprit et surtout qui réfléchissent par eux-mêmes !";30433;95;199;2746;33473
MolieJean;jean-marc Molié;postier de profession, passionné de coutellerie artisanale, formé à Thiers et chez un artisan corse en vue d'une reconversion professionnelle.;9686;128;59;23585;33458
YannBre;Yannick BRÉ;Iffendic - Conseiller municipal à #Iffendic - #numérique @MontfortComCom @MegalisBretagne #Tremelin #Paimpol #Brehat #Corse #Bretagne @PS35Broceliande @BREIS_PS;14606;1317;905;16630;33458
PascaleDery;Pascale Déry;Députée de Repentigny. Ministre de l’Enseignement supérieur. Accessibilité. Persévérance. Réussite. Valorisation.;8644;1848;6169;16757;33418
techn0verdose;Nicolas Phalempin;Responsable Environnement & Mobilité en collectivité - passion #transitionécologique & #Participation  -  Auteur @SolutionLocal - né en 349ppm;31285;149;1711;267;33412
AureliAssouline;Aurélie Assouline;Adjointe au Maire #Paris17 : transition éco, espaces verts, biodiversité & condition animale / SDA #LR Paris / Chef d'entr. #AdministrateurDeBiens #Juriste;12727;3001;3393;14282;33403
ufelectricite;Union Française de l'Electricité;Acteur 🇫🇷 & 🇪🇺, engagé dans la lutte contre le changement climatique, l’UFE représente les entreprises du secteur électrique;12050;3975;8222;9104;33351
leblog_lpbb;Blog #LPBB⛳️;#LPBB, site d’actualités et infos sur la petite balle blanche par des passionnés. C'est aussi un #podcast et une newsletter hebdo #ALLinONE;18907;875;2184;11351;33317
Felfinus;đ Yao Guai dâHiver đ;35. Nana Ă  chat, anglophone & multifonctions. Des fois je joue aux jeux video. Supportrice courtoise de la #TeamMHR . Much â€ïž;27897;868;629;3923;33317
CDGHospit;CDG Hospitalier;Irresponsable du contrôle de gestion hospitalier, spécialiste de l'imprévision d'activité et des prévisions d'inactivité;9910;900;907;21581;33298
chris_p_potter;Christopher Potter;Entrepreneur (plateforme souveraine opensource GoFAST), ex.Cadre Dirigeant NTIC, Ingé.aéro,Pilote. La France doit résister dans le logiciel. Numeum. FR/US;14336;1524;856;16581;33297
achatpublic_com;achatpublic.com;ð» Leader en France dans les services aux #AcheteursPublics : #DÃ©matÃ©rialisation des procÃ©dures â¢ MÃ©dia de la #CommandePublique / #MarchÃ©sPublics â¢ #Formations;26030;1329;2701;3232;33292
FoodSecureCAN;Food Secure Canada;Non-profit working for healthy, just & sustainable food systems | Réseau pour une alimentation durable;12954;2273;11202;6776;33205
SimonVa42940408;Sim's 🇨🇵🇪🇺🏳️‍🌈;Résultat d'un brassage 🇨🇵-🇩🇪-🇵🇱-Askhénaze, donc 🇪🇺 convaincu. Danse folk, Histoire, Aide aux réfugiés et Sci-Fi.;14405;147;105;18518;33175
thomasf76934279;thomas france;;32985;32;118;34;33169
EvilDav46928861;EvilDave;J'aime Cayenne, pour les ordures qui nous gouvernent;20288;349;152;12364;33153
LmdsTv;THE_LMDS | 📦☄;"Bonjour, je fais des vidéos, et c'est drôle | 📦       -Vendeur de maïs pendant mon temps libre                
 Code LMDS afin que je m'achète une glace";835;500;105;31713;33153
VDNDouai;VDN Douai;Toutes les (bonnes) infos de #Douai et de sa région avec la rédaction locale de La Voix du Nord !;27550;456;4998;131;33135
resca_mqgp;Resca MQ/GP;đ Retenez lâessentiel de lâactualitĂ© | Martinique, Guadeloupe | MĂ©dia Digital | contact@resca.fr;7793;6;23872;1442;33113
pi_boul;PiBoul;Liberté et vraie justice;23064;524;472;9049;33109
ArtsetMetiers_;Arts et Métiers - ENSAM;Compte officiel de l’École National Supérieure d’Arts et Métiers (ENSAM) - Grande école d'ingénieurs française - 8 Campus - 3 Instituts - 6000 étudiants;15891;1405;10977;4812;33085
PhattFlowDek_55;Phatt Flow Dek 55 ð¢ Ï;"RÃ©voltÃ©. Et rÃ©voltant. Provocateur.
De gauche, et parfois tout le temps de gauche. Aversion pour la macronnie. Hip Hop. Graffiti. Rap. Production. Dj'ing.";9712;4774;2380;16218;33084
smoldiggernick;BDN;"Cubanolâtre

Lisez Oshimi Shuzo";11444;137;309;21170;33060
Quand_il_y_en_a;Quand il y en a, il y en a...;"... mais quand il n'y en a pas, il n'y en a pas.

follow the gourd !

follow the shoe !";12986;1934;420;17699;33039
CRESS_sud;CRESS Provence-Alpes-Côte d'Azur;La Chambre régionale des entreprises de l'économie sociale et solidaire en Provence-Alpes-Côte d'Azur ➡️ La #CRESS au service des entreprises de l'#ESS;13771;1854;3491;13916;33032
GastonTrougnard;LA SCIENCE;"Compte secours de @Gekko_Hopman! 
il/iel ð®ðªð«ð·ð³ï¸âð 
DÃ©mÃ©nagement envisagÃ© sur mon compte Mastodon: @GastonTrougnard@h4.io";18523;587;247;13662;33019
Malloradium;Malloradium;Quoique je dise, quoique je fasse, il faut que passent les voitures (noires).;12000;154;162;20682;32998
FabianAllanic;fabian Naceri;« Nous ne sommes pas des êtres humains vivant une expérience spirituelle, nous sommes des êtres spirituels vivant une expérience humaine » P.T de Chardin;9525;2980;4876;15611;32992
Arcep;Arcep;Autorité de régulation des communications électroniques, des postes et de la distribution de la presse jalerte.arcep.fr;6962;1359;22357;2267;32945
TelegVannes;Le Télégramme Vannes;Compte Twitter de la rédaction du Télégramme à Vannes (56). Infos, actu, sports et bien plus encore...;25142;710;6706;328;32886
_EvaSas;Eva SAS;Porte-parole du groupe Ecologiste à l'Assemblée Nationale, Députée de la 8ème circonscription de Paris;13715;2371;13682;3104;32872
Ballymag;Olga Baranova;« Je ne pouvais accepter le monde que par l'entremise des mains humaines » politics @CHplusplus @spschweiz politische Bildung @anny_klawa_morf @CampaignCampCH;14921;749;3744;13423;32837
RoadTo10nis;Sidney ا;On peut répandre la lumière de deux façons, être la bougie, ou le miroir qui la reflète.;14077;1779;987;15990;32833
j4ff4rr;Jaffar;Être de gauche, c’est réfléchir.;5445;315;76;26987;32823
WikiAgri;WikiAgri;"Media professionnel
#Agriculture
#Agtech";10431;5247;11551;5562;32791
NejmaBrahim;Nejma Brahim;Journaliste @mediapart | Pôle international, migrations. « Yana datni el ghorba datni... »;3105;990;12538;16140;32773
ByDeepz;Ben;slt miss mad, dispo pour un verre ou quoi ? ^^' Sapiosenssuel, photographe amateur;18894;262;1640;11954;32750
MeretMarine;Mer et Marine;Toute l'actualité maritime;20454;697;11467;109;32727
PoussierLaurie;Laurie;je trais des vaches, je fais du savon, et j’aime bien l’aloe vera aussi. #ceuxquifontlelait. #artisanat #FrAgTw #Bzh;9087;1692;6968;14977;32724
VictorNdonnang;Victor Ndonnang;“…Talent is everywhere, but opportunity is not.” Helping to bring the #Internet of #Opportunity to everyone. Sr. Manager @InternetSociety. Views are mine;19142;1826;2406;9309;32683
sebgdu;Sebastien GDU đ«;â­ïžâ­ïž Head of Product Agorapulse - Member at FrenchCPO - Soccer - Gaming!  - Dad & Champion du monde (x2) - Views are my own ! đ§đ¶;27622;992;991;3078;32683
AzzazNadege;Nadege Azzaz;Maire de @Chatillon92320 • VP #Sports @vallee_sud • Conseillère régionale @groupeSER_IDF • @jaimechatillon;13232;1995;5256;12188;32671
vlanx0;Vlanx;"Je pratique le dur métier d'éditorialiste sur YouTube : piped.video/@Vlanx/videos

Masse Taux Don : arobase vlanx arobase piaille point fr";7349;317;5620;19378;32664
ecvass02;Charlotte Vassant;Agricultrice en polyculture blé, betterave, pommes de terre, légumes, cipan en tcs et labour, #globalgap @beApi_Coop;18069;1289;3083;10220;32661
AMDucroux1;Anne-Marie Ducroux;"Enjeux du XXIème siècle, état du monde... 
Expertise #DeveloppementDurable #Environnement #RSE #ESG #Dialogues 
Bonus #Beauté #Saisons #Nature #Culture #Paris";23818;4372;1411;3058;32659
gloria_0410;Gloria ð§ð¯;ð ð³ she/her insta ð¸ @glorias_captures EARTH | PEACE | LOVE âï¸;6825;972;453;24382;32632
flyCSI;Clément;#geek #tech #digital #travel #avgeek ex-#airline. Tweets are my own.;17703;504;1505;12875;32587
DeGrahamdetroy;Graham De Troy;E-Woke, je bloque à vue les intolérants, les racistes, les fachos, les zemmouroïdes, les ZE et les Z (qui visiblement sont les mêmes).;13691;872;115;17894;32572
sycfi;SYCFI;Nous regroupons & représentons les #consultants #formateurs #indépendants intervenant en #Formation #Formpro Discussion linkedin.com/groups/7433421;29208;921;2118;315;32562
MBACanada;Musée des beaux-arts du Canada;Le Musée des beaux-arts du Canada est OUVERTS. Visitez notre site Web pour plus d’info. (English: @NatGalleryCan);12513;768;17728;1544;32553
AsinDidier;ASIN DIDIER;Non aux mondialistes et aux bien-pensants.;20774;72;270;11426;32542
HisoooK;Hiso ðŸ‡¦ðŸ‡±;ðŸŒ»ðŸŒ»ðŸŒ»ðŸŒ»ðŸŒ»;16039;206;969;15326;32540
newsnetfr;newsnet;Base documentaire pour le datajournalisme;32289;0;238;5;32532
alharroud;Alharrou;Politique || Communication || Nouveaux médias Building @tounmedia;6695;970;3185;21662;32512
Izidra_;Izidra đđ;Esprit curieux et critique. RĂ©voltĂ©e par les injustices et les mensonges. No đș #FreeAssangeNOW #FreePalestine;12561;100;102;19748;32511
raufrere;Rémi AUFRERE-PRIVEL;Expert Stratégie, Europe-International, assoc. , RS UNSA Ferrov, CESER IDF, consultant social. Élu local 1989-2008. Médias TV Radios, social self-influenceur😉;4692;863;739;26209;32503
LusoMys;Luso_MYS;;4092;494;58;27858;32502
Libertd65830771;Liberté d'expression #NONALAGUERRE US GO HOME;La liberté d'expression ne tolère aucune tyrannie. Lisa de Clugny.;19419;737;487;11848;32491
BrahimAzmi;AZMI;La grande affaire et la seule qu'on doive avoir, c'est de vivre heureux ð«ð· ð²ð¦ mes tweets ne concernent que moi!;8007;337;246;23891;32481
asdl44;đ;;12131;796;662;18884;32473
UEauMali;UE au Mali;compte officiel de la Délégation de l'Union européenne au Mali à Bamako;2085;151;30176;60;32472
Liona543J;Léona1234;"Des mots.
Essayer cette chose, encore.
Comme des petites bouteilles à la mer, oui.
Écrire sur tout et rien.
Réflexions, musique, lecture, animaux, cuisine.";12519;477;246;19228;32470
Ata1ante;Atalante ن;liberté! j’écris ton nom.;16651;152;236;15427;32466
LeFnake;le Fnake;"Quand est-ce qu'on se décide à agir vraiment ? 
Climat, biodiversité, limites planétaires...";5769;112;118;26457;32456
too_sham;KarlMaps;"Dada scientist
☁︎☔︎ ☀︎ 
   ℃AP
     ℹ︎tª
    LO©
    EN€
🏗🏭🏢🏦

♨︎ @DesFaiseurs
#ClimateBrawl ⚡️";8080;533;540;23299;32452
Cyrielle_Chtl;Cyrielle Chatelain;✌️Députée #NUPES #EELV 🌻Présidente du groupe écologiste 📍2e circonscription de l’Isère #circo3802;8562;1492;8776;13589;32419
DotraFranck;franck dotra;;6996;110;158;25140;32404
ahmedmogola;Ahmed MogolaðŸ‡©ðŸ‡¯;SecrÃ©taire GÃ©nÃ©ral de la Ligue des Jeunes Progressistes du Parti Rpp ( Parti au Pouvoir). Je suis la dÃ©finition de notre devise: UnitÃ©-EgalitÃ© et Paix.ðŸ‡©ðŸ‡¯;7971;5350;5752;13315;32388
FrancoisMarot;Francois Marot ð¡ï¸;"System change not climate change: shift to sustainable society, change conventions
#dev #agile #devops #Java @thisWorldIsInsane@mamot.fr";20648;1245;591;9902;32386
NasroLam75;🇰🇵🤺 نصرو النقشبندي;Algerian hopeless - ✌️مافيهاش/ Anti-Makrout;22835;2011;603;6884;32333
noschlafen;noschlafen;;30408;1118;660;116;32302
FranckPengam;Franck Pengam (Géopolitique Profonde);Autonomie & Décentralisation sur geopolitique-profonde.com;7086;1772;15161;8281;32300
Equili_Energies;Équilibre Des Énergies;Organisation d’entreprises engagées dans la décarbonation en France et en Europe pour une transition énergétique conciliant prospérité, climat et acceptabilité;19330;1539;9073;2335;32277
Patochefan;Patoche;Balkany Fan Account;18872;448;247;12687;32254
Valiryus;Linconnu;Presque connu.;10157;1245;756;20038;32196
ActuIAFr;Actu IA - Intelligence Artificielle;"Toute l'actualité de l' #IntelligenceArtificielle /
Première source d'info 🇫🇷 / Membre de l' #AI Alliance 🇪🇺
 #IA #machinelearning #DeepLearning #Transfonum";6714;8815;14154;2505;32188
web2day;Web2day;ð¦  #Web2day is the #digital spring break for #startups & #tech professionals and enthusiasts. Next â 31, 1 & 2 juin. Powered by @CantineNantes;14870;1568;13786;1937;32161
LouChesne;Lou Chesné / @louchesne@mas.to;Porte parole d'@Attac_fr;10648;627;836;20030;32141
Burlesque_32;ð«ð· Abracadabrante;"#JambonBeurre #TeamPatriotes #Reconquete #JeSuisLÃ PourVa
Pas de MP s'il vous plaÃ®t.";4992;2717;2363;22036;32108
ugodiluca;Ugo Di Luca ðªðº;"We need to be smart examples for robots coming next
âªï¸Friulano
âªï¸#WebApps #SaaS #Datas #AI
âªï¸Infos sur #Italie";23321;496;843;7437;32097
EnergyNewsPro;energynews.pro;Energynews.pro c'est l'actualité du secteur des énergies. Diplomatie, politique, marché ou technique, retrouvez tout ce qui fait votre industrie.;24393;4499;2833;352;32077
daniel_ikoli;ðŸ‡¨ðŸ‡©;La patience est la vertu du juste;11028;1974;1503;17550;32055
GilbertAveugle;Gilbert CHEVALIER;Je suis vendéen, aveugle, veuf, organiste retraité, compositeur et interprète. Je n'ai pas été avorté malgré ma cécité et je ne veux pas être euthanasié: pigé ?;26022;2944;1092;1995;32053
AmbSuisseRDC;Ambassadeur Chasper Sarott;Ambassadeur de Suisse đź‡¨đź‡­ en RĂ©publique DĂ©mocratique du Congo đź‡¨đź‡© et au Gabon đź‡¬đź‡¦ et Ambassadeur dĂ©signĂ© en RĂ©publique du Congo đź‡¨đź‡¬. @eda_dfae @swissMFA;1527;96;27526;2891;32040
LoigCG;Loïg Chesnais-Girard;Président de la Région Bretagne | Prezidant Rannvro Breizh | Perzident de la Rejion Bertègn | #emojibzh | 🇫🇷🇪🇺;5856;993;18490;6680;32019
asc_csa;Agence spatiale canadienne;L'Agence spatiale canadienne coordonne, au nom du gouvernement du Canada, les programmes spatiaux civils. Conditions: bit.ly/1LqZO4Z (English @csa_asc);17169;573;12204;2026;31972
vl_plus;vl_plus;Refusez le mainstream ! Abonnez-vous Ă  @vl_plus. đź‘‰  đźŽĄ Mini-vidĂ©os sur l'actu, les affaires, l'argent, etc sur YouTube đź¤µ piped.video/@vl_plus đź‡«đź‡·;13061;1597;10981;6330;31969
didjule;ʝʋ;"Quelqu'un sait à quelle heure c'est la prochaine révolution ? 🤔

Instit, militant cgt, musicien, à spondy pour la vie #autoimmunesaloperie #dépressionforever";14533;571;238;16607;31949
jimestone_voxx;Ghost_Voxx 🔸♠️;⛔️ Always imitated but never equaled🙈🙉🙊. Messi 🐐 ❤️💙;6609;923;1105;23289;31926
Mouettedelouest;Mouette de l'ouest;Dans ma grammaire, le féminin l'emporte. Nature, ma vie. Laïcité. Liberté.;11663;1309;204;18746;31922
KEMPFHERVE;Hervé Kempf;"Rédacteur en chef de @Reporterre, le quotidien de l'écologie. Auteur de ""Comment les riches détruisent la planète"" (@EditionsduSeuil)";2491;149;29233;28;31901
Life01Thomas;Life 01;"LIFE 01 - Toute l' Actu sur la pollution de l'air - Respirez Informé
#indoorairquality #qualiteairinterieur #airquality #qualiteair #IAQ #QAI";31540;225;69;46;31880
bastos4ever;Lola la mécréante ❤️;Les humains sont la seule espèce sur terre 🌏 QUI ne sert à rien . Une abeille 🐝 est plus importante que n'importe lequel d'entre nous. ÇA fait réfléchir.;16723;3553;3023;8573;31872
ManuelDUPONT7;Canon78;;20586;334;721;10216;31857
PlanPse;Plan Sénégal Émergent #PSE;#senegal;13399;1221;3386;13845;31851
16Tpe;Toyec P.E. 🔋;"Doctorant en motorisations electrifiées 
Sympathisant #MouvementSimple";7543;342;381;23576;31842
hokuspokus1877;hokuspokus1877;;15426;2362;291;13751;31830
L_mncn;Banzai;Bout de bois I'm daddy 👶🏻 Citoyen du monde 🌍;28817;260;228;2520;31825
AutoMotoOffi;Auto Moto Officiel;Bienvenue sur le compte officiel du magazine Auto Moto et du site auto-moto.com ! #News, #essais, #scoops, #pratique. Ne ratez rien de l'automobile.;15120;639;15946;120;31825
CAPE_ACME;@CAPE-ACME;"Canadian Association of Physicians for the Environment | Association canadienne des médecins pour l'environnement
Securing human health by protecting the planet";13203;2887;7023;8665;31778
IDDRI_ThinkTank;IDDRI;"#ThinkTank indépendant qui facilite la transition vers le développement durable.
Account in English: @IDDRI_English";10167;1604;13791;6208;31770
Floby;Florent Jaby ðð·ð¨;"If you write stupid code, your code does stupid things.
ex-Octo, ðâª
Team #ViteMaDose

Vouvoiement requis si on ne se connaÃ®t pas.

ð @floby@mastodon.social";19185;436;890;11253;31764
RadoineHaoui;Radoine HAOUI;Psychiatre, ex Président de la CME, chef de pôle psychiatrie #psychiatrie #santementale;5494;2557;2134;21577;31762
BHouillon;Bertrand Houillon;Maire de Magny-les-Hameaux #magny78 @magny78114 + VP agriculture et espaces verts #sqy #interco;11062;518;1350;18802;31732
Sbjlf;Sb;"j'đ ma đ«đ·, mes racines, ma culture, mon terroir.
Je soutien nos FDO.
Anti Macron, anti gauche/ecolo bobo, anti woke";12501;1929;1618;15678;31726
rveillezvous5;réveillez-vous;;7328;440;439;23505;31712
elephantgeek;Matthieu D.;Transition énergétique, urbanisme & patrimoine. Économie, communs & externalités. Nanars, vfx & pop-culture.;8779;953;775;21182;31689
JCColasRoy;J-C Colas-Roy;Vice-Président de Coénove | Député de l'Isère de 2017 à 2022 🇫🇷🇪🇺 | Ancien administrateur de l'ADEME | Ingénieur Grenoble INP | #energie #climat 🌍;4481;1584;7155;18462;31682
86Greenpeace;Greenpeace Poitiers;Greenpeace Poitiers est l'un des 26 groupes locaux de Greenpeace France. Tous bénévoles, notre mission est de sensibiliser le grand public;3689;134;354;27487;31664
Fabien_Albert;Fab ð³ï¸âððºð¦;EvÃ©nement . Nature . Gastronomie . CafÃ©s & Slow coffee;1829;664;143;29023;31659
enviroflux;Enviroflux ð³;"ActualitÃ©s et informations tous azimuts environnement, Ã©nergie, biodiversitÃ©, climat, innovations citoyennes...
...enfin tout ce qui va dans le bon sens quoi !";27968;2002;1395;248;31613
sirasylla76;Sira SYLLA;Députée de la XVème législature. Avocate. Auditrice #IHEDN POLDEF #DiploCulturelle #Francophonie #Visas #Diasporas #TransfertsDargent #Afrique #Sénégal #Rwanda;7028;1118;11230;12235;31611
anouchk53686141;anouchka;;15010;138;130;16328;31606
Filoutube71;Filoutube;;15746;170;99;15584;31599
agricultrice81;Massif;Mamie Gallium;14523;405;371;16297;31596
VDNDunkerque;VDN Dunkerque;Bienvenue à la rédaction dunkerquoise de La Voix du Nord.      Venez suivre l'actu de chez vous;23976;291;7259;41;31567
iscoscisl;ISCOS ets;L'Iscos, nato nel 1983, promuove la solidarietà internazionale e la cooperazione allo sviluppo endogeno, ecologicamente sostenibile e socialmente equo.;8291;1545;1674;20028;31538
Parker_heros;Parker;24 ans // Parfaite illustration du courage. 2023 // Reconquérir le Pouvoir// Je suis entièrement libre comme le Révérend Martin Luther KING. FATSHISTE.;11213;2398;2493;15434;31538
cityzenwalking;DAKTARI : Rédacteur en chef;Groupes d'échanges : #POLYPIQ : Politiques #POLYCULT : Cultures #POLYTALK : Débats #RESODIMO : Comm Jeux énigmes : #ENIGMO #MINIMO #HEBDODIMO #CODIMO #GEODIMO;8755;4184;2620;15831;31390
valentinecarton;Valou;'Quand la vie et la mort se tiennent la main, l'histoire peut continuer' Delphine Horvilleur ♥️🕊;15384;419;193;15393;31389
JeanHenaffSA;Groupe Jean Hénaff;"Petit groupe familial breton engagé pour une alimentation durable
henaff.fr henaffandco.fr algues.fr kervern-charcuterie-bio.fr
#henaff #globexplore #kervern";8704;447;7272;14932;31355
SergeSasseville;J.Serge Sasseville (il/lui-he/him);Homme cis gay avocat anglican passionné par la culture en couple avec un arabe musulman/Conseiller de la Ville indépendant district Peter-McGill @CentrevilleMTL;24074;1768;3461;2038;31341
JA_Moreau;Jean-Antoine Moreau;Personnalité publique;18949;620;693;11074;31336
edtwmasc;Edmasc;Économie Politique Rugby Sports;20045;135;226;10918;31324
_kobmanden_;Ｌ’ｅｐｉｃｉｅｒ;🇩🇰 Chasseur de tête d’ail 🧄 Je trade les fruits et légumes bio, le forex, matières premières et indices.;11978;850;180;18306;31314
VickyBe5;Vicky Be;Nâentre pas dans le moule du nouveau monde. Pour le rassemblement des droites. Sauver la đ«đ·;6334;1343;1143;22460;31280
B_SMART_TV;B SMART;Le media des audacieux;12260;512;16652;1848;31272
F8Full;f.;"Life is a {lovely, lonely} game.
Autistic, !typical, ð³ï¸âð. And then some.
ðºð¦";10022;1314;276;19655;31267
frhannequin;Frederique Hannequin;Inspectrice d'académie-inspectrice pédagogique régionale #histoire #géographie #Martinique- #EDD -Valeurs de la #république -Réserviste citoyenne et musicienne;7090;2265;1311;20597;31263
laurentminguet;Laurent Minguet;Ing. physicien, entrepreneur (EVS, XDC, PIL, Horizon, Solinvest, Mega...), cluster TWEED, membre de l’Académie royale de Belgique, administrateur EDORA;14139;301;2708;14088;31236
PVincourt;Patrick Vincourt đ Pvincourt@mastodon.zaclys.com;Formerly Research Director @INRAE_France ,also involved for seventeen years in R&D of French seed companies. Now retired.;21341;670;1554;7670;31235
mi_olivier;Olivier.M;"The Best is yet to come
(PP tsariste par #RingEditions)";8799;562;111;21762;31234
Alexand60933058;Alexander;Je déménage sur mastodon, peser sur le game... @byron... Mais le cloaque twitter devient trop étouffant, bitcoin et mise en avant du pire...;16623;216;61;14326;31226
transdevFR;TransdevFR;"Permettre à chacun de se déplacer chaque jour grâce à des solutions sûres, efficaces et innovantes au service du #BienCommun 🗺
#TheMobilityCompany";8328;2615;12648;7616;31207
Cogitopix;Cogito;"""Bien informés, les hommes sont des citoyens ; 
       mal informés, ils deviennent des sujets"" 
                                                     A. Sauvy";25739;63;434;4928;31164
clemrenard_;Clément Renard;#DroitsHumains #LutteSociale #DémocratieDirecte #PeuplesAutochtones #Écologie #Climat #AbyaYala;10539;2442;6533;11617;31131
GrandParisMGP;Métropole du Grand Paris;Compte officiel de la Métropole du #GrandParis;5766;875;18268;6217;31126
Coach_Crazyleg;Michael J.P. Laurent - Are you in PARETO 5% ™ ?;The healthy SELF AFFIRMATION , H2W !  - WITH GENERATIVE AI, YOU WILL NEED TO BE IN THE 5% FOR THE LAW OF PARETO -   Our Luxury Brand : The  MG CLUB #mockinggem;14243;3032;901;12942;31118
MNontondji;Maurice NONTONDJI;"LinkedIn Community Manager. Passionné de social Media et entrepreneuriat.

#marketingdigital #LinkedIn #digital #CommunityManagement #Freelance
#digital";26990;721;371;3035;31117
jc_tortora;Jean-Christophe TORTORA;Président @LaTribune Entrepreneur #Economie #Médias #Territoires #Innovation #Industrie #TransitionNumérique #TransitionEcologique #Climat #Mixité #Inclusion;7787;1629;5523;16129;31068
g_maneski18;Le Pichichi 🇨🇲;Je préfère mourrir que de survivre, je ne vais jamais manifester @fcbarcelona;20482;332;137;10085;31036
Johanalyse;New world đ;De retour pour de nouvelles aventures ! Un affront ? Une insulte ? Je bloque... #RENAISSANCE #PS5 #APPLE;7958;171;285;22610;31024
Globe59;David 🇫🇷 🏦 Investisseur immobilier;🎯 Objectif : La retraite dans 10 ans | 1️⃣ M€ de patrimoine immobilier brut | 🎁 Je t’aide à créer ta retraite 🔥 | #immobilier #scpi #immocrypto;12056;144;8390;10434;31024
jcdubacq;ʒɑ̃kʁistɔf dybak🏴‍☠️;Loyal neutre a Chaotique bon. VP redondances de @RealUNIVFrance . Informaticien et auteur lipn.info/jcdubacq @jcdubacq@lipn.info @papajessie@piaille.fr;26357;480;591;3530;30958
AgostiniCome;Côme Agostini;"🏝️ Corsica
💼 Assemblée nationale
🎓 Sciences Po | Paris-IV | MNHN 
💙 Président de @renaissancecor 
❤️ Président-fondateur de @nova_sciencespo";12860;541;408;17148;30957
franckstassi;Franck Stassi;Journaliste #BTP (matériaux, construction, aménagement, bois...) et Biens de #consommation @usinenouvelle. Blogueur @businessmarches. Compte personnel.;12838;455;1056;16597;30946
f_angebault;Frankie ANGEBAULT;Vice Président Mobilités #GrandPoitiers / Élu délégué Ville Cyclable #Poitiers @P_collectif / Ingénieur #TransitionEnergétique / tweets n’engageant que moi 🚲🌈;8519;3164;2377;16880;30940
_pilaf_;Pilaf;"Creative Director.
ex @riotgames (#LFL #DIV2 #OPT). Tweets are mine.
My mom says I'm special.";11241;1115;1049;17533;30938
JulienApostat;Julien;;11938;377;307;18309;30931
100media_fr;The Media Leader (100%Media);L’info média des professionnels. 100%Media, newsletter préférée des decideurs medias. Une société Adwanted Group. 🗞️👉themedialeader.fr/newsletter;17868;1115;10438;1485;30906
PfeifferCarl;Pfeiffer Carl;;20912;308;241;9433;30894
LeLyonTurin;La Transalpine Lyon-Turin ð«ð·ð®ð¹ðªðº;ComitÃ© pour la Transalpine #LyonTurin - 270 km de liaison ferroviaire fret & voyageurs Ã  travers les Alpes pour relier lâEst et lâOuest de lâEurope ðð±;4842;7269;8241;10535;30887
Ben100__;Ben10ð;Je vous regarde dâen haut et j'aide les reufs Ã  se lancer en Freelance. SaaS maker avec Deep et co-fonda @greenea_io;11595;307;927;18035;30864
NaremariO;Narémari Ossiré;DIEU dirige tout . Concepteur, développeur d'application et site Web. master  e-commerce. le monde c'est l'humilité et le travail dans l'ombre 😇🙏🙏🙏;12171;2693;2058;13939;30861
Calys84701718;carlys;acab: à l'adresse du compte du petit Robert;22731;104;127;7844;30806
durovray;François Durovray;Président @CDEssonne, engagé pour son territoire | Président @codatu_org | Responsable Prospective- Idées & délégué #IDF @NousFrance_fr | #Mobilités;13636;1592;8994;6580;30802
le_investisseur;Le média de l'investisseur;Le média de l'investisseur est destiné à ceux qui souhaitent s'informer sur la bourse, sur les cryptomonnaies et sur l'immobilier. Pas de conseils financiers.;9722;302;10775;9977;30776
ObsSmacl;Observatoire Smacl;"⚖Actualité juridique #ColTerr #FPTerr #assos  
Un service de @SmaclAssurances assureur qui accompagne les collectivités et les territoires depuis 50 ans.";23216;1547;3072;2899;30734
CongoHandicap;Congo Handicap /Advocacy;Congo Handicap est une  organisation nationale de droits congolais luttant pour la promotion des droits humains  des personnes en situation de handicap 2007;13597;5299;5778;6031;30705
ArthurMilchior;Arthur Milchior;"English on @ArthurM_en,
SWE Google Chrome,
mainteneur @AnkiDroid,
blogueur,
fan de math et d'informatique,
Il/lui par habitude,
Mes tweets n'engagent que moi.";22477;1361;1024;5822;30684
LHdecores;Légion d’honneur-les décorés;;7101;0;1442;22132;30675
LinucheB;Linuche Bertrand;Pas envie d'échanger des insultes donc je bloque;5422;533;90;24630;30675
FabienRoca;Fabien Roca;Sudiste expatrié à Paris | Ingénieur | Lecteur du GIEC | Observateur de la société d'aujourd'hui;331;328;13;30001;30673
GregPatriote17;Greg1775;Souverainiste đ«đ· Amoureux de la FRANCE đ«đ· Anti macron et gauchiasses . Le gauchisme et le macronisme sont des maladies mentales incurables;9333;3662;3738;13911;30644
Watzuki1;Arthur D 🇨🇵🇪🇺⃠ 🇺🇸⃠;"Gaulliste, socialiste donc souverainiste

Ce que je dis n'engage que moi 
Responsable @ujsouv
Adhérent @RSouveraine #KUZMA2027";6340;365;476;23434;30615
pascalco64160;pascalco64;;22536;294;183;7599;30612
HyacintheKABUY1;Hyacinthe KABUYA;libre penseur, chercheur, patriote et juriste.;14111;1468;1488;13525;30592
Pigoum;nofate;La liberté et l'intolérance des uns s'arrête là où commence celles des autres.;21397;525;166;8483;30571
Rauta_Yrtti;Rauta_Yrtti;;6180;556;30;23802;30568
Tasmanian1958;Tasmanian;Deux oreilles et une bouche...donc on doit écouter deux fois plus que parler;10038;200;183;20118;30539
clemencecailla1;clem;nation arc-en-ciel;4057;695;467;25288;30507
plustard55;Ge Li;;9609;116;115;20653;30493
dFoFair;dFoFair;;12954;441;363;16708;30466
_mind;mind Media;mind Media est une lettre spécialisée sur l'économie des médias, de la publicité en ligne et de l'adtech  |  Editeurs médias, régies, agences, marques;15733;4131;10001;594;30459
CCI_92;CCI Hauts-de-Seine;La CCI Hauts-de-Seine, partenaire du développement des entreprises et des territoires des Hauts-de-Seine #PME #innovation #numérique #fintech #financement;16626;729;10225;2876;30456
MoniteurAutomob;Le Moniteur Automobile;1er magazine et site d'actualité auto en Belgique. Retrouvez ici le meilleur de nos articles, essais et reportages. moniteurautomobile.be;28398;76;1960;9;30443
ANESTAPS;ANESTAPS;Association Nationale des Étudiants en #STAPS (Sciences et Techniques des Activités Physiques et Sportives) - Agréée JEP - Membre de @La_FAGE;12023;858;8247;9310;30438
____Zen_______;Zen;;10491;539;140;19257;30427
Francchretien;Union pour La France Libre;Chrétien Français souverainiste, libéral et national fier de la France qui est le plus beau pays du monde et qui doit rester la France Libre et Victorieuse !;14557;463;142;15259;30421
Conseillerca;Conseiller.ca;"Conseiller est la principale ressource en ligne des conseillers en services financiers québécois. 
Pour s'abonner : conseiller.ca/abonnement";24150;1543;3093;1635;30421
yvesjordan16;yves jordan;indépendant & producteur;5329;282;140;24669;30420
annelisebth;Annelise Bth;JRi de bureau #métierpassion .tv @francetele // team @Cuej_info // Fan de pop / collage / séries / littérature;15008;398;596;14413;30415
AMDucroux;Enjeux de l'environnement;Présidence commission #environnement d'acteurs de la société civile Le CESE France. Gouvernance Convention citoyenne pour le climat. CNTE, CNB. 2010-2021;20213;4949;4336;910;30408
ClaudeRoze;Pierre Claude Roze;Pour que le pays des droits de l'homme LE RESTE !;14369;1004;663;14364;30400
JeremieLandreau;Jérémie Landreau 🌏🌳;"2TCO2eq/personne.
Préservation de la biodiversité. 🚴‍♂️
Éloge d'une ville plus lente.
Adjoint au Maire de #Pessac ☘️
Réinventons le #radicalisme";14152;1700;2654;11869;30375
PatesRiches;Pâtes riches;#Bourges #velotaf;6375;288;57;23651;30371
dzu251;Hoang Quy-Luat;Graphic Design & Web Development + MyLine & TienDaï ArtStudio ► linkd.in/NwL1rn;20931;2175;1647;5613;30366
NaviRadjou;Navi Radjou 🇮🇳🇫🇷🇺🇸🌎(நவி ராஜூ);Top 50 Global Management Thinker. TED Speaker. Coauthor: Jugaad Innovation (250K copies sold). Frugal Innovation Expert. Keynote Speaker. Indian+French+American;12488;2747;10006;5116;30357
sofiagaluka;mmefonfec;"Prof vintage ; fait cours au tableau ; lit des livres en papier ; so eighties...";23136;325;265;6627;30353
greg_leblond;Greg Souchay;"Porte-plume de l'actualité en hyper-ruralité. @pigist
Energie, climat, environnement, et humour aligoté sauce aigre-douce
📷 David Richard";20253;1078;2387;6619;30337
MilhommeO;Olivier Milhomme;Journaliste;16708;4957;369;8300;30334
CentraleLyon;Centrale Lyon;Une école d'ingénieur généraliste au cœur de l'innovation;11313;616;10989;7412;30330
Mamedi_Diarra94;Mamédi 👨‍💻🌿;💻 Élu aux #NTech #OpenData à #Vincennes | 🎓 #Droit @SorbonneParis1 |👥 Engagé #Jeunesse, #Éducation, #ProtectionDeLEnfance | BN UDI Jeunes |🤝 Pdt @Repairs94;12493;1217;1199;15420;30329
B2Bolo;Barthelemy Bolo;Compte personnel. Conseiller presse et communication de la Maire de Paris @Anne_Hidalgo.;12260;3472;4494;10086;30312
SleemanNatalie;Natalie Sleeman;First Counsellor/Head of Sector Trade @EUinSwitzerland. JustDance aficionadağ. ğªğºğ¨ğ­trade, facts&figuresğğ. Tweets IMHO. RTâ endorsement.;2526;1224;482;26065;30297
DamasNick;mawus Bagheera 🐆;"#LibertéDePensee #Africain #PSG 
dev. socio-economique, finance; AgroBysness, info socio-politique et nvle technologie.🇧🇯 🇧🇫 🇬🇭 🇹🇬  🇨🇮";12292;2272;1272;14458;30294
VbV75011;VBV75011;;15503;359;167;14245;30274
RosemondePommi1;Rosemonde Pommier;L'énergie éolienne plus on la connaît moins on l'aime.;14297;360;249;15365;30271
birman_fabrice;Fabrice BIRMAN;"L'individu est handicapé en se retrouvant face à face avec une conspiration si monstrueuse qu'il ne peut croire qu'elle existe.
J Edgar Hoover(Directeur du FBI)";17058;935;386;11877;30256
DanielCoteGaspe;Daniel Côté;Père de jumeaux, fier Gaspésien, maire de Gaspé, préfet de la MRC Côte-de-Gaspé, président ex-officio de l'UMQ;10584;1532;2220;15889;30225
UT3PaulSabatier;UT3 Paul Sabatier;"Une universitÃ© ð
PrÃ¨s de 37 000 Ã©tudiantes et Ã©tudiants en sciences, santÃ©, sport, technologie, ingÃ©nierie 
68 structures de recherche ð
#UT3 #UT3PaulSabatier";9848;1084;11003;8235;30170
Josefabionaranj;Josè Fabio Naranjo M;;18614;4992;1275;5281;30162
wissemtweet;Wissem;ð¤  mÃ©dias â¢ serpent dans la botte â¢ founder @dlpreport;10061;987;1309;17793;30150
the30man;Charles Diers;Adjoint aux sports @Angers / Alumni @ESSCA_Ecole / Co-fondateur @LaDalleAngevOFF / Ex-footballeur @LFPfr;10104;1251;5988;12804;30147
SMKvertetbleu;Scott McKay;Écologiste de coeur et de raison, toujours à l'affût de solutions innovantes et pragmatiques. J'ai vu passer de l'eau sous les ponts...;14669;1166;830;13475;30140
IsabelleIdec;IsabelleðIdecð¸ð¨ðµð¿ð;"Dans notre monde qui s'uniformise sans retour, tout ce qui est unique devient plus prÃ©cieux de jour en jour. Stefan Zweig 

â¨ï¸Pas de message privÃ©. Mercið«";8546;1410;1214;18968;30138
PrinceRodgersN;Prince Rogers Nelson;Dearly beloved, we’re gathered here today to get thru this thing called life;9697;185;269;19984;30135
energycities;Energy Cities;The European learning community for future-proof cities;12176;1039;12169;4734;30118
Taaaataaaa6;Taaaataaaa;Pas super jouasse au niveau du vivre-ensemble.;10676;1249;1839;16341;30105
batiweb;Batiweb;Le RDV quotidien des pros du BTP! Toutes les infos du Bâtiment et de la Construction : Solutions et innovations, interviews, dossiers spéciaux, législation;10919;1440;13905;3838;30102
LLafreux;Lolito Lafreux;;1441;152;31;28466;30090
Tonton_Mahamet;Tonton Mambé;"Economic Analyst
Business Analyst
Political Analyst";11902;761;1992;15418;30073
MMary58851297;M. Mary;;7452;803;681;21126;30062
gilgeorges2;Georges Gil;;23956;4997;1037;71;30061
Ace15Asso;ACE15 La culture à Paris 15;#ACE15 est l'Association Culturelle et Événementielle du XVème #Paris15 🎂 2005 #JournéesBrassens Prix littéraire Georges #Brassens ❤ #JournéeDesCollectionneurs;8707;4949;2627;13759;30042
BabenSoro;Baben Soro ð¬ð³;"Compte indÃ©pendant qui partage de l'actualitÃ© dans divers domaines.
DÃ©fenseur de la dignitÃ© africaine âð¿.";7779;321;4119;17817;30036
ufoflyings;❌Zone 51🇵🇸;Pro-Palestinien🙏 🇵🇸;26426;927;1627;1038;30018
CapitaineFlam14;Capitaine Flam đ;Un gay normand parmi tant dâautres. đłïžâđ aime discuter, la politique, contre les extrĂȘmes et a le meilleur chien du monde Natchođ;8918;847;3278;16963;30006
NodibL;Nodib Liam;Macron on t'emmerde;21916;141;94;7816;29967
Gibertdidier;Didier;;21041;255;188;8477;29961
AtelierHGSempai;Atelier HG Sempai;Ici, on cherche, on bricole autour du cours d'Histoire-Géographie;19018;957;2456;7515;29946
AMIF_asso;AMIF;Association des #Maires #IleDeFrance - Président : @beaudetstephane;9072;5078;12678;3116;29944
B_Bernard73;Brice Bernard Ⓜ️;Conseiller régional RN #Auvergne #Rhône #Alpes • Délégué departemental RN #Savoie • Entrepreneur et commercial;7020;771;2800;19325;29916
Maxmascoli;Maxime Mascoli;Journaliste à L'Union d'Epernay. Passé par Châlons, l'Ardennais Sedan et La Voix du Nord. Musique, jeu vidéo, actu locale et rage. Mes tweets engagent Beyoncé.;15479;740;458;13231;29908
WorldUniService;WUSC - EUMC;;9657;1873;10525;7828;29883
denver1416;denver14;Le Terre Neuve possède la Beauté sans la Vanité, la Force sans l’Insolence, le Courage sans la Férocité, et toutes les vertus de l’Homme sans ses vices.;16553;0;94;13187;29834
spafr4;spa_fr;Agence de presse saoudienne;11142;9;18681;0;29832
NewsExplorerFr;NewsExplorer.FR;Application de revue de presse et de veille informationnelle nationale et internationale, informations étrangères traduites en français;29760;0;43;0;29803
Carol_Ann101;Carol-Ann Beaulieu;Enseignante au secondaire. Passionnée d'histoire. Actualité, politique, voyage etc... Native de Sherbrooke;28005;844;497;407;29753
pabloboyca;Lsks;;1745;511;84;27381;29721
dubelisa1;lisa@dubđšđ”;"Une FRANCE plus forte, plus unie, plus apaisĂ©e
#EMACRON";14338;1258;859;13209;29664
mondedesgeu;Monde des Grandes Écoles et Universités;Des informations premium au cœur des campus et des entreprises #recrutement #étudiants #RH #management #pédagogie #campus #grandesecoles #universités #dirigeant;15569;1048;8056;4982;29655
NinoDvm;Nino 🇵🇸 🏴‍☠️🇩🇿;عندما قلت لله كنت خائفة منه قالوا لله إنهم خائفون مني;2566;603;294;26179;29642
Sovanna_Sek;Sovanna DivOption Zen;Fondateur de DivOption Zen. Rédacteur #Bourse #actions #crypto. Make #Dividend Great Again;22091;1348;4255;1936;29630
Victor_obrt;Victor;"""un Homme c'est une bouche mais c'est aussi deux bras""";3528;675;65;25340;29608
Vincent_Oni_XG;Vincent / Oni;Amateur de #jeuxvideo, #goodies #comics, #mangas, #gastronomie et accessoirement rédac chef de @XboxGamerNet // rédacteur/critique depuis 18 ans;11055;358;1011;17177;29601
MontaudPro;MONTAUD Andre pro;"This account was my pro global survey tool on robotics and mechatronics for 10 years. Still open for time to time.
Join also my personnal twitter : @montaudlive";26064;135;2257;1107;29563
heureux_raleur;Heureux Râleur;"ex: IIIè Rima - Commando Marine.
Sò a Corsica di Corti, aduttatu i Rennes.
Semu bè in FRancia.
#FNRN #LFI #GJ #CGT sont les fléaux de notre pays !";22515;248;485;6307;29555
giofil1961;giovanni filippo;"Ancien du Palais Brongniard
#PassionAT
#DéfendeurCausesPerdues
#PourfendeurDAbus #1MondePlusÉquitable #TelleEstlaVoie #TelleEstlaFoi 🙏 #Veneto 🐈🇮🇹🇨🇵";18613;368;1503;9060;29544
franckboissier;Franck Boissier🔻🐧 📻 🎶 🐘;Co-président de @radioms93 | Créateur @ilotech_telecom | Militant laïque @Ufal_org | Président du Réseau @Educ_Populaire;23190;900;3217;2215;29522
Hamoudot_;Cupidon_;"Cupidon...ð¼ ð 
Pas Ãros...ð¥°
L'amour n'est pas un sentiment, mais un choix qu'il faut assumer devant tous. Aimer c'est tout donner et se donner soi-mÃªme.ðð";6882;599;508;21507;29496
SenRosaGalvez;Rosa Galvez;"Sénatrice du Québec, professeure (Université Laval), ingénieure civile
Senator for Quebec, professor (Laval University), civil engineer";12493;1811;3333;11848;29485
Destain131;Destain;Vita Peregrinatio Fugaces Dies;11423;441;171;17442;29477
SylvieBrot;Sylvie BROT;"Conseillère municipale d'opposition @VilleRamonville #Ramonville &  @Sicoval31. 
PRAG @UT3PaulSabatier. 
Maman x 2. 
Mes tweets n'engagent que moi.";11555;1447;1848;14614;29464
PPCKCR;PPCKC;Official Account for the People's Party of Canada for the Kanata-Carleton Riding.;27794;233;1344;69;29440
missionhaitioas;Mission d'Haïti à l'OEA;Notre mission: défendre les intérêts d’Haïti à travers les différentes structures de l’Organisation des États Américains.;811;1085;27427;106;29429
UnEmpiriciste;Un Empiriciste;"""Tintin avec une veste en cuir"" | Evidence-based policy et Scepticisme | Economie, Santé, Environnement | Par @LouisFreget (ENGLISH), doctorant en économie";6356;5002;4262;13808;29428
jeffou232;Jeffou/Cékado 🐢✌️✌️;infirmier, préserver et contempler la nature.;3398;626;250;25144;29418
miguel83033343;miguel;;3632;24;51;25694;29401
zedka1976;zorgane ramzy;;9400;658;190;19142;29390
ANabiMussayab;A.Nabi Mussayab;Former Ambassador /specializes in political and economic Affairs;25597;1079;420;2265;29361
EuropeEnImages;Europe En Images;Web Tv sur l'Union Européenne et la vie des européens. Web Tv about European Union. europeenimages.net #europe Made in Europe, France, Bretagne, Saint-Malo;28485;318;484;66;29353
Mediarail;Mediarail.be - Rail Europe News;Observatoire ferroviaire. Ici pas de com' téléguidée, mais plutôt la libre pensée et les réflexions critiques. Opinions strictement perso. #railways & #realisme;17876;988;3682;6784;29330
InfoFlash_44;ð«ð· InfoFlash_44;"Informations officielles et alertes locales concernant le dÃ©partement de la Loire-Atlantique.
â¹ PrÃ©vention des risques et information des citoyens.";29043;7;227;0;29277
LEDIEUSPINOZA;HEGELOSAURE đź‡·đź‡Ş;Savanturier de philosophie;12666;2827;582;13190;29265
Sakho_Psg;Nick Kyrgios Stan;Le jour où Melenchon arrivera au pouvoir, la France connaîtra un déclassement rarement observé. Ici ça lutte contre ce gourou fais parfois des mêmes;14263;366;144;14489;29262
Abdoul_wahabHar;Abdoul-wahab Harouna Bayéro;"étudiant/ panafricaniste/ essayiste en économie, politique, théologie... 
je suis contre l'hypocrisie.  anti-LGBTQIA+etc...";8123;2072;500;18545;29240
AndrLaflamme5;Samuel D'Iberville;;14328;472;227;14171;29198
polymtl;Polytechnique Mtl;Compte Twitter officiel de Polytechnique Montréal #polymtl;9778;2137;12811;4470;29196
annesogruat;Anne-Sophie Gruat;;29094;37;42;0;29173
Ptyrandia;Ptyrandia;"Quelle différence y a-t-il entre un œuf et le temps ?
Le temps passe et l'œuf dur.";9686;713;76;18693;29168
goodbyefarew3ll;Goodbyefarew3ll;"Traître à la natation -
Terroriste intellectuel -
Influence la jeunesse avec tes impôts

#GaucheLaser
#ChauveLaser
@goodbyefarew3ll@piaille.fr";11335;594;295;16935;29159
DaoZak;Daoudi Zakary;"Drt Airector.
Spirit Crusher. 
Wlid El Bahdja. 
Dernier Soldat du Rock'n'Roll.";14595;200;1010;13336;29141
elhadjham;EL HADJ;"Simplicité
TRIM-TAB";17917;4976;1517;4728;29138
Ph_Demarquez;Philippe Demarquezð±;"Correspondant Parti animaliste (95)
Membre de L214, One Voice, SPA, ASPAS, Greenpeace 
#LesAnimauxComptent";2826;421;556;25302;29105
CIMorg;CIM.ORG;CIM is the leading technical society of professionals in the Canadian minerals and materials industry. #CIMTL23;13152;1096;8242;6606;29096
silicium17;Guillaume Liégard;Montreuil, Physicien, Esprit taquin voire légèrement fielleux;22587;2434;3855;216;29092
CfeDnr;fokker22;Responsable Engineering Aéronautique, ancien délégué syndical de l'encadrement. Pour une société éclairée et apaisée.;8895;1297;585;18260;29037
Lio_38;Lionel C.;ð Conducteur de trains & Moniteur ð ð¦ð¡ðð ð©ð¼ðð®ð´ð²ðð¿ð ð Paris Gare de Lyon ð Arras ð¨âð» Team ðªð²ðð¼ðð²ðð¿ð¿ð®ð ð¦º ðð;21781;856;1999;4351;28987
HazizaEmma;Haziza Emma;"Dr. de l’École des Mines de Paris. Hydrologist. Researcher in climate change adaptation and mitigation.
 ""Un degré de conscience"" sur @franceinfo chaque samedi";2637;2364;19025;4945;28971
stevo3milliards;Marine Macron;Agente de notation de la Macronie.;17470;301;169;11024;28964
LarissaMonvi;Monvi Larissa;Citoyenne du monde đ, lĂ©gitime Ă  aborder tous les sujets đ. lâhumain et son environnement mon combatđȘđŸ  Je dis ce que je penseđ§. #team alloco đ;12380;792;605;15183;28960
sliman04546556;Sulimanfranco;"Coronacircus.
piped.video/CS9OO0S5w2k";24380;973;378;3217;28948
fabricebant;Fabrice Bantuzeko Z;Lecturer at the Université Evangélique en Afrique (UEA) / Animal heath-Zoonosis and Aquaculture / Veterinarian parra professional and Animal lovers;4771;647;757;22763;28938
_Akanoa_;Noa;Vous pouvez retrouver mes anciens articles ici lafor.ge ð;17775;180;1480;9501;28936
Ctuncrime;Jean-Marie Dinh;Journaliste. De la culture à la politique ou l'inverse !;19759;1967;2406;4772;28904
ABPInfos;ABP;Agence Burundaise de Presse/Burundi News Agency à l'œuvre depuis le 25/06/1976. Quartier Asiatique, avenue des paysans n° 7, B.P 2870, e.mail: abpinfo@yahoo.fr;14212;482;13985;220;28899
kan_fary;Ibrahim Maiga 🇲🇱;Maliden kura;2361;211;475;25852;28899
persideelinda1;Perside elinda;Étudiante en médecine👩🏻‍⚕️Chrétienne et fondatrice de :Mikate by Perside,des beignets spéciaux mis à votre portée avec son goût délicieux/numéro +243901485229;7099;2538;10737;8516;28890
marchand2022;Gilles Marchand;Président d'Informations sans Frontières. France's best kept secret! Get France’s best incentives about the Future. Web 3D. Énergies vertes Innovation;2368;1681;400;24403;28852
PuraVida_4_Ever;Conrad Thomas-Collignon ğ²ğ«ğ¨ğ­ğ§ğ·ğ­;VP IT dans une ESN secteurs Fintech et Biotech, ex-expatriÃ©, single, curieux, sportif, plutÃ´t Keynes que Chicago boys ou pire Hayek. EcoÂ²(lo)-souverainiste.;14201;3478;2559;8609;28847
systemcruyff;Cruyff System;#GénérationX #Parisien #libéral #universaliste Pour le retour d'une Droite et d'une Gauche avec un cerveau, un cœur et des couilles.;17486;1024;290;10020;28820
MissBChaimae;Chaïmae Bouazzaoui שימה בועזווי;"Moroccan Diplomat🇲🇦
🇲🇦🇮🇱1st MoroccanWoman Diplomat in Israel.
Fmr. Advisor to H.E. the Minister on Morocco-U.S. Cooperation (2017-19) 🇲🇦🇮🇱🇺🇸";7758;1955;1473;17634;28820
JeffMpoyi;Jeff Mpoyi;Je suis sociable;11544;501;366;16403;28814
SlimanSense;Juste Rafaleur;Ultima ratio regum;2596;684;71;25461;28812
MISSONNIERANDRE;André Missonnier ♦;"Parce que les idées ne sont pas faites pour être pensées mais pour être vécues.(A.Malraux). Bureau @DroiteDDemain relation aux élus.
#NouvelleEnergie";8343;3826;2503;14123;28795
_mdcf13;мαтнευѕ ƒαriαѕ;Principal @mdcf_13;26835;799;1060;64;28758
imagesreseaux;Images & Reseaux;Pôle de compétitivité référent du #numérique | Réseau de + 250 membres en #Bretagne et en #PaysdelaLoire | Accompagne vos #projets de R&D #collaboratifs;12771;1296;7364;7324;28755
Azure_France;Microsoft Azure FR;Compte Officiel #Microsoft #Azure #Cloud. Suivez l'actualité et profitez de contenus exclusifs !;10717;1196;12916;3926;28755
Eric_Lecomte_;🇪 🇷 🇮 🇨 Lecomte 🇧🇪🇺🇦🇬🇪🔻 CTRL+Z🇷🇺;#NAFO #Fellas #ITArmyUA;20947;564;3552;3682;28745
EnergiePartagee;Energie Partagée;Mouvement national de l'énergie renouvelable citoyenne. Ensemble, accompagnons et finançons la #TransitionEnergétique ! #EnergieCitoyenne #EnR #FinanceSolidaire;9213;2838;11929;4761;28741
AzouaghSid;Sidtrading;manager , coach sportif et trader;20498;316;6561;1359;28734
ced_maurin;Cédric Maurin;"Prof H.G. en lycée, 
Doctorant à @LettresSorbonne
thèse sur Théophile Roussel (politiques hygiénistes et sociales au XIXème) Humaniste, européen convaincu";12683;1772;3954;10322;28731
AsterTKi;Aster;;21222;603;108;6764;28697
FojePa;jean Paul FOSSO;;17049;4992;397;6229;28667
ClementGdre;Clément 🌱🌻;"Salarié dans une exploitation agricole, passionné d'agronomie et de grandes cultures ! Fan de sciences 
#ACS #FrAgTw #AgriculteurEnDevenir #NoFakeScience";8282;682;515;19123;28602
Perrin_Cam;Camille Perrin;Working on all things #food @beuc ð. ð«ð· in ð§ðª. Views personal, RT = interesting. @Perrin_Cam@eupolicy.social on ð(she/her);12350;2467;3502;10270;28589
JoeKa007;Joe K;Entrepreneur et Ingénieur Informaticien.;10243;5003;782;12561;28589
cdiakite1;Alassane Diakite;African, curious about life and the world.;6393;515;469;21195;28572
yonalua;çara;☾︎;3693;486;15;24346;28540
Imrann46002499;Imrann;;10116;628;388;17354;28486
LEKUONADomenja;Lekuona Domenja;"Ràdios: Pireneus StAffrique Verdon Occitània Noscultures Hapchot Capacap #occitan #Bearn #PQVNL #hadiu
facebook.com/lekuonabaris #legislatives2022";19784;681;943;7074;28482
voixdunucleaire;Les Voix du Nucléaire;Association citoyenne engagée pour le climat 🌍🌡️, enjeux énergie 🌃👩‍🏫 & autres applications de l'atome ⚕️🔬🌾🛰️ @voixdunucleaire@mastodon.cipherbliss.com;6779;783;17543;3370;28475
poggi_robert;POGGI Robert;Directeur à l’Action Régionale EDF en Bourgogne-Franche-Comté #TransitionEcologique @EDF_BFC;11202;146;557;16562;28467
sebastien_pays;MoreAwesomeMetal;;12704;176;190;15390;28460
odelphine;Delphine O;French ambassador 🇨🇵 @francediplo and Secretary General of the #GenerationEquality Forum. #genderequality and women's rights ♀️.;4723;1423;9967;12342;28455
AssnatQc;assnatqc;Travaux parlementaires, projets de loi, nouvelles et communiqués de presse : pour tout savoir sur la politique québécoise! #assnat;6470;270;21452;215;28407
stefdbk;StÃ©phanie Dembak-Dijoux ð»;"Adjointe Paris 19e #ESS #Circulaire #NumÃ©rique. Membre de la direction d'#EELV ð
Ex CheffeCab prÃ©sidentielle 2022 et AssNat. 
Boulot NumÃ©rique et Finance";10032;1652;2459;14205;28348
unjour1chasseur;Un jour un chasseur;Suite à la mort de notre ami Morgan Keane, nous avons créé cette page pour recueillir & relayer vos témoignages de comportements abusifs liés à la chasse.;3512;406;17600;6820;28338
loder_shawn;Shawn Loder;"J'suis Spécial! Le francais pas ma force.
'L' avantage d'être intelligent es qu' on peu facilement faire l' idiot, alors que l' inverse reste impossible'";19117;83;162;8973;28335
undefin15445393;Alix 🏳️‍🌈 🏳️‍⚧️;;6412;57;64;21787;28320
sampayapiou;Piou☠PSG;moi j'annonce le chaos et tu sais ce qu'il a pour lui le chaos ? Il est impartial.;14454;927;253;12680;28314
jpaccart;jean-philippe accart;Responsable Bibliothèque Sciences Po Reims @ScPoReims. Franco-Suisse. #Information #Documentation #Formation #Enseignement #Consulting #Conférences #Livres;21769;806;3834;1901;28310
MrMarlowe69;MrMarlowe;un économiste libéral au XXI siècle c'est comme un cuisinier qui ne fait  que des bigs mac il sait que c'est pas bon mais ca se vend bien  Droit social;9905;623;212;17537;28277
Bouygues_Immo;Bouygues Immobilier;"#BouyguesImmo, concepteur de lieux de vie engagé pour une ville belle et respectueuse de la planète, où les usagers vivent en harmonie.
#LaVieCommenceIci 🏘🌱";6620;1065;17901;2682;28268
Journal_Auto;JournalAuto.com;Le Journal de l'Automobile est le titre de référence des professionnels de l'Automobile depuis 1979.;20573;651;6799;238;28261
AndreGanan;dry Sunshine;"La bourgeoisie nous marche dessus...

Et le fascisme attend son tour";4288;889;923;22139;28239
YaourtNutrition;Yaourt & Nutrition;"Retrouvez ici l’information scientifique sur la place du yaourt dans une alimentation saine et durable. 
Par l'Institut Danone International & l'ASN.";5639;4322;13561;4717;28239
mineminees;Laura GO News local Lille;"Les news Pokémon GO sont ici !
Elle/She 🏳️‍⚧️🏳️‍🌈 
Code créatrice Epic Games/Fortnite : mineminees
Vous êtes de Lille ? Rejoignez la commu sur discord !";15338;859;3064;8946;28207
democraquoi;democraquoi;;21927;521;483;5254;28185
concordefragile;Vidocq;que justice soit rendue;20923;2739;2047;2467;28176
ajeasso;AJE;L'Association des Journalistes de l'Environnement forme ses adhérents et les aide à exercer leur métier dans les meilleures conditions. Adhésion ajeasso@free.fr;10661;8464;7699;1351;28175
pquirion1;Philippe Quirion;"Chercheur CNRS au CIRED (@cired8568) en économie.
Climat, énergie, environnement.
Researcher economics. Energy, environment, climate change
@pquirion@piaille.fr";5731;696;4214;17528;28169
Graphseo;Julien Flot;Trader passionné depuis 2006 : Mon Histoire, trades et conseils graphseobourse.fr/graphseo-e…… Mes vidéos piped.video/c/JulienFlot #bourse #trading;11753;440;12496;3477;28166
Amb_Delattre;François Delattre;"Ambassadeur de France en Allemagne
Französischer Botschafter in Deutschland
🇫🇷  🇩🇪  🇪🇺 @FranzBotschaft 

Former French Ambassador to the U.S. and the U.N.";1806;1186;4273;20888;28153
WokaMoka;WokaMoka 1+1+1+1;;15296;326;140;12365;28127
mxguydr;Vånīsh The Blēåch;étudiant 3ème année IMT Nord Europe (Norvège) - expert sportif (Haaland envoyé des dieux) tu koné et bien vu - vrai numéro 10 et démon - trouveur de pépites;4632;556;84;22844;28116
CorwinAmbre92;Corwin d'Ambre;;14512;1051;478;12069;28110
ScottRobert1959;Scott Robert;"Pragmatique et réaliste.
Ni Maîtres, Ni Dieux
🇪🇺🇬🇧🇮🇹🇧🇪
Parfois moqueur ou truculent... 😎";19167;426;311;8193;28097
ELCHEAPO16;🏴‍☠️ EL CHEAPO 🏴‍☠️;Victimizer extraordinaire, people person, not taking crap from anyone, lovable yet direct, but above all a person with a plan and not afraid to use it!;14215;161;380;13330;28086
MartineDumas4;Martine Dumas;;12879;147;35;15022;28083
ETshisekediste;Emma Tshisekediste;analyste politique, cadre du parti politique Alliance pour le Changement A.Ch;4578;1977;4711;16799;28065
romain_wims;Romain Wims;Investisseur, solopreneur & banquier. De 0 à 10K€ investis en moins d'un an. En route vers les 100K. J'aide les jeunes à commencer à investir sur le long terme.;1477;69;25679;838;28063
CamaradePangu;Camarade Pangu;;1109;668;31;26236;28044
AnnuaireMaroc;Annuaire Maroc;L'annuaire francophone FranceSurf ouvre ses portes aux sites internet du Maroc: francesurf.net/maroc/ #Référencement #Maroc;18348;3145;6546;0;28039
erasmus7187;Stéphane Reix;"Prof HG EMC en détachement. DAC @canope_87. «la loi défend la foi aussi longtemps que la foi ne prétend pas faire la loi"" A. Briand";16135;678;267;10959;28039
Lescegeps;Lescegeps.com;Notre mission est de mettre en valeur le réseau d’enseignement collégial québécois : ses contributions, son histoire, son rayonnement et ses réalisations.;25110;224;2699;2;28035
gharperkelley;Gregory Kelley;Proud Dad/ Député de Jacques-Cartier / MNA for Jacques-Cartier/Libéral/Packers🧀/Habs/Raptors;9022;4702;4702;9590;28016
troublemagma;Simz;"Je suis l'altruiste, lyriciste, qui fiste, les fils de Cyber-Aquabonniste, ma force est dans cette liste
J'résiste, j'assiste, influence dadaïste ....";5899;114;38;21951;28002
MercedesAMG30c;Sylvain.;Enfant de la Lorraine, Résistance est mon ADN. A la reconquête de notre France 😉 Membre Places d'armes.;9195;1225;886;16673;27979
Vincent_Cz;Vincent Czeszynski;Partner - Conseil en stratégie #Transport #Climat #Energie #Economie #Politique #NouvelleEnergie (Ces tweets n'engagent que moi);14953;1008;1267;10740;27968
Gustavo58413026;Gustavo David - Les messagers Hugin et Munin;"Une mauvaise paix vaut toujours mieux qu'une guerre sans espoir (Zweig). Chaque pas fait contre la liberté est un pas fait pour la guerre (Bernanos)
 🇷🇸🇭🇺";18230;1864;1422;6443;27959
OilIndiaLimited;Oil India Limited;Official Twitter handle of Oil India Limited (OIL). A fully Integrated National Petroleum E&P Company under Govt. of India.;4223;282;23120;331;27956
7_xibar;7Xibar;La nouvelle grande chaîne;27830;16;38;64;27948
Maeva06;Maéva Guims;"Ca tweet sec par ici !!! #SerieAddict and love @beyonce //
Young & Wild &Free !!!";12054;446;171;15271;27942
no1knowssss;Moon2 Morrow;Ł;5159;311;104;22359;27933
ElisabethLavill;Elisabeth Laville;Founder & Chief Entrepreneur @Utopies_Paris @Utopies_Bdx @Utopies_Brasil @MesCourses_PLP @CampusResp Proud to be the 1st @BCorp_fr;7535;4546;7570;8275;27926
VDNMaubeuge;VDN Maubeuge;L'édition de Maubeuge - Le Quesnoy de La Voix du Nord est sur Twitter !;23072;493;4224;106;27895
m_blm_tw;MhD;Amor Fati !;8135;1391;797;17570;27893
LucieFair666;𝕷𝖚𝖈𝖎𝖊𝕱𝖆𝖎𝖗;"Hell is carved with good intentions
She / her / Together let's jinx the world by carrying the light #economist #war #crypto #osint #NeutralEvil";13390;1658;433;12393;27874
sblanc66000;Sophie BLANC;Députée #RN des Pyrénées-Orientales |Conseillère Régionale|Avocat | Docteur en droit| ex.adjointe à l’éducation|@AN_AfCult |@louis_aliot |@MLP_officiel;8813;3840;5750;9468;27871
Destimed;Destimed;Journal d'information numérique, méditerranéen et citoyen;18898;2812;5918;221;27849
JeremieMartin7;Jérémie Martin;Engagé pour #Hendaye et @kottebask / Ex Région @Occitanie et @CaroleDelga;11625;1449;1151;13604;27829
LontermeE;Lonterme Emelyne;;13455;128;59;14182;27824
juu_lvt;juliette;ni patrie ni patron;6894;221;187;20511;27813
bdbdbdmoi;bdbdbdmoi;;19659;540;470;7141;27810
feeasso;FEE;#France #Énergie #Éolienne | L'éolien renouvelable, compétitif et créateur d'emplois | Représente les professionnels de la filière éolienne en France.;11912;1610;8700;5582;27804
Orange_Atomique;Victoria VALPARAISO;"ð§âðInflammation and Inflammatory Diseases   ð§âð¬Cellular senescence 
ð¦mainly about ð±ð¦ ð§¬ðï¸ð±ð¥ð¦µð©ºðªðºð¬ð§ðð¾ð°AIðâ¢ï¸ðºï¸ð·ðð¨ð¶";6767;998;134;19904;27803
Tourisme_Infos_;Tourisme Info;Toutes les informations sur le tourisme;27626;0;175;0;27801
websaison;Quentin Saison;un peu + journaliste chaque jour | @onperdlenord | @studiohanslucas | académie @esjlille | focus environnement;1471;2286;1658;22382;27797
brigcollet;Brigitte Collet;Pédiatre. Femme politique. Horizons #ADAPEI33 #AFPA #PetiteEnfance #Education #famille;13173;622;896;13106;27797
MPapianne;marie papianne;"đź‡şđź‡¦ #FreeUkraine
Enrichissez-vous ! Enrichissons-nous !";13985;720;311;12778;27794
VolnayCm;Volnay;"William Pitt: “Necessity is....the argument of the tyrants ... the creed of slaves""
Droit Musique Arts de la table - mes tweets 
n’engagent que moi";20535;3476;292;3487;27790
Quitt3rie;Quitterie de Villepin;Innovations démocratiques. Candidate indépendante #Législatives2022 2ème circo de Paris 5è, 6è, 7è mandat délibératif #délibération #AccorddeParis #ODD;9685;3214;5132;9743;27774
mairievitry;Vitry-sur-Seine;đ Compte officiel de Vitry-sur-Seine, la plus grande ville du @valdemarne_94;19350;418;4189;3801;27758
bitznarweb;ardent bitznarweb;Tout ce que je sais c'est que je ne sais rien, et encore parfois je l'oublie. Passionné d'actualités, presse, géopolitique, musique, cinéma, littérature.;6646;1635;1534;17918;27733
_H4mm3r_;Emmanuel McKinsey ☢️🇷🇺🇫🇷 🎈;Ceux qui optent pour le moindre mal tendent très vite à oublier qu'ils ont choisi le mal. Hannah Arendt piped.video/watch?v=Ok0czf…;12453;537;169;14560;27719
Fafrette;Richard Fradette;Professeur retraité de physique, d'astronomie et de météorologie, je développe et partage ma conscience objective, cosmique, planétaire, sociale et humaine.;24819;85;235;2579;27718
5ansdeplusEm;Guy Lemesre;macroniste de la première heure;1931;4999;2617;18142;27689
rlarvent;larvent rodrigue;la France est un paradis peuplé de gens qui se croient en enfer. S Tesson.;20680;387;110;6507;27684
AidonsM;Fin a la violence au 🇲🇱;Jeunes Maliens et Maliennes qui veulent encourager nos concitoyen/es a transformer leurs vies en obligeant l'Etat a gouverner pour l'interet general.;16239;346;6342;4745;27672
Hendouch87;Henda Fellah;Freedom of Expression & Transparency advocate| Resisting for a better Tunisia| Views are my own.;8763;3375;4114;11411;27663
CouleursParis;Paris en couleurs ð»ð²ðª¶;VÃ©lo, Patrimoine, Ecologie;8966;429;494;17749;27638
Danora10;yanora ð¨ðµ;"Vanne tout ce qui bouge.
a dÃ©vorÃ© tout Thiercelieux
Pour le non alignement.
A pour cauchemar le septemberprogramm.
ð£â  ðªðº / â¤ ð«ð·";14327;267;184;12851;27629
Allard_30;Allard 30;;17186;2123;227;8084;27620
Gauthierpierlu1;Pier-luc anti woke;;10897;337;341;16011;27586
LefranMartin;Martin Lefran;"Explorateur du comportement humain. Allergique à l'idiotie et aux conspi. 
Human behaviour explorer. Can't stand stupidity.";8110;526;282;18667;27585
SoucheColin;Colin Souche;Guide et animateur nature dans le Sud de la France, j'utilise Twitter principalement pour m'informer.;2053;787;45;24693;27578
GautierWeinmann;Gautier Weinmann;;14921;327;623;11691;27562
x_delcourt;Xavier Delcourt;anachorète  (ex- prof des universités- Strasbourg - CUEJ: responsable Dess eurojournalisme et enseignements européens 1990-2015) Femme, Vie, Liberté;24814;927;1114;701;27556
Hanabi63;Takeshi;Brel, Truffaut, Cinéma,velotaf,  @ASMOfficiel . Enseignant @UCAuvergne. Génération.s Mitterrand.;21009;209;179;6157;27554
rppola;Rose Pola Pricemou;Ministre du Plan et de la Coopรฉration Internationale ๐ฌ๐ณ;404;204;26167;767;27542
techbled;Techbled.com 🗺;Tech News from Algeria & around the world;11934;3128;2252;10216;27530
Montagnemnt;La Montagne Montluçon;Compte Twitter officiel de La Montagne Montluçon. Actualité de Montluçon et de ses environs.;22825;475;4061;159;27520
KiketteOver9000;KiketteđÏ â;;8074;4983;3231;11217;27505
elanja;elanja;@Bitcoin Holder @Dodge Holder  Freedom Safe... from imperfection is born the exception!! ð;22832;1192;419;3006;27449
mathieuklein;Mathieu Klein;Maire de la @VilledeNancy, président de la métropole du @Grand_Nancy.;9728;863;13412;3444;27447
MeloarFreilhec;Meloar Freilhec;Projet de reconversion agricole en production et transformation de PPAM et de fruits, en agriculture de conservation des sols (ACS). Petit-fils de paysan.;12983;1222;371;12864;27440
agribuzztv;Agribuzz;Le monde de l'Agriculture vu par le prisme des réseaux sociaux ! #Buzz #Agriculture;16567;2168;6246;2456;27437
BFDroulin;Bernard Droulin;"Quand j'entends ce que j'entends et que je vois ce que je vois, il ne faut pas s'étonner si je pense ce que je pense.
#NouvelleEnergie";6785;511;393;19740;27429
S_Ndour;Stéphane Ndour;Passionné d'innovation, de communication et de numérique I Dir. Développement & Partenariats @bpifrance #FrenchFab | #Industrie #F1 #Paris #Afrique #Climat;12645;1783;1714;11282;27424
BBalguissa;Balguissa;𝚂𝚙𝚎́𝚌𝚒𝚊𝚕𝚒𝚜𝚝𝚎 𝚌𝚘𝚖𝚖𝚞𝚗𝚒𝚌𝚊𝚝𝚒𝚘𝚗 𝚎𝚝 𝚖𝚎́𝚍𝚒𝚊𝚜 #𝙾𝚡𝚏𝚊𝚖_𝚊𝚞_𝙱𝚞𝚛𝚔𝚒𝚗𝚊 #𝙶𝚘𝙿𝚊𝚐𝚊 #𝙲𝚊𝚟𝚒𝚎 #𝙻𝚠𝚒𝚕𝚒 #TL226;5717;3942;6213;11549;27421
Souri_Cat;Sou_ri4;;11074;338;241;15764;27417
FadatCecile;Cecile Fadat đč;Ăduc SpĂ© Protection de lâEnfance -đčCN @partisocialiste - SF PS87 - Adjointe Maire Condat/Vienne - DS @CgtSanteSocial - CPH - đșïž Voyages đ„Ÿđž - Team @ol đŠ-;3637;1528;1138;21108;27411
Rochet112;Louis 🇫🇷 🇼🇫;Ex CPA 🇫🇷 CPOCAA « instruire pour protéger » Sicut Aquila 🐝✝️;21216;231;213;5746;27406
aymenibn_;ⴰⵢⵎⵏ أيمن ⵣ;;12224;381;229;14570;27404
EnviroMag;Environnement Mag;Environnement Magazine, média pour les professionnels de l'environnement, dans les entreprises, l'industrie et les collectivités;11214;350;11308;4523;27395
londeixp;Pauline Londeix;"Experte accès aux médicaments
Co-fondatrice @OTMeds
Combien Coûtent Nos Vies? @Editions1018
Sport #LupiRoma 
E ti vengo a cercare  🇮🇹 🌈 
contact@otmeds.org";12272;1434;4038;9646;27390
vinsos9;Bastos ūüíČūüíČūüíČūüíČūüíČūüíČ;;25049;882;306;1151;27388
hotdogsmayo;le malouin;post covid, vacciné et opposé au pass sanitaire;22248;375;179;4579;27381
Castrom16441323;Castro maria;;11387;14;28;15947;27376
N_W_O_OFF;NEW WORLD ORDER;Nous sommes à la veille d'une transformation globale;11866;4978;3089;7417;27350
BarOud18209248;Bar Oud;;19347;94;70;7810;27321
Saladin82;Saladin82;"Sûreté de Concert & Tournée.
Protection & Accompagnement.
Gestion de Foule, Transport de Fonds & Valeurs.
Conseil en Sécurité et Sûreté.
Commerce International.";12667;569;199;13873;27308
___Sameer______;ⵙⴰⵎⵉⵔ;#TEAMOM;21867;343;86;5005;27301
youmatter_fr;Youmatter FR;"Il est temps d’agir pour notre avenir. Youmatter est le média pour ça.
#Climat #Santé #Écologie #DD #RSE #Éducation

Echangeons@youmatter.world";7287;3432;11665;4913;27297
PhilippeThomazo;Philippe Thomazo;Journaliste à Transitions & Énergies, trimestriel consacré à la transition énergétique et ses enjeux.;16535;742;776;9242;27295
Bloups9;Bloups;"Les gens sont de plus en plus cons, et moi aussi...
Vivement la fin des cons !
Ne jamais prendre les gens pour des cons, mais ne jamais oublier qu'ils le sont !";12459;240;41;14554;27294
CalvoConstant;Calvo Constant;Conférencier, Expert, Sciences Sociales, RSE, Développement Durable, Stratégie, Executive Coaching, Management, Communication, Leadership, Changement. bilingue.;22212;1632;1750;1696;27290
lilou_siba;Lilou DIESSE;Révolution de ma conscience en cours! Élévation, spiritualité, je suis branchée sur du 432 Htz, je me préserve de toute attaque extérieure 💖, je suis Diesse💫;7443;1354;763;17728;27288
stephanehis;stephane his;Consultant climat énergie, rédacteur l’Usine a GES, ambassadeur Association Finance Responsable   #climate #RenewableEnergies #energy #energie #GreenFinance;14371;646;1015;11252;27284
sophie_maze;Sophie Mazé;;25249;156;170;1665;27240
RCFLyon;RCF Lyon;"Votre radio locale RCF à Lyon et sa grande région : bienvenue !
 DM ouverts / 📨 contact.lyon@rcf.fr / 💻 rcf.fr";18291;1546;4966;2423;27226
danlert;Dan Lert;Maire adjoint @Paris en charge de la transition écologique, du Plan Climat, de l'eau et de l'énergie. Président @EaudeParis. Élu écolo du 19e arrondissement.;8031;2720;5968;10486;27205
EchosParisien_E;Les Echos Le Parisien Événements;Créateur d’événements qui vous donnent les clés pour agir ! ✊ @GoEntrepreneurs @CommonGoodSmt @InclusivDay @GrandOcean @ForumAsso @MediasEnSeine @InvestirDay;12703;4833;6399;3261;27196
TorreAndr;André Torre;Socio-economist, territorial development, proximity, conflict. Socio-économiste de l'espace et des territoires. Proximités, conflits,  développement territorial;6159;3839;3732;13458;27188
PATATRAS03;PATATRAS;;10342;188;63;16506;27099
Gims_SIMISI;Gims_SIMISI ✊🏾;activiste, coach, libre penseur, analyste politique…;9760;552;904;15882;27098
SG_Maroc;Société Générale Maroc;"❤️ Votre #banque Société Générale Maroc : Actualités Corporate...
📲 Privilégiez les canaux de Banque à Distance";2711;77;23311;995;27094
ZaynDiallo6875;Diallo Ali Zayn Abidin;;26993;2;14;85;27094
SebastienBGY;Sébastien Baguerey 🇪🇺;#ComPol, storytelling politique & communication stratégique | ex-collab @europarl 🇪🇺| @PartiSocialiste 🌹Team #HenriEmmanuelli;9472;1576;1453;14586;27087
cgamboat;Cristina Gamboa;CEO @WorldGBC. Public advocate & collaborative climate action leader, #regenerative solutions & #SDGs @SAISHopkins Grad. Economist. Nature lover šļøš;5924;1220;2351;17586;27081
Nuke_Info;nukeinfo;;19855;408;537;6271;27071
ItteletI;ITTELET Isabelle;"Conseillère Régionale 
des Hauts-de-France 
Nord-Pas de Calais-Picardie
Vice-Présidente du Conseil Départemental de l'Aisne";3727;2920;1441;18974;27062
EBrocardi;Porte-parole des sapeurs-pompiers de France;Porte-parole et directeur communication des sapeurs-pompiers de France ð§ð»âð(((ð¥ððºð°ð)))ð Team #FedCom;3296;1132;14801;7821;27050
c3_d;C3D;Compte officiel du C3D (Collège des Directeurs du Développement Durable), association présidée par @FBonnifet. #DD #RSE #CSR - Suivez aussi #DirDD -;8452;2572;7880;8107;27011
SoubranneC;Céline Soubranne;@AXAIM #ESG #Durabilité #Climat #Biodiversité #Inclusion #Culture #Patrimoine #Livres #BD;10786;1830;4090;10285;26991
MaghribiHoor;Majid;;7838;672;499;17971;26980
Desv_Ben;opinions inopinées;Le libéralisme a atteint ses limites. Sortons du déni, prenons nos responsabilités./#environnement #RSE;17590;1164;415;7794;26963
QTennerel;Salade Chaude;;2101;162;12;24682;26957
robardelles;Robardelles;;16281;177;89;10386;26933
dieudelaparesse;Joël Fiset 🇨🇦;🇨🇦🇨🇦,😎👍✌️👋🇨🇦🇨🇦🇨🇦Le temps est sans importance, la terre est un souvenir pour lequel il faut se battre.;21510;958;326;4123;26917
DESANGOSSE;DE SANGOSSE;#DESANGOSSE innove et met en marché des BIO-SOLUTIONS. #Biocontrôle, BioFertilisants, BioNutrition pour pérenniser les écosystèmes agricoles #PositiveProduction;11392;2004;2769;10745;26910
AbdouRa37434885;Abdoul Ouedraogo;Agro alimentaire;3755;5021;498;17617;26891
fatseb25;Reggie;;3295;185;119;23264;26863
Cliff_Hanger__;Cliff Hanger;Mon ancien compte Twitter est déverrouillé après plus d'un an, suivez moi. ➡️ @ZodJames;11606;285;313;14657;26861
CatPouet;Pouet cat #Skatty ðð;"Compte secours cath - skatty61 suspendu par un troll perdu mes 700 abonnÃ©s merci a ceux qui se reconnecte.
Macron 2022";20089;352;285;6124;26850
MyriamVillert;Myriam Villert ð«ð·ðªðºðºð¦;Responsable de mission (pro.) l Community manager (assoc.)  instagram.com/MyriamVillert | AdhÃ©rente @Renaissance #Renaissance;6202;525;551;19564;26842
anna2smilab;Anna MOUNIER;Cofondatrice @smilab_Paris Formation/Coaching avec Sourire ð #ExperienceClient #IntelligenceEmotionnelle #ExcellenceRelationnelle ð²annamounier@smilab.fr;11044;829;1321;13635;26829
PChasseuil;Edward Drummond;"Professionnel de la peur
Vent contraire
Esprit triste conjuré
#followBackNUPES
#TeamPatrichiottes
#Requequette";10674;1983;1177;12985;26819
PascalTour;Pascal Tour;Co-Founder of Morgan Philips Group #Executivesearch #Outplacement #IT #informatique #recruitment #emploi #job #management;25447;357;467;538;26809
PatocheDes;Patachon des Garrigues;;12016;824;871;13088;26799
latest_1d;E;ð¬ð§¬ð¦ ð§« depuis 24 ans en milieu hospitalier ð¨ð¦ð±ð·ðð¬;8388;949;425;17012;26774
QuetzalBleu;Quetzal bleu;;4875;373;226;21295;26769
loryanesinger;Loryane Singer;"Actriceð¬ Chanteuseð¤ Auteure-Compositriceâ«
CinÃ©ma TÃ©lÃ©vision Musique
Showreel : vimeo.com/526756513
loryanesinger.com";14304;1641;1502;9321;26768
Alex60426525;Alex tremité;les réseaux sociaux permettent toutes les dérives 👎 injures = blocage. faites preuve de répartie ou d' humour surtout si nous ne sommes pas du même avis.;5897;762;237;19836;26732
Vavid1;David Viellard;"Gardez moi de la hiérarchie, mes élèves je m'en occupe

#viedeprof";15231;396;253;10844;26724
ONUGeneve;ONU Genève;Compte officiel en français de l'Office des Nations Unies à Genève (ONUG);15634;688;9061;1313;26696
Alain_Lerocher;Alain Lerocher;L'esprit fantassin n'existe plus, c'est un tort;14118;633;375;11550;26676
bernardsolidair;Bernard Thoquenne;"retraité bancaire
bénévole structurant de la 1ère ONG française de développement 
militant centriste MoDem-Alternative";23490;1141;548;1495;26674
WSide75;Faston75;rejoins moi sur ma chaine d’info snap:                              👻alpha-bravo92👻;20654;2060;334;3616;26664
grandzugzwang;Gustave Quesnel;Science, environnement, géopolitique, Je méprise tout les régimes autoritaires et leurs supporters.;6889;503;84;19154;26630
stanycombat;ＳＴＡＮＹ ＣＡＭＢＯＴ;Guitar leader @echelleinconnue Pelotari disgracieux Frappe aux murs des villes invisibles avec celles de More Abd el-Kader Makhno... auteur de «Villes Nomades»;12710;1773;469;11656;26608
stijipoltouk;Stiji;"ð¹ð³ 360Â° d'Anti-blanchitÃ©â¡ï¸â¡ï¸â¡ï¸â¡ï¸â¡ï¸

BlanchitÃ© = hÃ©gÃ©monie sociale, culturelle et politique blanche Ã  laquelle sont confrontÃ©es les minoritÃ©s ethnoraciales";16259;292;317;9733;26601
CafedeTassigny;Café Latte de Tassigny;"""Ça sent la poudre"" Jean 11,43. Troll mesquin d’après le Corse de Twitter. Amateur de parquets semi-récents. Descendant de Ronsard.";10601;324;125;15550;26600
DJuDPom;DJu;lawifi.fr chiffrer.info/;14165;707;137;11554;26563
Mister_Vass;Vass Soliotopoulos;They engineered the key of a virus, they favored the changes of the key-codes, they'r lowerin immunities...WINTER is Coming my friend... NON-CITOYEN est. 2022;3226;171;119;23034;26550
BSirsalane;Bouchra Sirsalane;"Ălue đ«đ· DĂ©mocrate & Humaniste | PrĂ©sidente @Femmes_Dem'ocratesđžïž| @NGDem_Live đ | Membre comitĂ© @TeamPlaneteđ | Coach & Formatrice 

đ#Puteaux #LaDĂ©fense";8755;1001;2013;14773;26542
MulyangaLuc;Jean-Luc Mulyanga;Chercheur, apprenant, curieux à perpétuité. #philosophie #théologie #écologie #sociologie #anthropologie #littérature #poésie;11447;796;1679;12618;26540
nelmaropi;OPI. Marianne­čçĘ­čçÁ­čç¬­čç║­čç║­čçŽ­čî╗;­čçŽ­čç¬­čç«­čç│­čç║­čçŽ­čçČ­čç¬;6796;378;71;19282;26527
salscha;CryptoPouffe de l'Espace;"đŽââ ïžđž
Je tente de rentrer en contact avec Elon afin d'envoyer Aurore BergĂ© en orbite đ«";4543;476;239;21257;26515
ChChiroux;Christelle Chiroux;"#Mediation Info #RSE @TF1INFO @LCI                                             
Auteure #Podcastsð#EXPERTESÃ laUNE #InfoEtVous";8561;1675;1801;14478;26515
eczozz;Edgar Zimmermann Ⓩ🇨🇵🌿;⚔️ Millitant à Génération Z et à Reconquête;9878;1817;4054;10765;26514
LudivinDivin;LudivinDivin;Whatever;17532;160;683;8113;26488
moloubakotty;ted moloubakotty;;11252;382;418;14429;26481
ReseauFCM;FCM;La Fédération canadienne des municipalités est la voix nationale des gouvernements municipaux depuis 1901. #munican | In English: @FCM_online;18806;1854;4497;1311;26468
uniscite;unis-cité;Association pionnière et experte du @ServiceCivique. Près de 10 000 jeunes mobilisés par an dans plus de 122 villes en France. Du bac-5 au bac+5.;9302;3038;8224;5898;26462
BLGLaw;BLG;We are BLG: Canada’s Law Firm | Nous sommes BLG, vos avocats au Canada;9223;485;8911;7833;26452
Darkduprey_HS;Darkduprey;Dédicacé aux champions qui ouvriront cette page pour vérifier le nombre d'abonnés car ils n'auront pas meilleur argument dans le débat;13249;45;40;13112;26446
mleeut;mleeut;"socialement non-fonctionnel‧le, trouble de l'affirmation de soi - nb - (iel/ça)

terrifié‧e par l'avenir du climat #xr #anticapitaliste #antipsy";7613;363;146;18299;26421
BailleulRomain;Le mec à la casquette 🧢🚀| La-Mine.io |;"👉 Co-Founder @La_mine_io : Hub Web3
👉 Web3 Advisor - Builder - Fundraiser
👉 Sponsor & Partner : Event @web3Lille";7870;2861;6373;9299;26403
Phil_zabel;Ti-Mé fatigué;Né d’une mère caféinomane, donc d’un père collateur ☕️;2849;287;148;23111;26395
JBHamonic;Jean-Baptiste Hamonic;Maire @Villepreux78 đ± | VP @SQY #MobilitĂ©s đČ| Pdt @AlecSqy | @PetitesVilles | RĂ©fĂ©rent #MobilitĂ©s @Amif_asso |BurEx @MoDem Pdt @MoDemYvelines |@leselusducoeur;14754;2242;2754;6632;26382
VINCIEnergies;VINCI Energies;Accélérateur des transformations environnementales I Accelerator of environmental transformations #VINCIEnergies;12767;592;7679;5325;26363
Cskeete;𝘾𝙝𝙧𝙞𝙨𝙩𝙤𝙥𝙝𝙚𝙧𝙎𝙠𝙚𝙚𝙩𝙚;Député de #SainteRose #AssNat. Ministre délégué à l’Économie. Ministre responsable de la Lutte au racisme. Ministre responsable de la région de #Laval RT≠👍🏽;12166;1959;4927;7295;26347
AlexSleepless;AlexSleepless;Musique, ciné, livres, comics, trolling de la start-up nation...;20853;1836;1096;2557;26342
kamdemjoel36;Joël KAMDEM🇨🇲;PLET en Construction mécanique // Ingénieur de conception en génie mécanique// Entrepreneur...;3303;298;331;22389;26321
LvRg13;Regorski;;14675;421;117;11108;26321
TARS9000;TARS ☣ 🏅;"nul n'est méchant volontairement (Platon)
Zemmourien,Mélenchoniste,Macroniste,Lepeniste et vert barrez vous. je ne suis ni A-politique ni aveugle.";14947;29;370;10974;26320
LesPatriotes_75;Les Patriotes Parisiens;"Compte officiel @_LesPatriotes Ă  Paris de @F_Philippot. 
La đšđ”, sa libertĂ©, son art de vivre, sa grandeur ! 
đ§ referent75@les-patriotes.fr | @DBP_LPatriotes";16483;205;2435;7196;26319
2030Pandemonium;Pandemonium 2030;"Fight against the Thruth Killers !
Fight for free speech !

Pour la liberté de parole et contre les tueurs de Vérité !";10904;1559;765;13088;26316
forbes_fr;Forbes France;Compte officiel de Forbes France - Actualités, Business, Entrepreneuriat, Economie, Management, Politique, Luxe et Lifestyle;9663;157;13370;3120;26310
CommerceCanada;Commerce Canada;Votre source officielle du gouvernement du Canada pour des mises à jour sur le commerce international. English : @CanadaTrade;14308;103;11721;146;26278
Atoffolet;Adrien Toffolet đȘ;"Journaliste sur les ondes. France Culture. France Inter. France Info.

Anciennement : Voxpop | Society | Jazznews | Binge Audio | France 4 |";8360;4906;3243;9754;26263
stephandrouin;Stéphan Drouin;La mission de @Tesla est d'accélérer la transition mondiale vers l'énergie durable $TSLA;5293;1304;704;18956;26257
__waxinggibbous;š«¶ćoverwhelmed erać;she/her;4423;141;66;21625;26255
davrhonealpes;MONTAGNON David;;13983;45;46;12178;26252
PJL_PPL_bot;Le bot des textes déposés au Parlement;Je tweete à chaque fois que le gouvernement / un parlementaire dépose un nouveau ⚠ projet de loi / proposition de loi. Codé par @malopedia. Lire tweet épinglé.;23537;3;2705;5;26250
selineVb57;selineVb;;15101;57;103;10980;26241
ELGRECOQC;Giannis;je suis Apolitique et j’ai un dégoût viscéral envers les politicos crasseux qui veulent contrôler nos vies 🖕🏼🖕🏼🖕🏼;8665;1060;400;16113;26238
cost_elo;cost elo;;2717;71;56;23390;26234
sebiseb;Sébastien Pillias;#TGV du 💙 @ancc - #music 🎶 & #surf 🏄‍ - Prof. de génie pragmatique à @AAuteuil - militant @CFDT engagé à la @FepCFDT - #anarchie en #macronie 🏴‍☠️ #athée;16791;1172;289;7971;26223
gytdmd;guyot D;;17453;121;713;7931;26218
KalambMoise5;Kalamb Moise;FONDATION MÈRE THÉRÈSA DE CALCUTTA;9238;5598;5757;5622;26215
CaroleCoupez;Carole Coupez;ð» DÃ©lÃ©guÃ©e GÃ©nÃ©rale Adjointe @solidLaique #Solidarite #Laicite #ECSI #Nevendezpasleducation ð©âðmaster #GESS #ESS sujet #militantisme - Je tweete pour moi !;5105;1551;1084;18473;26213
Linossier7;Benyoub - Linossier chérifa;Cheffe d’entreprise - Océanie influence & stratégies - #ESS #RSE #RSA Femme avec une opinion 😱 🇫🇷🇩🇿🇪🇺🇳🇨 #liberté #équité #sororité;9047;1696;1592;13868;26203
PascalMaurel;Maurel;Journaliste Pdt @Ortus_sante Pdt Grpe Santé @ScPoAlumni /Dir ThinkTank @UC2m1 #Santé #ContrePointsSante/ex DG Decision&StratégieSante-Grpe Profession Santé;14721;3443;3804;4200;26168
KaderToussaint;Kader Toussaint;La vie est un combat,sombrer ou s'élever!;2178;875;382;22724;26159
XB_Tiplouf;Baptiste s/o XB Tiplouf (en dépression);L’olympique Lyonnais ruine ma vie et ne là comblera plus jamais de bonheur L’OL❤️💙 #SV1👑 #MV1👑x2 Liverpool BB26💎,Pfut10 RBR❤️ #FB20🇫🇷;13305;1058;433;11360;26156
air_bulle;Bulle D_air;juriste travailliste;16170;949;207;8814;26140
Arkhs3;Head of Territory;;8959;440;78;16631;26108
acenergie;P.Dumoulin Acenergie;Coop. internationale France-Québec pour la transition écologique. Expertises-conseils MDE dans la francophonie. AMO tech. air comprimé industriel. VP ATEE HdF;12755;512;541;12290;26098
cynthiabash;Cynthia Bashizi N.;Journalist @radiookapi, mining specialist.Lecturer @ucbukavu Senior comms consultant Ex PressManager and spokesperson @WWF đź‡§đź‡Ş.Tennis lover.Tweets are mine;10241;2685;7091;6069;26086
montreuil;Ville de Montreuil;"Compte twitter officiel de la Ville de #Montreuil (93).

Pour signaler un problème repéré sur l'espace public,
contacter → Sesam bit.ly/32wk7e5";11270;874;10881;3060;26085
massetoc1;massetoc;;12315;35;64;13653;26067
labiche_david;Labiche David;#Conseillerrégional #NouvelleAquitaine #Maireadjoint #Châtelaillonplage #Secrétaire #départemental #LR17 #MembreBP #LesRépublicains #candidatlégislative2022;9342;874;1898;13950;26064
Morocco_UN;Permanent Mission of Morocco to the UN;;3999;599;20673;791;26062
alainauzet;Alain Auzet;Maire de Réau, vice-président @sdis77  🇨🇵  Maire bienveillant pour notre planète 🌍 (enfin j'essaie...);6064;4982;2096;12901;26043
gauchopathe;simple jeune socialo-occitan heureux d’être en vie;Why be racist, sexist, homophobic, or transphobic when you could just be quiet?;449;97;32;25461;26039
plutonj6;mucahit;arbitre, informaticien, militaire, policier, journaliste, psychologue, façadier, sécurité . À quoi bon ?;13285;348;148;12255;26036
HEC_Montreal;HEC Montréal;Établissement universitaire francophone dont les programmes d’enseignement et la recherche en gestion sont de renommée internationale. #hecmontreal;4382;2066;18310;1268;26026
frlinget;Frédéric Linget;"Redirection écologique 
Mobilité durable, vélo, vélotaf";11464;356;518;13637;25975
TGhassy;GHASSY TWITE;Homme persévérant;5898;3576;964;15530;25968
AntoineFarin;Antoine Farin đ±;Collaborateur Parlementaire đ @JRCazeneuve | @Renaissance | Ălu du Gers #Miradoux | Twitter perso | Â« Ensemble tout devient possible Â» đ«đ·đȘđș;4165;688;577;20529;25959
jg56_38;JG56-38;Breton d’origine, supporter du F.C. Nantes, qui a succombé à une Grenobloise. Déteste les politiques de tous bords et les cyclistes intégristes !;2260;49;83;23566;25958
pressadom;pressadom;"Suivez les Grands Evènementiels avec nous : Sports Mécaniques, Classic Cars et motobikes, Mode-Fashion, protection sociale, Actus, Architecture, photos.;";22272;2348;503;835;25958
GhostQB9;G;;7148;586;301;17908;25943
LibertyLoveFr;Liberty Love;#Studio #photo et #vidéo #artistique #pro à votre #service 24h sur 24 et 7 jours sur 7, uniquement sur rendez-vous. #StudioPhoto #Photographe #book #shooting;19472;4811;360;1283;25926
SDC_TCS;Service des délégués commerciaux;Aider les entreprises can. à trouver des débouchés grâce à du financement, du soutien et un réseau mondial de plus de 1000 délégués commerciaux. EN : @TCS_SDC;14603;1256;7154;2906;25919
villedemougins;Mougins;Compte officiel de la Ville de Mougins facebook.com/villedemougins/ instagram.com/villedemougins…;15204;316;4312;6071;25903
PrsPnm;4LeX;Supporter d’un club maudit. Virage Auteuil 1991 - PSG;17606;321;655;7306;25888
Quynh_Bui_;Quynh Bui;#RSE #DD #CSR #sustainability #ODD #SDG #ESS #climat #climate #climateeducation #innovation #positiveimpact #techforgood;3187;4137;799;17763;25886
tikibzh;Tikibzh 📸👮‍♀️🧑‍🚒👨‍⚖️🏅;certifié #TeamRobert #Team22 #TeamFedCom 🇫🇷;4812;471;844;19758;25885
TTF59;Thierry FAMECHON;Président du groupe associatif L'Observateur de Gondecourt. Ingénieur d'Affaires C.E.S.I.. ex-Chef de secteur commercial en PQR. Elu local avec délégations.;22426;527;341;2588;25882
leonmdt;Leon;Médecine, Musique et F1 en gros;7242;565;335;17740;25882
JeanPhi30896820;Jean-Philippe;ð¤¯Justice â et âð¿ð©¸â  vÃ©ritÃ©;10226;431;75;15133;25865
Marc_Mash;Marc;"Géologue-minier⛏️ / GIS & Modelling Specialist
Révolté 😡
#Kabiliste #Katumbiste
🇨🇩 🇿🇲";4932;852;492;19561;25837
baudler06;Baudler;Les médias c'est comme le Top 50, c'est inaudible et médiocre mais vous n'avez aucun effort à fournir... Ils se chargent de vous faire la programmation:)!;15792;744;569;8723;25828
arojule;juliette;// 13 mars N8;18873;133;265;6549;25820
Mvaaux_;Maxime Vaux #2;Compte twitter d'un citoyen dont les opinions vont de très à gauche (PCF des grandes heures) à très à droite (RPR 80's) en passant par tout l'entre-deux;3153;202;45;22414;25814
SebaGobert;Sébastien Gobert;"Journalist, Writer, Traveler. Former Head of the world news section @lalibrebe Focus on #Ukraine #Russia. Co-author #lookingforlenin & ""New York, Ukraine""";5270;1131;4666;14741;25808
ouriechi;At-Tilimsani;;16535;167;183;8910;25795
AsaniLonghe7;ASSANI LONGHE;Marié & Père des Jumeaux, Jurisconsulte, Défenseur des Droits Humains, Futurologue et Communicant du BUREC.;16021;2153;1311;6245;25730
CharlesAutheman;Charles Autheman;"#Media, #Migration, #Literacy, #BHR
ð¨ð»âð« @HECParis, @SciencesPo @PSIASciencesPo
Previously with @labdeshistoires, @voiceofwitness";9187;3810;2285;10446;25728
pat_bacc;Patrice Bacchin;Engagé pour la planète et contre les injustices. Citoyen et conseiller à #Aureville, enseignant et chercheur à l'université de Toulouse #UT3 @CNRS @LGClab;12631;6225;6266;567;25689
MenorOlivier2;Flo Breizhil 🎸🌟;Breizhilien 🇧🇷 #bzh, fan de Goldman 🎶🎸 et de Retour Vers le Futur. Là où on va on n'a pas besoin de route. Bola para frente.;7226;1341;907;16211;25685
OscarAvez;Oscar;journaliste spécialisé dans les transports;8717;41;74;16845;25677
ALLL2021;Alll;"singing in the rain
wandering in some political debates
#justice4pooraboveall";16191;256;93;9127;25667
ExceliaGroup;Excelia;Official account of #Excelia Higher education group in #Business #Tourism #Digital #Academy #ExecutiveEducation –  #EQUIS #AACSB #AMBA – In the top 50 #FT;10899;1261;9495;3989;25644
BoursetNath;Nath Bourset;;6128;138;61;19304;25631
TelegrammeGGP;Télégramme Guingamp;Le compte Twitter de la rédaction du Télégramme de Guingamp.;22734;309;2561;24;25628
mickaelberthout;Mickaël Berthout;"#sport #tourisme #patrimoine
🏛 Visites : Communes (224) / Monuments & sites (117)";5270;3266;363;16722;25621
cha_extranjera;Cha;Cha gérante S-F , MPWFr & DMWorldFrance.;19072;1423;91;5035;25621
Facci32620583;Facci ð¢;"Musicien. Musique Ã  l'image: 
musicafacci.fr/";11260;1258;1115;11982;25615
Pingu_pugnace;Pingu Pugnace;Manchot auto-diag, vieille ordure de père en fils;12576;371;240;12422;25609
RwandaCongo;PeaceRwandaCongo;Promoting peace, mutual understanding, dialogue, and cooperation among the peoples of Congo and Rwanda.;25354;0;245;4;25603
parentd101;Danielle Parent;Curieuse. Gourmande.;3721;88;405;21383;25597
jchapuis;Jérôme Chapuis;La Croix, directeur de la rédaction;2986;1266;19696;1639;25587
JournalduluxeFr;Journal du Luxe;Le media B2B du #luxe : #gastronomie, #mode, #voyages, #tendances, #horlogerie, #joaillerie, #automobile, #beauté, #retail, #digital, #innovation;13538;156;9164;2726;25584
vidjinnangniG;Grégory T. 🇧🇯👨🏾‍💻;Innovation project manager | Ecosystem builder | #Otaku;16624;180;1788;6988;25580
EntreprendreAuF;Entreprendre au Féminin ★ SEAF 2023 ★;Accompagnement pour les femmes entrepreneures - Sommet en ligne - Conférences, Tables rondes, Coaching, Événements. #coaching #entrepreneur #seaf #seaf2023;22789;829;783;1165;25566
LeaderOccitanie;Leader Occitanie;Réseau transversal d'entreprises innovantes ayant une ambition et une volonté partagées : générer une croissance maîtrisée, durable et responsable.;15737;1391;4119;4297;25544
radiostarsud;radio star. sud;Radio Star nous réunit, nous accompagne, nous sort de notre quotidien pour nous emmener dans notre été éternel, celui de la chaleur et de la bonne humeur;21204;345;3546;427;25522
Rhubarbare;Vincent Verschoore;Blogueur sur rhubarbe.net: vulgarisation scientifique, questions de société, Brexit, journalisme open source, photo. Et Coronavirus.;19931;2031;913;2642;25517
bonjouir83;Besoin de Savoir 😂🔬🌸🧀🐐;Humour, science, botanique et fromage de chèvre.;14322;211;125;10857;25515
vinnydz71;Paillettes d’étoile 🫧✨🦄;what’s happened in Vegas 🌵Stays in Vegas 🤠🎰 Good vibes 🌸 #news #travel #Music #food #tv #Art #Media #Radio 🎙 lol C'est pas toi, c'est moi🙈;11915;1949;1578;10068;25510
LoucasPinto1;PINTO Loucas;;10935;1644;1624;11291;25494
GabrielNdombi;Gabriel;Étudiant à la FDSE;6736;544;376;17825;25481
MsqtrColibri;đź‡«đź‡· Mousquetaire Colibri âśťď¸Ź ReconquĂŞte !;"Que la France retrouve ses lois, sa justice, sa monnaie, son armĂ©e et son indĂ©pendance Ă©nergĂ©tique. Le reste peut attendre.
@LiensZemmour";7603;4673;3287;9904;25467
NathanGuedj_;Nathan Guedj đ»;"SecrĂ©taire @EELVRhone, M. Ălections d' @EelvRhoneAlpes  et en master de science po. De passage Ă  l'AssemblĂ©e.
Ălections, OL et Lutte contre l'AntisĂ©mitisme.";11661;411;1959;11432;25463
TomdeBrouckere;Thomas de Brouckère 🇧🇪🎧🎙;Journaliste reporter @RTBFinfo Hainaut. Mordu d’actu internationale. Accroc au ciné. Le Sporting, c’est sans objectivité et je vous parle même pas des Diables.;7278;1483;2270;14430;25461
FranceONURome;France ONU Rome ð¨ðµðºð³;Mission permanente de la France auprÃ¨s des Nations unies Ã  Rome (FAO, PAM, FIDA) ð¨ðµðºð³ I Alimentation & Agriculture | Ambassadrice : @CelineJurgensen.;3123;1672;2869;17795;25459
FondDavidSuzuki;FondationDavidSuzuki;La mission de la Fondation David Suzuki est de préserver la diversité de la nature et le bien-être de toutes les formes de vie, maintenant et pour l’avenir.;7973;1205;12538;3706;25422
le_RESES;RESES;"Le #RESES - Réseau Etudiant pour une Société Ecologique et Solidaire 🌍
regroupe plus de 150 #assos étudiantes sur les enjeux socio-environnementaux 🌱";10318;2189;7776;5125;25408
TelegLorient;Le Télégramme Lorient;"Degemer mat sur le compte officiel du Télégramme de Lorient : on parle de Lorient, de son pays, et de tout ce qui fait son quotidien !

lorient@letelegramme.fr";19272;281;5285;570;25408
gressmaniac;gressmaniac;amoureux d une réunionnaise et donc de la Réunion. Né en Alsace donc fana du Racing club de Strasbourg;10602;318;201;14284;25405
justinevirideau;Justine Virideau;Cyclorandonneuse - Voyage à vélo - Photographe (since 1999);9179;326;1747;14150;25402
BrigitteDeLyon;BF-Lyon;"MES LONGUEURS D'ONDES🍀🐞 sourire, bienveillance 
- Lyon, Monts et coteaux du Lyonnais, 
handicap,  enseignement supérieur et recherche ESR, ...";8922;1429;365;14683;25399
Michel_Peters;Michel Péters;"#Liegeois #Libéral #éternelétudiant
Agacé par les anonymes peu courageux = bloqués.";20364;943;2621;1469;25397
jrechagneux;Julie Rechagneux;Conseillère municipale de Lormont • Conseillère régionale RN de Nouvelle-Aquitaine • DD Adjointe du RN Gironde;7625;1668;7143;8959;25395
inv3stir;inv3stir;Le meilleur de l'actualité business d'Afrique sélectionné pour vous.;24748;329;288;2;25367
FRANCOIS8139;FRANCOIS PHILIPPE;;12949;71;119;12222;25361
CTM_Martinique;CTM;Collectivité Territoriale de Martinique;11442;486;13117;311;25356
7lpha_;đ lpha đđ;TRIA PRIMA đ âż đ // coachings @MJBFITNESSS;12190;3381;4744;5036;25351
christiemorreal;Christie Morreale;Ministre de la Santé, de l’Emploi, Formation, Économie sociale, Action sociale, Égalité des chances & Droits des femmes. Vice-Présidente du Gouvernement wallon.;8247;2370;10239;4463;25319
Gregam_Pat;Patrice Dessaint;Breton un jour, Breton toujours;8818;57;28;16412;25315
NicolasTurcat;Nicolas Turcat;#EduRenov #renovation #education #territoires #ecoles #colleges #lycees #renovationenergetique / @BanqueDesTerr / Pers. account;7795;2415;4324;10779;25313
LanceurI;Lanceur d'alerte Info;"Les lanceurs d’alerte font un signalement dans l’intérêt général.

Compte de secours :nitter.net/DLanceurs

Telegram t.me/FrenchWhistleblowers";11174;222;1616;12298;25310
Edina_Ifticene;Edina Ifticene;"Campaigner @greenpeacefr
#KeepItInTheGround #PeoplevsOil #StopFossilFuels #Oceans";4229;935;1374;18758;25296
StGeorgesL12;RVB đ„đ„đ„đ­;;8949;452;198;15697;25296
runklelove;Runkle-Tim ⚫⚪ 🐮;"butcher 🔪 plein de nouveaux fans. Je coupe les steacks comme personne.
Nufc fan since 96 till I die. 

insta : timolrx";12536;804;287;11668;25295
alainmeilleur1;AM;;6638;457;148;18052;25295
IESFfrance;IESF;#Ingénieurs et #Scientifiques de France : Artisans du futur | Plus d'1 million d'ingénieurs #IESF #EnqueteIESF #JNI2023;12953;2155;4071;6099;25278
FrancoisDagnaud;François Dagnaud;"Maire du 19e arrondissement de @Paris.
Pour suivre l'actualité de la Mairie : @Paris19e";4989;1032;10411;8845;25277
GuillaumeBottaz;Guillaume Bottazzi - ギヨム・ボタジ - 紀堯姆．波塔茲 - БОТТАЗЗИ;"Asia & Europe & USA & Russia 
MORE THAN 100 ARTWORKS FOR PUBLIC SPACES ordered by museums, cities, ministries, investors... 
#art #neuroaesthetics #artinsitu";8089;7603;7726;1848;25266
mallandirS;s.mallandir ☣️;toujours contre la doxa de gauche et Umbrella Corp.Aucun soutiens politique, l'Occident sous sa forme actuelle est une impasse.;15399;638;283;8912;25232
Jean_LucFUGIT;Jean-Luc FUGIT;Député du Rhône/Président Conseil Supérieur Énergie /VP OPECST/ Rapp.Loi Mobilité/Qualité de l’Air/Biogaz/Spatial/ Hydrogène/Agriculture/ Ruralité /Fan de Rugby;9725;3880;6462;5136;25203
Le_citoyen_DZ;Dr. Al;"Tous les maux dont souffre l'Algérie ne sont que des conséquences de la fraude électorale.

La salubrité d'un état dépend des élus, c'est à dire des citoyens.";18446;624;2403;3707;25180
Prg163;đ«đ· Prg163;Câest nous les gentils;13764;925;362;10127;25178
BPragassam;Blaise ,⚜️🇨🇦, entrepreneur📏📐🖋️✏️📈🔎;"On n’apprend point aux hommes à être honnêtes hommes, et on leur apprend tout le reste. 
Blaise Pascal";2275;685;122;22054;25136
BelliDeum;NUPESFLIX;;6120;147;38;18828;25133
flush44;Jean-Libertés;"Investisseur, anti-contrôle social
finances-entrepreneur-franca…";4990;1010;552;18576;25128
BenmiloudKarim;Karim BENMILOUD;"Recteur de l'Académie de Clermont-Ferrand depuis juillet 2019.
Né à Vannes, normalien, agrégé, Professeur des Universités (Littérature latino-américaine).";2106;2407;3157;17453;25123
bodayaam7;nobl7siiga;artiste poète peintre;10310;4127;2467;8212;25116
Alice8076;Alice Ernoult;"prof de #maths, #apmep, rêve d'un monde plus juste quitte à passer pour une candide.
@aliceernoult@mamot.fr";10223;936;2169;11780;25108
The_NeTpSyChO;Hervé Godquin;Hardcore engineer, hacking & DIY enthusiast, cybersecurity auditor for fun & profit. Picard exilé dans la loire, ancien cascadeur dans la série Derrick :).;8047;4167;991;11898;25103
armelle_malora;Magnolia_Armelle7 ð¬ðª¶â¨;;10338;654;767;13336;25095
RochaneK;✨ Rochane ✨;"Expert & Chef de Projet #Numérique à #BruxellesFormation
Fan de veille, partage des bonnes pratiques #IA #TICE #ClasseInversée #DigitalLearning #Hybridation";15771;1396;4870;3056;25093
haitinews2000;Haitinews2000;Haitinews2000, un média en ligne haïtien administré par des jeunes professionnels. - Infos Nationales et Internationales, Sport, Culture, Insolite, Météo...;17408;2072;5357;230;25067
KevinRivaton;KEVIN RIVATON;Kevin Rivaton. #Paris #Beyrouth #Tourisme. Il faut quitter la vie comme Ulysse quitta Nausicaa - en la bénissant plus qu'en l'aimant.;24945;50;23;32;25050
parealain75;pare alain;j aime l astronomie,les conferences,l archeologie,,la speleologie,le jardinage,le cinema;10357;3502;647;10543;25049
EquitasIntl;Equitas;International Centre for Human Rights Education - educate. empower. change. | Centre international d'éducation aux droits humains - éduquer. habiliter. changer.;8264;4344;5641;6779;25028
Oronaye;Alexandre Ⓐ Oberlin;Les fanatiques de tous bords finissent toujours par me bloquer.;13505;200;280;11028;25013
Belhache;Philippe Belhache;Journaliste @sudouest / Critique BD @AssoACBD / HPI débutant / Geek light / Chauve à lunettes;16362;1062;1292;6280;24996
UTTroyes;UTT à Troyes;École d’#Ingénieur publique post-bac, membre de l’alliance européenne EUt+. La #technologie centrée sur l’humain : #environnement, #recherche, #innovation;8477;2154;4825;9502;24958
PaulMul97561773;Citoyen Paul;I am a pirate. Aarrh !;10785;185;224;13761;24955
bo_no_bo_no_bo;SapiensSapiens;;3632;1401;54;19846;24933
DigitAqui;Digital Aquitaine;Pôle numérique Digital Aquitaine 🚀 #DigitalCluster #Esanté 💉#CommerceConnecté 🛒 #ITS 🚗 #Géolocalisation #Simulation #VR #AR #Data #IoT #BlockChain ⛓;6097;2946;7530;8353;24926
BBOX52256362;BBOX;"Gaulien, GauloisđČđ«LaĂŻque đČđ« 
RĂ©publicainđČđ«.
LĂ  pour essayer de comprendre ce monde en auto-destruction.
Dans le CNR tous les FranĂ§ais 
Du Soviet au Royal.";14006;905;471;9502;24884
Q_chatelier;Quentin Chatelier;Journaliste travail/emploi @LSQredaction - Adhérent @assoajis;21346;941;1614;966;24867
BFMLittoral;BFM Grand Littoral;"Info, trafic, météo
📺 Sur la TNT : 32 (Flandre/Audomarois) / 28 (Boulogne-sur-Mer) et les box SFR (483), Bouygues (326) et Free (330) et sur Molotov TV";22557;25;2261;17;24860
BazikaDieudonne;Dieudonné Bazika;Chercheur. Politologue internationaliste, Libre-analyste de fait politique et social. Expert en Organisation Sociale.;14542;1364;919;8021;24846
fga38000;santana garcia;;5954;89;38;18759;24840
MarieHbib;MHB;Gasconne en Bretagne ... tétue ? (un peu, beaucoup ?) mais toujours à vélo.;12888;970;147;10828;24833
LeuthyMolina;Christine Leuthy;Directrice Régionale Sud-Est @citeofrance, Entreprise à Mission pour réduire l'impact environnemental des emballages et des papiers #Trier #Réemployer #Recycler;9495;2032;1485;11819;24831
rev3;rev3;Chez nous, notre #rev3 d'une économie durable et connectée est réalité. La 3ème révolution industrielle est en marche avec @CCI_hdf et @hautsdefrance;10546;1487;6624;6171;24828
ca_ginesy;Charles Ange Ginésy;Président du Conseil départemental des @AlpesMaritimes, Président du Parc national du @Mercantour @SICTIAM_FR #Valberg #ia #SMARTDeal #GREENDeal;10925;1120;10605;2168;24818
MustiQ;MustiQ;gratte-papier news-addict. Intérêts pour la politique, le patrimoine et la sécurité publique. 🐘 @mustiq@mastodon-belgium.be;8833;4472;721;10790;24816
ZayActu;ZayActu.org;"ð° L'info des Antilles-Guyane en temps rÃ©el ð
TÃ©lÃ©chargez notre App IOS / Android sur votreð±
ð§ redaction@zayactu.org 
âï¸ 0696 80 24 24";16167;1072;7488;76;24803
josedacunha8;Da Cunha Jose Manuel;Assume ses tweets.;16963;275;157;7402;24797
piervak;Pierre Vak ð¬;"Avocat (ð) insolent, dÃ©batteur passionnÃ©, philosophe par moment, j'aime Ã©changer... dans le respect. 

(CrÃ©dit photo: Phillip Wang / TPDNE)";14860;478;213;9231;24782
villedieu_a;Antoine Villedieu;đ DĂ©putĂ© de la Haute-SaĂŽne groupe @RNational_off , Commission permanente @AN_DevDur  đ«đ· Ex policier đźđ»ââïž;6786;662;3931;13398;24777
PaulMaujean;Paul MAUJEAN;Faisons d'un Bug,une opportunité Ingénieur AM expert technique SAP et un peu artiste quand j'ai le temps...;15828;179;92;8678;24777
sandrineDescla8;sandrine Desclaux;En te levant le matin,rappelle-toi combien précieux est le privilège de vivre,respirer,d'être heureux;11892;17;74;12787;24770
SU_Samuel;Samuel Arvidsson;"De Gauche. Jamais d'accord avec ma famille politique.
Like = bookmark pour usage ultérieur, pas forcément une approbation du tweet liké.";24259;69;214;219;24761
rosemarie4710;jakeline chartier;;1327;75;74;23249;24725
Balotelletubies;Balotellitubies;Expert en rien;4547;310;83;19784;24724
schmurcks;Prof Gaga avec Cthulhu;Compte personnel - Ingénieure pédagogique d'après un CPC, meilleure maîtresse d'allemand d'après mes eleves, feignasse d'après certains journalistes;9107;582;803;14210;24702
mifiguemifigue;MifigueMifigue;"Quand je serai vieux, j’irai mieux. En attendant j’apprends.
piaille.fr/@mifiguemifigue";12860;689;404;10740;24693
Infos_Dijon;Infos Dijon;"infos-dijon.com - L'information à #Dijon - Mail : redaction.infosdijon@gmail.com
Facebook : facebook.com/infosdijoncom/";13516;1646;9256;274;24692
Quecholli1;Quecholli;Un peu beaucoup dans le livre...;10890;84;88;13618;24680
arno_duval;Arnaud du Val #HDCCG đ»;"VĂ©lo sportif et utilitaire, science, logiciel libre.
Membre d'une sorte de groupuscule de cyclistes extrĂ©mistes.
Compte personnel";13792;485;384;10014;24675
EvinaMartial;Evina Martial;Consultant Senior en Systèmes d'Informations;24215;253;111;58;24637
alvinsolaire;Alvin Solaire;Je RT ce que je trouve intéressant !;3727;4998;711;15197;24633
apocalypse666fr;apocalypse 666;Penseur. 666, le nombre du diable.;9066;545;409;14610;24630
MedhyDanet;Medhy;M1 en info-com, militant đąá”  âïž @Nupes9108, fan de SF (Star Citizen â€ïž) đ«đ·;1221;201;172;23029;24623
GauloisRadical;Nicolas Dollet;"La gauche qui pactise avec les islamistes, la droite qui drague les lepenistes ð½
FranÃ§ais et europÃ©en ðªðºð«ð·
Soutien Ã  nos Forces de l'Ordre ð";8933;647;129;14902;24611
Dosto_deRiv;Piqui Blaindère;Physicien/modélisateur, Batterie molle & pâté croûte. Pour une Compréhension des Lois de la Nature et le Respect des Temps de Cuissons.;8212;267;156;15974;24609
minedinfos;Veille Mine d'infos;Je picore au quotidien, l'actualité pour les accros d' infos de tous poils...;18234;1888;2398;2085;24605
RamondPierre;Pierre Ramond;"Doctorant en science politique | Responsable @GC_Mardis au @Grand_continent | Donne cours ""Théories des relations internationales"" @ENS_ULM (S1) | فارسی";2791;1444;2413;17953;24601
Bonapartiste66;🇫🇷 Bucéphale R! 🇫🇷;« Les sanglots longs des violons de l’automne blessent mon coeur d’une langueur monotone. Paul Verlaine »;9202;3572;2674;9136;24584
distelzola;Distel Zola;Husband, Dad, International ⚽️ player @Independence 🇺🇸🇨🇩instagram.com/distelzola/?hl… Founder @banazolaDRC Hight level supporter advocate @WFP;3287;816;8980;11488;24571
Djam51673788;Djam;;722;89;17;23732;24560
TwentyOneCMR;Lie Jordan 21𓃵 🔰;"Manchester United, FC Martial, Manga, FC Zoro, Musique
Page : facebook.com/profile.php?id=…";4739;394;364;19056;24553
Option_Finance;Option Finance;L’hebdomadaire Option Finance a pour mission d'être un véritable trait d’union entre les entreprises et la communauté financière depuis plus de 20 ans.;14493;281;8111;1667;24552
TheAppEcon;TheApprenticeEconđź‡¨đź‡¦;"Le mieux est l'ennemi du bien - Voltaire //

U - PMs - ADA

//
MSc student in applied economics - Thesis on the impact of monetary policy on inequalities";3096;153;49;21252;24550
JN_Gibbs;Jean-Noël favier;;3788;73;30;20653;24544
LM_NCHO;N'cho Landry Modeste;Économie, Histoire, Culture, Science&Technologie;22596;667;389;890;24542
RoyMv6;roger;Ingénieur;2874;6794;8523;6348;24539
rolandsophie1;Sophie Roland;Journaliste - Formatrice solutions & climat @soljourno @Imagine2050_ @ESJLille @ijbaofficiel ex @Cashinvestigati @francetv @envoyespecial @cfjparis née à 327ppm;3418;5002;3611;12506;24537
BKiteti;Boya Loso Kiteti;Économiste BCC RDC,ex Chef des Projets à Banque Mondiale,USA. Maîtrise Santé J.HOPKINS,USA. Auteur 2 livres. Climat Influenceur.Acteur Politique en RDC.;16249;5001;3258;16;24524
boris_lupeta;lupeta boris🇨🇩🇨🇩🇨🇩🇨🇩🇨🇩❤❤🥰✌🔥;"#informaticien.
un modèle à suivre 
je suis congolais de père et de mère 
j'aime mon pays la #RDCONGO avant toute chose 
toko longa kaka";2846;1344;1226;19107;24523
UNV_ROWCA;UNV W&C Africa;"The UNV Regional Office for W&C Africa contributes to peace & development in the world through volunteerism.  #Volunteerism

Youtube channel ðº : bit.ly/2XY2qCa";7054;550;8926;7959;24489
LeChat58145491;Symbiosis ð;"Amateur de stupiditÃ© humaine, mais la moraline m'ennuis fortement.
Le futur sera nuclÃ©aire ou il ne sera pas.
L'aliÃ©nation doit Ãªtre combattu.";6603;28;27;17825;24483
francoispinche1;François Pinchemel;technocrate du développement durable (de lapin(çalinge));14723;369;185;9193;24470
humcoalition;Humanitarian Coalition | Coalition Humanitaire;Bringing together 12 leading aid organizations during int’l humanitarian disasters. 🇨🇦 Together saving more lives | Ensemble nous sauvons plus de vies.;12100;1246;5157;5961;24464
MarquisedesAng4;ML;;9643;609;846;13358;24456
Vert_le_media;vert;Toutes les bonnes infos sur l'Ã©cologie (et plein de super jeux de mots) dans une newsletter quotidienne ou hebdo. Pour nous lire et vous abonner gratuitement ð;4620;1693;15985;2142;24440
Dechets_Infos;Déchets Infos;"Actualités, enquêtes et reportages sur la gestion des déchets.
Edité par Olivier Guichardaz
Obtenir un n° gratuit : tinyurl.com/l7tqjko.
Retweet ≠ adhésion.";15602;830;7067;938;24437
IOMROWCA;IOM West & Central Africa;UN Migration (IOM) account for West and Central Africa - bringing you updates and stories in both EN & FR;7343;923;10544;5615;24425
NetMelc;🔋NetMelc🔋;$TSLA focused investor since 2019 | Finance | Trader on the side | F1 Enjoyer | currently in $EOSE as well;3818;240;226;20141;24425
Camcam_Evrd;chaton;"Votre petit rayon deđ CRPEisteđ©đŒâđ«
FiĂšre de nos couleurs đ«đ·
#teamVarane";9384;308;214;14500;24406
steveododo;Clément Le Hareng;Esthète de la mauvaise foi dans les justes causes. Insoumis au prêt à penser. En contradiction et en débat même avec moi même, souvent. #ecosocialisme;12281;353;166;11606;24406
Lionel8120;Lionelð8120#BLM#antiLRNEMZ#jaipaseu10%;En ces temps de marchÃ© conquÃ©rant et d'idÃ©ologie penaude (C. Taubira).;13435;1067;968;8927;24397
batistab17;batistab17;#Apple addict et #NintendoSwitch;22875;350;121;1021;24367
prince2BZ;Srg;Le monde ou rien;13832;269;317;9935;24353
MartineStSimon;Madame Martine St-Simon;;10762;383;272;12904;24321
vickyleandre;GrumpyVicky;"up shit creek without a paddle 
#veille #infodoc #traduction #angers #nantes";6276;570;94;17359;24299
IndustrieFrance;Société d'Encouragement pour l'Industrie Nationale;"#ENCOURAGER #TRANSMETTRE #VALORISER #INDUSTRIE #INNOVATION 🇫🇷 
Association 1801 #UtilitéPublique
#HotelIndustrie @oliviermousson";7202;2781;2703;11585;24271
DegrafH;Degraf Hilda;;12728;230;115;11194;24267
GeorgeAbitbol22;George Abitpaimpol;#EAG Gwengamp 加油吧 ! #emojibzh #Velotaf (conversion en cours) Né à 343.6ppm;16512;91;299;7353;24255
AnthonyAssemat;Anthony Assémat;"Rédacteur en chef Entreprises Occitanie (site et magazine mensuel) et du Top Éco. ex-@actutoulouse
#Tarn #TeamCO #Toulouse #Comminges #Pyrénées";14375;4379;5308;188;24250
ContexteEnergie;Contexte Énergie;"⚡ Le fil énergie de @Contexte / Animé par @AnnaHbrt, @IsabelleSmets, @NezimTJ, @ThomasChemel et @GenicotD

Photo bandeau : Chris Hunkeler / Flickr";12681;389;10711;467;24248
Cristroumph;Christophe☝;Il ne faut pas se taire face à l'obscurantisme religieux ou politique.;14012;979;307;8948;24246
grandparissud;Grand Paris Sud;#GrandParisSud c'est 23 communes sur les dĂ©partements de l'Essonne et de Seine-et-Marne đ, 24 228 entreprises đŒ et 40 Ă©coles d'enseignement supĂ©rieur đ©âđ.;9565;1442;5217;8020;24244
Booguis1;Booguis;;23367;42;43;791;24243
Guishaume;Guishaume;trop n’est jamais assez. cold wallet, mutualiste, decentralize et web 3.0;11914;2761;296;9263;24234
akomesyal;Johny Augustin ­ččí;Force de lÔÇÖEst ­čžş Ô×í´ŞĆ Compte Priv├ę (Mon Opinion);10692;1642;2943;8935;24212
MoodMediaFR;Mood Media France;"▶️ Mood Media crée une #expérienceclient complète autour du magasin et du contenu #audio #visuel, #sensoriel et du mobile. 

#retail #digitalsignage #music";10434;1705;2151;9915;24205
baugeenanjou;Baugé-en-Anjou;Compte officiel ville de #BaugeEnAnjou #MaineEtLoire (49) Des Tweets pour tout connaitre sur votre Ville ! #jaimelanjou;14188;666;1684;7663;24201
SfyzerTF;Sfyzer ;"Analyse technique & macroéconomique pour trader & investir à travers plusieurs classes d'actifs.

PEA 🇫🇷 🇪🇺 / CTO 🇺🇸 / Cryptos #Bitcoin / Gold & Silver";4970;97;8561;10560;24188
JohnDupontIDE;John Dupont;IDE libéral;8730;202;113;15126;24171
_PapaMars_;PapaMars;Dans les années 80 on m'a fait fêter le bicentenaire de la révolution et chanter l'hymne à la joie au Châtelet pour l'Europe des droits de l'homme. puis...;9021;1672;396;13080;24169
antoningosse60;Antonin Go Ⓜ️🇨🇵;Adhérent du @Rnational_off, militant et soutien de @MassonBryan;12188;1523;1869;8588;24168
HenriGolant19;La Tartiflette Masquée;"""Il vaut mieux ne rien dire et passer pour un imbécile que de l'ouvrir et confirmer qu'on en est un"" (Groucho Marx)

Une insulte ? Je bloque illico !";16484;932;1009;5742;24167
gonepur;Bret Le Gone - Gauche et à gauche.;Humaniste, tolérant sauf aux cyniques, escrocs, malhonnêtes.;8568;3588;1183;10824;24163
finance_invest;finance_invest;;20490;1808;1839;1;24138
Citoyen83674311;Citoyen;#NonALaRéformedesRetraites;4600;768;94;18636;24098
CoquillardI;COQUILLARD ISABELLE;;11267;1049;357;11410;24083
Abota1;Abota;"Les faits ne pénètrent pas dans le monde où vivent nos croyances (Marcel Proust)
#progressiste #environnement #Europe";8387;1138;227;14326;24078
Breizh_Erminig;Visan Rouxel;"Breton de cœur et d'âme, français ? jamais, terrien, toujours.
Stop aux pseudos démocraties
Bretagne, colonie française depuis 1532";17217;100;63;6678;24058
VJi42532136;VéJi;Bloqué par @russophobieorg qui devrait plutôt se renommer @poutinophilieorg !🧐;12025;1416;526;10066;24033
Axiome_Fact;Equinox 📰Facts;Il n'y a pas plus droitard qu'un vrai marocain car il est Royaliste. Les marocophobes, islamophobes, anti-chrétiens & antisémites, circulez y'a rien à voir!;5377;2263;2053;14325;24018
mvignaud;Marc Vignaud;Journaliste à l'Opinion. Politiques économiques et conjoncture. Mes tweets n'engagent que moi. Participe à l'émission de France Inter, On arrête pas l'éco.;9676;2003;4658;7664;24001
Vapulabe;Vapula;"Maker, fan of Linux, Science-Fiction and Metal.

Blocage systématique des trolls, j'ai autre chose à faire que subir leurs raisonnements tordus.";13931;70;101;9870;23972
RFI_eco;RFI Éco;L'actualité économique vue par @RFI.;17715;659;5466;125;23965
oxythan;David -Insensitive reader @oxythan@mastodon.social;"IngÃ© humaniste, #NoFakeScience ð´ââ ï¸
S'invite dans vos threads sans frapper.
Autres profils @F4HTQ (Ham radio)  @ThisIsATechDir (Pro)";11402;815;432;11306;23955
fimaform;CMDR Doom;Toute chose profite ou souffre de la volatilité. La fragilité est ce qui souffre de la volatilité et de l’incertitude.;12961;513;167;10306;23947
TheMundele;Tonio ðºð¦ #StopPutinWar;La passion exclut souvent la nuance et la raison... #NofakeScience #Politique #digital #Rugby #gÃ©opolitique #running;16350;613;238;6737;23938
MiroirSocial;Rodolphe Helderlé;Barreur de #RelationsSociales sur le MiroirSocial, média double face = participatif et journalistique sur abonnement.;13620;3713;6065;539;23937
WaleedMouhali;W.Mouhali;"Enseignant Chercheur en Physique
Conseiller municipal @EELV @Lagarenne 
Porte parole Bureau ExĂ©cutif IdF @EelvIdf đ»
#mĂ©caniquedesfluides #informatiqueQuantique";6700;4248;1483;11485;23916
chanezherbanne;đ«đ· Chanez Herbanne;"ConseillĂšre RĂ©gionale des @hautsdefrance -
2Ăšme VP en charge des lycĂ©es et de l'enseignement supĂ©rieur -
Cofondatrice du PĂŽle MobilitĂ© du Beauvaisis đđ”đ±";6052;3653;2800;11399;23904
LaetitiaMendes3;Laetitia Mendes;Consultante Sales & Marketing @FYTEasily;23742;21;124;6;23893
cdt_news;cdt.fr;Spécialiste dans la vente et l'achat de métaux précieux et devises depuis 1984. Envoi sur toute la France. Avis clients sur TRUSTPILOT : Score Excellent 9,5/10;23755;20;113;0;23888
YoshYosh59;Yosh Yosh;;14405;3916;157;5402;23880
affreujo;Jimmy987;;2225;130;62;21446;23863
vivendi;Vivendi;Creation Unlimited with @canalplusgroupe @HavasGroup @Editis_officiel @PrismaMedia @gameloft #VivendiVillage @Dailymotion;10772;483;9821;2778;23854
meteo60;Meteo60;"Aussi sur t.me/meteo60
Compte de meteo60.fr, même ligne éditoriale que le site. 
Ce compte n'est pas un forum, un tchat ou un formulaire de contact.";12772;69;9497;1514;23852
EChenut;Eric Chenut;Président de la @mutualite_fr. #santé #protectionsociale #prévention #epargneretraite #ESS Universaliste, Européen et aveugle 🧑🏾‍🦯;5801;1806;4733;11506;23846
juu_luux;Julux đ;"This is a @Pommeofficial and @AliceOseman stan account
25 yo | beer, anime, manga, science and shit (đłïžâđ).
Heartstopper đ.      
he/him";10098;280;95;13365;23838
matiheu24;Matiheu24;Simple citoyen.;4441;792;109;18496;23838
okami_1405;Killukami;"J'aimerais partir avec toi et brûler des églises
🌸🌸
she/her🏳️‍🌈";2711;309;53;20724;23797
ANIA_FRANCE;ANIA;L'Association Nationale des #Industries #Alimentaires représente la 1ère #industrie de France. Pour une #alimentation saine, sûre, durable et accessible.;6800;1649;10960;4380;23789
phcrevel;Philippe Crevel;Directeur du Cercle de l'Epargne et fondateur de Lorello Eco Data;14207;2409;2547;4625;23788
Ebanguemilito;Résolutions des problèmes sorcellerie et enquêtes;"Conseiller En Gestion des Affaires

ceux étant sur twitter, postant comme les entreprises de journalisme dont je suis followers sont de mon régistre. don't lie";13461;315;21;9984;23781
ia67920173;Drink Wild;;15675;447;61;7595;23778
AutoJournalMag;AutoJournalMag;Twitter officiel du magazine L'Auto Journal #automobile #presse #essai #video #passion;13843;104;9704;114;23765
fredericdenomme;Frédéric Dénommé;Quiconque avec un coeur vote l'amour - Développeur @LesManifestes - Responsable élections internes @QuebecSolidaire - Fondateur @VOTVOT;18735;2767;1754;483;23739
HarryCo55534773;Harry Cover;"Caribou à poil dur. 
Du 20ème siècle, définitivement.
Vannier, lecteur, cueilleur, pêcheur, golfeur, ex chasseur.";8387;800;269;14282;23738
LeJusticier313;SeutouAlburyPendað¸ð³;Quand lâinjustice devient loi, La RÃ©sistance est un âð¾ devoirð¸ð³ #Chessplayer #LibrePenseur #AnonymousSN #BPP #PatriotAnticorps #MacGiver #OMiens;6622;4882;3700;8523;23727
Bienkowski_Ant;Bienkowski Antoine;non, détester le fascisme ce n'est pas être russophobe.;8761;419;53;14466;23699
Habibou2DBZ;Habibou de DBZ;Je suis le vrai et je connais très bien le présentateur;14346;3921;164;5267;23698
BRGM_fr;BRGM;"ð«ð· Service gÃ©ologique national - #gÃ©osciences 
ð¬ð§ #FrenchGeologicalSurvey - #earthscience";4580;1307;13069;4732;23688
smarthelot;Stefan Marthelot;Intra/entrepreneur dans les EdTechs et design. Gaulliste et souverainiste. Humeurs sur l’histoire, la politique et la langue 🇫🇷;6161;1131;1081;15305;23678
sebastien_abis;Sébastien ABIS;Directeur Club DEMETER, Chercheur @InstitutIRIS, Enseignant @UnivCatholille @Junia_ingenieur, Chroniqueur @lopinion_fr, RCIT @MarineNationale;11435;1324;6605;4311;23675
RomainLaveau;Romain Laveau đȘđșđ»;Conseiller fĂ©dĂ©ral @eelv, rĂ©fĂ©rent communication du groupe local #Angers agglo;4296;1275;1536;16553;23660
sofepadi;SOFEPADI;SOFEPADI's mission is to promote and defend the rights of women and girls ð¨ð© in order to ensure that mothers and children have access to their basis rights.;5082;3293;7190;8091;23656
DomCorner3;Dom Corner;Anti dogmatisme, le plus en vogue présentement est le dogmatisme scientifique, mais ce n'est pas le seul, loin s'en faut;20587;333;215;2519;23654
F_Bouvard_REV;Francine Bouvard ­čîĆ­čÉż­čî▒­čÉČ­čÉč­čÉŚ­čŽî­čŽŐ­čÉ║­čÉĚ;"Membre @REV_parti en r├ęgion (#IledeFrance)
Partenaire et soutien #UnionPopulaire et @JLMelenchon
#ecologie #antispecisme
Droits du #Vivant";8167;4999;1895;8574;23635
KrolOngala;Krol Ongala;Communicant | Directeur de la publication digitalnews.ga | Consultant en marketing et communication digitale;7826;840;1600;13352;23618
KassimDoumbia13;Kassim Doumbia;Web Communicant diplômé en Réseau informatique Télécommunication et en Marketing Management;5876;2676;5396;9659;23607
barbiturhic;Barbituric;toujours athée, laïque et universaliste… barba ouille truc;4665;198;140;18600;23603
lotcharlot;Charlotte Soulary;Ecoféministe | Responsable du plaidoyer @ZeroWasteFR #zerowaste 📢 #PlasticsTreaty |📚 Le féminisme pour sauver la planète (2021);11959;2428;3561;5641;23589
MYOMIAOU357;MYO@MYOن;🇫🇷🇮🇱🇷🇺 🇪🇦🇮🇹 🌿 ✝️Solitaire en Corrèze je 💧sur🇨🇵.. Animaux,Histoire 🎶 ⚜ t.me/MYO357 Cpte 2 de @MYOSOTIS357;14191;1178;540;7673;23582
cabinetSecafi;Secafi;#Expertise #Conseil #Formation pour représentants du personnel et organisations syndicales #CSE #travail #syndicat #RPS #SSCT #traitsdunion @GroupeAlpha;11166;3976;4682;3756;23580
emiliozzzzzz;Emilio ð³ð³ð³ð³;Souverainiste ð«ð· frexiteur, ni gauche ni droite, bloque si mauvaise foi, compte souvent en mode privÃ©ð¥ð¥ð¥ð¥;10455;1001;343;11764;23563
DhP_france;Ph.D_sciences_France;"Actualité et citoyen avec le droit de vote ;)
Ph.D en sciences";18791;78;147;4547;23563
Jeremy_9_;J.;Géopolitique | Sport | Esport;7417;1010;113;15009;23549
VeoliaWaterTech;Veolia Water Tech;Veolia Water Technologies, the global leader in water treatment. Part of @veolia #circulareconomy #sustainability #water #wastewater;11674;335;9519;2020;23548
IsupportFBI1;I_support_F.B.I.;;10052;5000;281;8195;23528
CharbonGaz;RACG Officiel - « Hydrogen-ready »;"Regroupement des Acteurs internationaux du Charbon et du Gaz.
En backup des #ENR 🤝 En route vers la #transition 🌻
Une fiction souvent dépassée par la réalité";6463;179;8183;8696;23521
Sebbaz_;Sebbaz (sebbaz@pouet.panglossoft.fr);"pouet.panglossoft.fr/@Sebbaz
Bénévole @tdn_fai et @federationfdn";12498;1756;396;8823;23473
kingrice1967;VAN;Liberté - Égalité - Fraternité;16118;172;84;7077;23451
Meret_Lucas;Lucas Meret;Jeune, étudiant, L2 Histoire ᵠinsoumisᵠ @JFIRennes Syndiqué à @unionpirate #Rennes2 #FI #NUPES 🇫🇷🌍;5948;842;574;16083;23447
KaminaEnMoulaaa;Sach 🔫;;3077;858;79;19419;23433
berge93mbhcc;Earline.Berge93MBhcc;;23389;1;15;0;23405
Capo_Canellas;V.CAPO-CANELLAS;Sénateur @UC_Senat @UDI_off SeineSaintDenis Questeur @senat Pdt gr étude aviation civile Maire Honoraire, CM #LeBourget;10203;2425;3721;7055;23404
PaulYment;Paul Yment;Simple et composé à la fois. Plus-que-parfait par le passé. Imparfait à présent. En conditionnel dans le futur. Tout ça est très subjonctif, finalement.;16426;73;290;6614;23403
Reap_YouTube;RealPolitik;Youtube channel: piped.video/channel/UCMoAA…;4609;126;11569;7091;23395
MatP58634023;Ichigo;"Ça peut trancher, mais c'est pour ton bien ;) Détend toi c'est de l humour.";7400;61;91;15831;23383
ofqj_france;Office franco-québécois pour la jeunesse - France;L’Office franco-québécois pour la jeunesse (OFQJ) est un générateur d'opportunités pour les 18-35 ans en #France #Québec #Francophonie;9646;2844;6730;4160;23380
wamnews_French;WAM French;Le compte officiel de l'agence de presse des Emirats, WAM, sur Twitter, en Français;20641;19;2712;0;23372
127Walcott;Koco Kouame Theophil;;902;139;134;22195;23370
Convictionkab;Kabiliste Convainquant Et Convencu;"Kabiliste par conviction,Passionné de l'avenir meilleur de la RDC,
''ensemble ne trahissons jamais la RDC, luttons pour sa dignité et son émergence 🤝";6272;4983;8357;3757;23369
Porglo;Glopor;Retraité fraîchement devenu octogénaire.;11963;364;212;10822;23361
MercierTherese;MERCIER M-THERESE;Marie-Therese Mercier, Commissaire aux comptes.Associée EY. Conseillère Régionale Occitanie .« Sois le changement que tu veux voir en ce monde » Gandhi;9926;965;1860;10594;23345
DeDe_clown_ODD;Dédé, le clown des #ODD;Tweets of a European citizen who dreamt to turn into a clown when he got 50. Now turning into Dédé le clown des #ODD!;14720;1681;633;6292;23326
DamienTANCHE;Damien TANCHÉ;"AdminServeur, Geek et amateur de Ubuntu. Rugby Fauteuil, Tennis de Table, Basket Fauteuil, Handisport, au repos
ngl.link/damientanche";16906;438;236;5730;23310
Diallo_____;Rah’Man🫥;L’AFRIQUE NOTRE AVENIR #Panafricain #libéral ✊🏾;13930;664;1328;7387;23309
ayoubdedamaro;Ayoub Camara;Politique, Science, Foot & Autres;1422;693;93;21095;23303
lechodusolaire;l'Echo du Solaire;La lettre hebdomadaire d'actualités sur l'énergie solaire;11948;490;4013;6848;23299
laurentgia;Giannetti Laurent;Directeur commercial PME BNP Paribas  #finance #investissement #patrimoine #entrepreneurs, #banque ,#startup Passionné #digital (Y né X) .Tweets are my own.;18489;2419;1170;1213;23291
ChDias72;Christophe D;La démocratie, ce n'est pas celui qui gueule le plus fort et qui crache le plus loin.;8102;385;224;14565;23276
chocapic57;chocapic57;#TeamFCMetz;4516;2851;370;15506;23243
EnercoopBreizh;Enercoop Bretagne ☀️;Coopérative locale #Enercoop ⚡️ On parle #EnR, transition énergétique citoyenne, #ESS en #Bretagne et ailleurs. Rejoignez-nous ! 👐💡;10934;2106;2546;7643;23229
RadTicker;RadTicker;News, Infos & Meinungen zur nachhaltigen Mobilität. Radpolitisch aktiv. Unterstützt die @KidicalMassK Köln, @KinderaufsRad & @lebenswerte_Lux mit Grafik.;10221;542;4105;8356;23224
succube124;Clara Parks ✌️;Nomad Land;7208;2884;2239;10886;23217
allinjf;Jean-François ALLIN;"Directeur de la #communication de @dalkia filiale du groupe
@EDFofficiel #ÉconomieCirculaire #TransitionÉnergétique #RSE #Décarbonation #EnR #Innovation #Data";7720;4782;4007;6693;23202
bearstech;bearstech;"#SCOP d'experts du #LogicielLibre
Confiez nous la performance de vos applications (hébergement, infogérance, #devops, #SRE, sécurité, efficacité énergétique)";7645;2807;7361;5388;23201
CENAuvergne;CEN Auvergne;"Conservatoire d'espaces naturels d'Auvergne, membre du réseau des Conservatoires d'espaces naturels.
Ensemble, préservons les espaces naturels d'Auvergne !";14186;224;2573;6215;23198
MichelP_95;Michel;;14226;406;109;8449;23190
Prefet49;Préfet de Maine-et-Loire 🇫🇷🇪🇺;Compte officiel de la préfecture et des services de l'État en Maine-et-Loire.;8448;360;12209;2170;23187
bcprch;Benoit⚱️🦀;Socialo altomédiéviste;5175;840;635;16530;23180
tduverger;Timothée Duverger;Chercheur @CEDurkheim, Resp. @CTerress @ScPoBx, OEIL @j_jaures, chroniqueur @AlterEco_, Obs. @ZeroChomeurLD 📚 #ESS #décroissance & #revenudebase;11287;1272;3803;6810;23172
MarieChureau;Marie en grève;Activiste pour l’écologie et la justice sociale | étudiante en droit franco-allemand et politiques écologiques, Paris/Berlin | she/her;1366;703;1329;19762;23160
DovifatB;Dovifat Benoit;Hydrogen, new mobility's Ambassador, specialist in hydrogen news with a global, macro-economic and geopolitical view on the subject 29k LinkedIn followers;10923;132;363;11724;23142
NicePresse;Nice-Presse;đź“± 1er journal gratuit du 06 | ActualitĂ©s et infos Ă  Nice et dans les Alpes-Maritimes | #Nice06 | Aussi @Nice_Culture (đź“¨ DM ouverts);12389;2210;5976;2546;23121
LaSamaritaine12;Séraphina;"Bienheureux celui qui a appris à Rire de lui-même : il n'a pas fini de s'Am-user !

Psaume 22 : Le Seigneur est mon Berger,

La Vérité est mon Épée";10028;131;109;12851;23119
MarocV_Com;Marocv.Com;Actualités en temps réel géré par un algorithme qui sélectionne et organise les articles selon les sujets les plus pertinents du moment.;22914;3;110;85;23112
CharetteB;Benoit Charette;Député de Deux-Montagnes - Min. de l’Environnement et de la Lutte contre les changements climatiques, de la Faune et des Parcs - Min. resp. des Laurentides;8297;3063;10232;1505;23097
Laurent47925162;Laurent;;11475;155;79;11384;23093
RothAurlien1;Thor Orelien;🇺🇦🇺🇦🇺🇦🇺🇦 Si tu aimes Poutine et son État criminel, passe ton chemin l’idiot. Ненавиджу росію 👊🏻 👊🏻 👊🏻;5319;1857;332;15581;23089
fontaine_78;Fontaine Franck;Maire @Ville_Mezieres - VP #environnement @CUGPSEO - VP @MairesRuraux78 - Président Honneur @ffjv_officiel - Président @Event2Give - référent @RepEnsemble 78;10775;1637;1949;8714;23075
Fleur2corail;Fleur de Corail;"L'homme regarde la fleur, la fleur sourit Le temps est une donnée fatale...    
à 🐍🐵🦎🐢🦀🦂🐂🐐🐑🐖🐀🦇🦃🐓🐕🐩
👂👀👁️👉👇 ☁️🌩️⚡️💧🌧️ 🌪️ 
Tic, tac, tic, tac…. 
👉🕛";16181;301;481;6101;23064
Keuh_Keuh;Edward Wanderhard đź¦™;Anarcho social Gaullisme, nan je dĂ©conne pour le Gaullisme !;5753;186;68;17032;23039
Pepere_06;Francois L;interessé par l'aviation et la chose militaire...;16359;373;241;6060;23033
elnandowa;el nando (anti RN-LFI-Z) abonné Franc-Tireur;bloqué par Taha Bouhafs, Nicolas Dupont-Aignan,Françoise Degois,Bruno Gaccio,Pr Éric Chabriere (IHU équipe de Raoult),Maxime Nicolle Gilet Jaune, OlivierTruchot;11600;1729;680;9020;23029
isabelle_senand;Isabelle Senand;Directrice des études à la Fédération des entreprises du Commerce et de la Distribution, @FCDfrance;15637;1877;3226;2286;23026
funrandomstring;.........;Pas la pour très longtemps;13609;147;136;9133;23025
JeanAicard;Jean  Aicard;"Expert en évolution professionnelle.
Ni avare, ni prodigue.
Ceci est mon compte personnel. Le twitter pro. est ici: @_AJ06
Website pro.: quater.fr";16324;2979;1942;1767;23012
jothiram;Jothi Ramalingam;Tamil Dravidian - Yaathum Oore Yaavarum Kelir.;4462;20;46;18474;23002
LudovicMiseur;Ludovic Miseur;#Technopédagogue - Ingénieur #pédagogique #multimédia diplômé 🎓@univ_lille | Empêcheur de penser en rond | #TIC #TICE #EdTech;10774;1391;938;9879;22982
NBathily;Nayé Anna Bathily;Manager, Ext Affairs, West&CentralAfrica @WorldBank Group Passions: #gender, #Africa, #education & #governance& #culture. MPA Mason @Harvard. Views my own;2339;428;18505;1675;22947
branislavmilic;Branislav Milić;Geopolitics and media disinformation watchdog / Crisis communication expert / FR, EN, SR.;19884;222;881;1959;22946
NAFOrrest_Gump;NAFOrrest Gump 🇪🇺🤝🏻🇺🇦;#NAFO #OFAN 🇨🇵;4409;5445;5615;7449;22918
mrbidon;Mr Bidon;"Ambiance café du commerce (géopolitique / politique française)

Cause aussi monde du travail, énergie et logiciel libre";7489;621;251;14531;22892
LIBERA1964;MéloMéli🤪;;7624;184;113;14961;22882
nqvfn;εὔνοια ••;Nail Tech 💅🏾 insta: nqvfn | 888;10709;209;317;11645;22880
Prefet972;Préfet de la Martinique;Compte officiel du préfet de la Martinique. Retrouvez-y l'actualité des services de l'Etat en Martinique.;5322;596;16158;801;22877
agence_bio;Agence BIO;"đ©âđŸ LâAgence FranĂ§aise pour un monde + bio, au service de lâintĂ©rĂȘt gĂ©nĂ©ral.
Le bio, bon pour (tout) le monde đ";6275;180;14279;2138;22872
JJODRY;Julien JODRY;Journaliste automobile - Rédacteur nouveautés - Illustrateur scoops - Vidéos YouTube - Podcasts - Magazine AUTO-MOTO depuis 2004 - @automotooffi - Horyzon Média;12403;1453;6380;2630;22866
JusteThomas;Thomas;"ð¨ðµ South Alps
ð» Mass event organisation
ð¿ Outdoor sports specialist
ð· IG: @mcbaghette";5847;594;115;16301;22857
bo_nass;nass;"Les humains sont égaux
Le savoir est une arme,dont le verbe est la munition.
Ne croit surtout pas tout ce qu'on te raconte.";9853;253;120;12621;22847
Casscroute1;Casscroute 🇫🇷🇲🇬;Nunca toca mi plata 😾;2006;77;27;20726;22836
Valenti01972391;Valentin T.;"Rabbitpool (le lapin de deadpool)
Ne pas lutter plus qu'on ne peut traduire, ne pas coopérer plus qu'on ne peut lutter
stablediffusion.fr/france";22655;2;6;171;22834
lephenix555;Le Phénix en attaque ✝️⚜️;La bienveillance est l'arme redoutable au fond des abimes. La lumière bannit la médiocrité. Elle revient à la face de Dieu avec force.🦅_Trump + JFK.jr + Flynn;13017;1969;2181;5644;22811
Roi_Orycteropes;Le Roi des Oryctéropes;"Pronoms : moi/je.

#SlavaUkraini";11062;606;172;10967;22807
Redseagull_56;Isa C;;5841;634;405;15909;22789
DidierGirard;DidierGirard［Ξ］🏃🐝🐦 ⚛️;co-CEO @Sfeir / Cloud Rider / GDE @Google / PhD @ENSdeLyon;10097;1352;4781;6553;22783
RNCan;Ressources naturelles;Ressources naturelles Canada émet des tweets sur ces sujets #Énergie, #Minière, #Foresterie Conditions d’utilisation : ow.ly/sjOSt English: @NRCan;16310;252;5499;715;22776
chouettalphabet;Mathieu đźš©;Heureux secrĂ©taire fĂ©dĂ©ral du @MJCF75, adhĂ©rent @PCF. Vendeur syndiquĂ© Ă  la CGT.;5429;863;937;15516;22745
BathroomTrailer;Restroom Trailers USA;Restroom trailer super center hub. We review restroom trailers, manufacturers, and industry specialists.;21411;66;1160;104;22741
IliasPanchard;Ilias Panchard;Co-président & élu @VertsLausannois 🌻🌍 | Campagnes @LesVertsSuisses & @CampaigncampCH 💡📱 | Team @RaphaelMahaim 💻🏛 | Président Sortir du Nucléaire ☢️🛢;5888;1636;2708;12492;22724
suvranu;#suvranu;"Soutien aux candidats Barons Mariani, régionalistes, souverainistes
RIC périodiques & monnaie locale #corse
#mariani2022 #législatives2022 #suvranu, tous barons";6663;4510;1086;10419;22678
YannWehrling;yannwehrling;Ecologiste, illustrateur, Président du Mouvement pour une Ecologie Positive ex @LesEcolos_parti, VP à l’écologie de Région IDF, ex-ambassadeur à l'environnement;7411;4680;8041;2543;22675
Prefet38;Préfet de l'Isère 🇨🇵🇪🇺;Compte officiel de la préfecture et des services de l'Etat en Isère.;5253;319;16323;755;22650
TontonKoeman;Jerem;Simple spectateur de football.;15219;331;343;6745;22638
leprincematthi2;Matthieu Leprince;"Ingénieur en bois, engagé intermittent, collectif accro, gros dormeur, vibrant pour la gôche.
Né à 323ppm.
#Montrouge";5624;1940;459;14589;22612
DelCdric;Cédric // Merci Daniil #USOpen;;16524;1086;307;4671;22588
sergevp;sergiovp;Juste un peu moqueur , mais pas méchant, réfractaire aux idéologies gauchistes.;11118;5001;1937;4528;22584
Phil_Tournier;Philippe Tournier;Personnel de direction - Ancien secrétaire général du SNPDEN-UNSA (2009-2018) - Agrégation d'Histoire - Doctorat EHESS - Ami des chats.;16096;180;2852;3456;22584
Lucbouard;Luc_Bouard;Maire-Président de @larochesuryonfr Ville&Agglomération | Conseiller @DepVendee | Secrétaire Général  @VillesdeFrance, président du groupe de travail « Europe»;6902;3257;6118;6302;22579
PrimeauGilles;Gilles Primeau;Aerospace eng’r. Studied 737MAX crashes (hyperlinks @ end) ourcommons.ca/Content/Commit…;9752;926;403;11495;22576
MichaelTrabbia;Michaël Trabbia;CEO @Orange Wholesale - Interim Chief Technology & Innovation - Board member HSBC CE & @Gsma - Former CEO Orange Belgium;6918;728;9039;5883;22568
cncd111111;CNCD-11.11.11;Le Centre National de Coopération au Développement-11.11.11 est une coupole d’ONG et un mouvement citoyen au service de la solidarité internationale.;11105;2705;6818;1930;22558
Prefet53;Préfète de la Mayenne;Compte officiel des services de l’État en Mayenne.;11890;368;9282;1017;22557
m_Romagnani;Matteo ð«ð·ðªðºð®ð¹;#Nice ð´â«ï¸ / 17 years / @HorizonsLeParti / @Territoiresdab / @NiceEnsemble06;3371;2091;324;16741;22527
anap_sante;ANAP;Accompagner les professionnels de la santé et du médico-social dans l'évolution de leurs organisations;6705;880;12052;2880;22517
mtremblay2010;Mario Tremblay;;18064;1940;690;1817;22511
pep_france;Ma France;Ma France, c'est celle de Charlemagne et de Rouget de L'isle.  Ma France c'est celle des clochers et des Cathédrales qui sonnent les heures.;22363;20;104;11;22498
lepindev;Lepindev;Tech & Bio;19982;603;494;1417;22496
glassofschotch;.;;2131;403;41;19905;22480
_yann_14;AS A;;7266;300;55;14857;22478
fchatot;Francis Chatot;"Helping save the planet/humanity activist :) #decroissance @GEcologie @LPOFrance @Greenpeacefr @Bloom_FR @L214
@Francis@piaille.fr";4079;1505;1057;15835;22476
WFP_Canada;WFP Canada;Canadian account of the United Nations World Food Programme, Laureate of the 2020 Nobel Peace Prize | Compte Canadien du Programme Alimentaire Mondial 🇨🇦;9227;1658;4858;6702;22445
MonlyAdam;Christobald Aqueyns ðð¦¤ð³ï¸;Pourquoi penser ainsi plutÃ´t quâautrement? Explorer les multiples facettes de cette question et entretenir le doute est la raison principale de ma prÃ©sence ici.;6470;536;546;14891;22443
ConferenceDesGE;Conférence des grandes écoles;Conférence des grandes écoles (CGE), depuis 1973 #ESR #Excellence #Diversité #Accréditations #Etudiants #Insertion #Territoires #International - 🎂#50ansCGE 🎉;6845;1173;9690;4711;22419
PGuerendel;Philippe Guerendel;Engineer w/ geophysics specialisation. Prof Experience (Tech, Mkt, Mgmt) in O&G sector. Interested in/tweet on energy matters, climate issues, politics;16308;524;1608;3969;22409
FredericMignard;Frédéric Mignard;Approfondir le cinéma, l'analyser, l'archiver... Passionné de distribution, d'exploitation, de marketing, de cinéma de genre et expert en box-office...;12693;685;1041;7984;22403
HoohChi;Socialix ⴰⵏⴻⵎⵍⴰⵢ le Kabyle;"Anti-raciste / Anti-colonialiste
ⵣ Kabyle ⵣ ⚒ Marxiste ⚒";6432;466;498;15005;22401
CCUNESCO;CCUNESCO;The Canadian Commission for UNESCO carries out the work of UNESCO in Canada | La Commission canadienne pour l’UNESCO met en œuvre la mission de l’UNESCO au Can.;5816;1613;3867;11096;22392
Prefet27;Préfet de l'Eure;Toutes les actualités de la préfecture et des services de l’#État dans l'#Eure;9704;705;9392;2589;22390
mpemediatwit;MPE-Média;Matières premières Energie Média, au coeur des matières premières et des énergies via mpe-media.com;15327;1731;1010;4319;22387
IUHPE;IUHPE - UIPES;International Union for #Health Promotion and Education. Celebrating 70 years of advancing global #healthpromotion #healthequity RT≠endorsement;9101;684;2930;9671;22386
MGhinsberg;Marc Ghinsberg;Centres d'intérêts : Philosophie Economie Politique. Je donne mon avis non comme bon mais comme mien. Montaigne;19868;71;329;2118;22386
vincentlaviole;Vincent Laviole;"""Je suis plus en colère que je ne suis rationnellement lucide."" F. Lordon.
#Nantes et #Rennes villes d'adoption
J'ai choisi la pilule rouge.";7784;769;303;13529;22385
alternatiba69;Alternatiba ANV Rhône;Mouvement citoyen pour le Climat et la Justice sociale 👊 🌍 📍AlternatiBar MDA Lyon 1er ✨ Nous soutenir : helloasso alternatiba Rhone 📷 : Vincent Bulant;10043;916;3598;7826;22383
mikoo287;Mikoo;dominé indocile;1503;447;25;20385;22360
filipmartins1;filip martins;"Proverbe 8.13. Craindre l'Eternel, c'est détester le mal.
L'arrogance, l'orgueil, la voie du mal
et la bouche perverse, voilà ce que je déteste (dit l'Eternel)";10364;123;253;11619;22359
CarolineDuboc;Caroline Duboc;;4982;1582;446;15330;22340
shutupalready68;ShutupAlready!;;3304;1324;219;17490;22337
Mathieu31359682;Mathieu roy;"équité; droit fiscal, actualité, international,";18936;1032;190;2172;22330
Prefet973;Préfet de la région Guyane 🇫🇷🇪🇺;Compte officiel des services de l’État de la région Guyane;6656;243;14567;860;22326
siddick_a;πππππππ π° β;"Β«Avouer quβon a eu tort, cβest prouver modestement quβon est devenu plus raisonnable.Β»
Jonathan Swift";8658;279;1878;11511;22326
CChristo132;Christian Hiot Hiot;Amateur de bières blondes;9372;623;80;12233;22308
blipblipwalpa;BABA;LEGACY;3530;309;74;18358;22271
ArnaudMatarin;Arnaud Matarin;đŁ Porte parole @NousSommesMTP ââđł Responsable Vie Associative. Tweete aussi #ESS #association #Montpellier et #littĂ©rature;4997;2239;1498;13536;22270
DieudonneBila;#rwandaiskilling;he/him development undergrad @universityleeds | membre du @KOPax_Officiel | #Team243 #AfricanGreatLakes #OSINT 🇬🇧🇨🇩;6161;3324;333;12452;22270
Diapasonmag;Diapason Mag;Mensuel. Le magazine francophone n°1 pour la musique, l'opéra et la hi-fi. L'amour du classique, la passion de l'excellence.;8401;2285;11535;43;22264
nikon56;nikon56;;15213;69;169;6801;22252
M_Aimeric;Aimericđź”»;Syndicaliste rĂ©volutionnaire / antifasciste / anticapitaliste / CGT metallurgie;2170;404;225;19439;22238
farahkhey;ðFarah;Mum ì/ARH-Education populaire/Le temps presse, agir maintenant pour le climat, c'est agir pour l'avenir de notre ð et ds gÃ©nÃ©rations futures #UrgenceClimatique;3875;925;344;17091;22235
ser_enr;SER;Compte officiel du #SER - Le Syndicat des énergies renouvelables #SER est l’organisation professionnelle française des #énergies #renouvelables #ENR;6140;1797;12295;1996;22228
barickbuema;Barick Buema;Journaliste de formation et de profession, vos paroles ne s'envolent plus !;11995;889;8631;713;22228
JorisBabinks;jo^^;;8035;88;72;14022;22217
ca_hurstel;Charles-Antoyne Hurstel;@WorldBank • @Georgetown / @AssasUniversite • Infrastructure, Climate, Politics • Personal views;14276;727;1345;5857;22205
taexiie45;Lucie || SEEING TWICE 11/09;"Fan of MCU 🎬
📚MCO23 💮02' liner 
Multistan💘
UG :  BTS, Enhypen, Oneus, The Boyz, Epex, Treasure 
UG : IVE
📱Tiktok : @taexiie_4";8500;654;465;12566;22185
Covidologie1;Eglise de Covidologie 50Xð (estimÃ© Ã  fin 2036)ð;Grand MaÃ®tre de l'Eglise de Covidologie depuis 2020. Pour 1000 ans.;6620;94;377;15075;22166
CanadaONU;Mission Canada ONU #StandWithUkraine ðºð¦;Mission permanente du ð¨ð¦ auprÃ¨s de lâONU EN: @CanadaUN | RP: @BobRae48 | RPA: @ArbeiterRichard;11655;1085;7324;2087;22151
pboureau31;Pascal Boureau;Prévisionniste Météo / Blagnac / Haute-Garonne / PS31;8142;835;1242;11892;22111
LGdT__;æ;;4824;441;214;16621;22100
until_till;UntilTill;;364;156;22;21548;22090
Inno24news;INNO24;Le site d’info 24/7 des magazines #GreenInnovation #SmartMobility #BioGaz #Hydrogen+ #EcoLogistics #BlueInnovation. Actualité innovation & développement durable;947;1429;962;18737;22075
EcoledesPonts;École des Ponts ParisTech;"Construire les mondes de demain.
Grande école d'ingénieurs 🎓 fondée en 1747.
Membre de @ParisEstSup et de @ParisTech_News.
#ecoledespontsparistech #WeAreEELISA";5870;632;11503;4070;22075
Amb_ZhuJing;Zhu Jing 朱京;"中国驻欧盟使团公使
Ministre Mission 🇨🇳 à 🇪🇺";2116;484;17927;1534;22061
Megoustastou;Mégane Gensous;La vie est un long feed tranquille. Journaliste médias et publicité - #JeCasseLambianceEnSoirée avec @NousToutesOrg - #TeamMoinsse;12666;1798;2050;5539;22053
AAC_Canada;AAC Canada;Agriculture et Agroalimentaire Canada | Conditions d'utilisation: ow.ly/XHSU50FjUvL | English: @AAFC_Canada;13226;87;8635;101;22049
Coenove;Coénove;Association regroupant les professionnels de l'#EfficacitéEnergétique dans le #bâtiment et portant la complémentarité des #énergies dt le rôle clé du #GazVert;9976;1858;3747;6452;22033
MGeopolitix;Mister Geopolitix;Youtubeur vulgarisateur de géopolitique (204K / TikTok 135K). Grand reporter et auteur (atlas, BD...). Je parle du monde et des enjeux qui s'y passent!;7609;1224;5929;7262;22024
frobine;Florence Robine;Ambassadrice de France auprès du Royaume de Norvège (précéd. Bulgarie) . ex rectrice des académies de Guyane, Rouen, Créteil, Grand Est. ex Dgesco.;6209;1150;8739;5925;22023
leQPH_fr;Le Quotidien du Pharmacien;Le Quotidien du Pharmacien est le journal préféré des décideurs de l’officine. Parution chaque jeudi. Tous les jours sur le web.;12826;367;8300;530;22023
LaTribuneMtp;La Tribune Montpellier;Le média de l'économie régionale, pour ne rien rater sur les #entreprises de l'#Occitanie-est. #BusinessSuccess;9244;1878;9989;895;22006
pirateM0;p̑̈ȋ̈ȓ̈ȃ̈t̑̈ȇ̈ f̑̈ŭ̈ğ̈ĭ̈t̆̈ĭ̈f̆̈(🇹🇩🇸🇩);A̾ m̾a̾n̾ i̾n̾v̾i̾n̾v̾i̾b̾l̾e̾ i̾n̾ i̾d̾i̾o̾m̾e̾;5988;2779;4829;8408;22004
MpianaKabs;Mpiana Kabs;;19775;431;760;1034;22000
vincentisse;William de Ghomras;;1487;1755;387;18371;22000
ivoiremessages;Al DIARRA;Journaletudes est un site qui procure les offres d'emploi stages concours;20323;1286;383;5;21997
Inalco;Inalco;Institut national des langues et civilisations orientales – Enseignement supérieur et recherche depuis 1795 #Inalco #LanguesO;8233;639;11069;2051;21992
Cardienec;Cardien Diemil;Actualités, Sciences, Culture;12872;337;112;8663;21984
Fabulous_911;Fabulous_911;| Olympique de Marseille | #TeamOM ⭐;17663;924;161;3221;21969
aquinum;Aquinum;Association des professionnels et futurs professionnels du Numérique en Nouvelle-Aquitaine - Gestion du @bxnode, 1er espace de #coworking des pro. du numérique;6415;1774;8169;5608;21966
michellabrie404;Michel Labrie — Justicier en moule-bite;"Connard de cycliste, grille les 🚦 comme les saucisses, trottoir = pistes cyclables et dépasse les 30km/h

Mastodon @michellabrie404@asocial.jacquesetmichel.fr";10053;619;469;10817;21958
Eurovia_France;Eurovia | France;#Eurovia est une marque des activités Route France de #VINCIConstruction;5375;1387;7386;7810;21958
sophiebejean;Béjean Sophie;Rectrice de la région académique Occitanie, chancelière des universités, rectrice de l'académie de Montpellier. Présidente de l’Afdesri (afdesri.fr);6171;1381;6070;8317;21939
denisvannier;Denis Vannier;"Journaliste (data+maps+motion) #dataviz #Géographie 
Sur Mastodon : denisvannier@piaille.fr";5443;5002;4303;7175;21923
jf_vincent;JF Vincent;Né à 319 PPM. #FaceTheClimateEmergency #ClimateJustice #biodiversité;5327;480;184;15925;21916
LatourXavier1;Xavier Latour;Conseiller municipal @VilledeNice - Vice-président @MétropoleNCA #EnseignementSup #Recherche #Formation - Président CA @EPA_EcoVallee;749;89;1075;19983;21896
elucid;ÉLUCID;"Média en ligne indépendant 🗞 + chaîne YouTube (urlr.me/BJ9wx)
👉Transmission de connaissances fondamentales et esprit critique";831;112;20810;141;21894
Fassty100;Nicolas ­čçź­čçĚ ­čç¬­čç║ ­čç║­čçŽ;;15539;33;66;6253;21891
Toull_Boued;Toull Boued;Misanthrope selon Platon, mais curieux du genre humain...;2147;213;37;19483;21880
fdecoster;François DECOSTER;Maire @VilleSaintOmer / VP @hautsdefrance #Culture #Patrimoine #Langues régionales #Relations #internationales / Président @RenewEuropeCoR / Président @onlille;4764;3674;5270;8171;21879
VivreenVille;Vivre en Ville;@VivreenVille contribue au développement de collectivités viables, à l’échelle du bâtiment, de la rue, du quartier & de l'agglomération | vivreenville.org;7753;1206;10881;2039;21879
L_As_tuce;L’As.tuce ;💡Je te partage des bons plans pour économiser et gagner quelques euros 💸;2922;95;8768;10054;21839
schrempfette;Claire Goyat;Directrice associée @entrecomsocial #SocialMedia #DigitalCommunities;5765;1560;1758;12756;21839
TEnreille;Thierry 🐾🎸 4x💉🇺🇦;;11596;562;186;9479;21823
maghaiti;Mag Haiti;ılıllılı...Bienvenue...ılıllı Société, musique, culture, sport, technologie, mode, art, vidéo, cinéma, politique,... Mag Haiti, le magazine d'Haïti.;15432;1122;4964;296;21814
jplecomti;jp;Tweete sur #energie #climat #environnement #velo #douaisis et autres gazouillis...;6825;669;188;14132;21814
emmoboyy;🇩🇿🇵🇸;"Je suis un ""sale gaucho de merde"" oui
Le communisme nous sauvera";3588;140;78;18008;21814
social_reflex;Hyst É Ribox;« Tant qu'il y a de la chlorophylle, il y a de l'espoir »;16527;202;1647;3434;21810
ChrisLenabour;Christine Le Nabour;Députée d’#IlleEtVilaine - VP @DeputesRE 🏛️ 🇫🇷 - 📍#Circo3505 / #jeunesse - #emploi - #inclusion / VP @UNmissionlocale;7304;1704;5827;6955;21790
davidfayon;David Fayon #réseauxsociaux #MadeinFrance;Numéricien engagé pour 🇫🇷🌍🐝 #TransfoNum | Auteur | Officier ® | Sport & course | Marié 👧👧🧒🐕 | #Paris (6, 14) #NouvelleEnergie | @rezosoc @fayon;13235;421;1191;6936;21783
AG2RLAMONDIALE;AG2R LA MONDIALE;Spécialiste de la protection sociale et patrimoniale #Prévoyance #Santé #Épargne #Retraite #PrendreLaMainSurDemain 📩 Toutes vos questions sur @AG2RLMQUESTIONS;5775;996;8965;6045;21781
Paula_CSR_SCMP;Paula Bernardino;"Montreal downtown urban gal with one foot in Toronto; Golden Square Mile citizen; MCM; SCMP; Corporate Social Responsibility (#CSR) focus; #travel; #wine lover";8216;2554;969;10033;21772
as_bello;Abdoul Salam Bello;"Executive Director @WorldBank Group
Administrateur @WorldBank Group";6717;2819;2435;9786;21757
VosgesTV;VosgesTV;La đź“ş de tous les Vosgiens du đźŚŽ linktr.ee/vosgestv;15004;354;6264;126;21748
Xavier_Delpech;Xavier Delpech;Rédacteur en chef de la RTD com. @Dalloz • Professeur associé de droit privé @Droit_Lyon3 • Président de la Société française de droit aérien et spatial;6666;500;5172;9402;21740
LaugierMichel;Michel LAUGIER;Sénateur des Yvelines;3056;854;2433;15375;21718
strawb3rrmy;kla;book, coffee and plants addictđȘŽđïžđȘâąArianaâąTaylor stanđ©”  @rclens;7420;247;141;13898;21706
lkdkiddkdlkd;Lkdkiddkdlkd;;462;45;2;21186;21695
BianchiDaniele8;Bianchi Daniele;Essayiste, enseignant, juriste, curieux...;17240;117;81;4256;21694
PaulSernine9;Paul Sernine;@PaulSernine6 est mort, vive @PaulSernine9 !;9256;413;128;11873;21670
MadridIsabel;Isabel Madrid;đadjointe au maire et VP du CCAS de Talence, UNCCAS, #innovation #marketing territorial, prĂ©sidente Monalisa33 đ€Č;7225;2435;1636;10371;21667
saskiabricmont;Saskia Bricmont đź‡Şđź‡ş;Member of European Parliament | @greensEFA @Ecolo | Committees: @EP_Trade @EP_Justice &migration | Children rights and human rights | Feminist;6776;1966;7950;4960;21652
Lacourt05602281;Lacourtéchel;"spécialiste de la cuisine provençale et des petits pains traditionnels, a travaillé chez Mac Donald.
Défends tous les insectes, et lutte contre l'usage des pest";14559;133;68;6890;21650
zirealvipi;Zi real vipi;"New compte en cours de creation. 
C'est super (Biiip) de re-follower plein de gens.
je tweete quand c'est fini... ou avant ð";19578;724;129;1216;21647
WALTERLURE75;HERVE CARRESSE;"Expert en gestion et COM de crise, ex colonel BSPP. Breveté école de guerre.
""Agir en primitif et prévoir en stratège."" 
 ""Attaquons, attaquons…comme la Lune.""";9316;1021;1961;9332;21630
Hergastul;Hergastul;"Entrepreneur, trader, consultant ou branleur selon les saisons.
Site web : vivredutrading.com";12439;80;4192;4914;21625
ClarisJay;Jay Clarisse;Rédactrice en chef Fonction publique à AEF info / Compte perso;16032;1641;2132;1815;21620
ArmandBukula;Armand Bukula;Expert Évaluateur de Programme. Expert en Marchés Publics. Chef de Bureau à la Décentralisation. Consultant. Père. Époux.;6054;1370;385;13796;21605
Ramanirabahoak4;Ramanirabahoaka Sahondra;"Médecin ( Interne HOMI à Madagascar, Pratique hôpital Sion Suisse;Spécialités médicales: Médecine tropicale; Insertion socio- professionnelle et handicaps Paris";10006;343;216;11034;21599
JouranalM;Jouranal;Pourvoyeur d'opinions, certaines vont vous déplaire.;8422;896;934;11345;21597
Axel_Darut;Axel DARUT;Circular Economy activist @No_PlasticWaste initiative -@minderoo♻️🌍🇪🇺 Co-author plaidoyer-lobbying.fr with @MichelGermond 📣🌿 between 🇳🇱🇧🇪🇨🇵;4097;4998;1823;10679;21597
LeonSaintEloi;Moraline;Construisons la Forteresse Europe !;8927;137;145;12374;21583
burn_lies77;ⵣ MACRON/RN HATE ACCOUNT;allergique à la droite, a l’extrême droite ainsi qu’aux misogynes. @burn_lies7;8157;98;4249;9076;21580
HugoMerrir;Hugo;all turned into one đ;8962;890;845;10883;21580
karinehamelin;HAMELIN Karine;;856;436;75;20203;21570
ReclaimFinance;Reclaim Finance;"Our mission: making finance work for the climate.
Membre des @amisdelaterre.
Newsletters: EN bit.ly/2TET3qF - FR urlz.fr/cI6g";6055;1614;8360;5540;21569
_ThDa;Kaptain_Lib;Liberté et Progrès.;19205;133;2061;167;21566
Cigref;Cigref;Le Cigref rassemble, diffuse, promeut et défend les positions collectives de ses membres sur leurs enjeux numériques. // 🇬🇧 : @Cigref_EN;8454;1066;8474;3563;21557
ReyBfr;Rey B.;What else ?;20380;87;209;878;21554
nicolas_mig1;Nicolas M.;Alumni @Dauphine_M299, Affaires publiques, Énergies, Métaux ⚡️ Views are personal 🌱;1591;1126;522;18295;21534
RNCREQ;RNCREQ;Avec ses membres, les 16 conseils régionaux de l'environnement, le RNCREQ a pour mission de protéger l'environnement et de promouvoir le dvpt durable au Québec;8587;1816;3913;7189;21505
adrelanine_;adre 🎞;photographe instagram.com/adrelanine | Ici on donne on reprend pas ce qu'on a donné en trop;6567;367;6888;7682;21504
villederueil;Rueil-Malmaison;Twitter officiel de la Ville de Rueil-Malmaison (92500). Actualités, infos pratiques, projets... Bienvenue à #Rueil;15134;121;5463;756;21474
ZizouPremier;ZizouPremier;;13370;427;141;7528;21466
HCheeseland;Hello Cheeseland;economiste en vacances;8381;30;38;13011;21460
Coucou13482;péonard 🔥❤️💙;Supporter du grand PSG | CM @ICParisSG ❤️💙 | Ancien CM de ton équipe com' préférée;17814;1221;379;2044;21458
cetondada;Léna;Depuis sa 3ème dose de vaccin mon père a eu 1 péricardite et 2 AVC. Macron et son Gouvernement en PRISON.;5083;3408;3991;8951;21433
RICEMUTZEN;MAURICE MUTZENMACHER;“Quand je vois ce que je vois et que j'entends ce que j'entends, je suis bien content de penser ce que je pense.” . Zéro dose .;1990;1486;1411;16522;21409
Blacksummer59;Emeric 🥀;J'avais trouvé un truc bien à dire sur moi mais j'ai oublié.;13971;349;56;7028;21404
VadcarCorinne;Corinne Vadcar;Global Value Chains, Business Models, World Trade, and Geopolitics issues in international Trade and Transport;14209;539;1347;5307;21402
Carole_Guillerm;Carole Guillerm;Conseillère régionale IDF #majoritepresidentielle / Députée-suppléante @JLBourlanges / Conseillère municipale #Châtillon 🌱;1819;3314;2803;13465;21401
VilledeTroyes;Ville de Troyes;Twitter officiel de la Ville de Troyes ð #troyes ð #fierdetroyes ð #troyesmavilleð;10415;362;8698;1913;21388
anelkamanzila2;anelka manzila;analyste  politique;11285;632;2495;6973;21385
laCSN;CSN;Compte officiel du #MouvementCSN, la Confédération des syndicats nationaux. Présidence : @CaroSenneville // #SyndQc #CanLab #UnionStrong;11002;1560;8530;270;21362
GuyGeorgette1;Guy Georgette;pro nucléaire, fumeur, alcoolique, conducteur de diesels;10860;1003;252;9246;21361
lHoebbs;Hoebbsđ«đ·;;9954;456;154;10795;21359
TEssolomwa;Thy René Essolomwa;Économiste |Entrepreneur |Président National de L’Alliance des Démocrates Révolutionnaires du Congo @Adrc_officiel;3266;638;1204;16247;21355
Alain29430;Alain P;;1736;153;101;19351;21341
dominiquebasten;dominique bastenier;"Juriste, Echevin et inspecteur général honoraire
Mes propos n'engagent que moi.";13672;395;182;7082;21331
GroupeADP;Groupe ADP;Accueillir les passagers, exploiter & imaginer des aéroports de manière responsable dans 50 pays et sur 120 aéroports🛫🌎 Support passager sur @ParisAeroport;5976;659;12049;2643;21327
Amelie_Fayard;La Roussignole 😉;#NUPES #EELV #CGT. J'ai un 🐱, elle s'appelle Luna.;8947;590;235;11550;21322
TheMetroidPrime;TheMetroidPrime;[Place of work] | [Irrelevant hobbies] | [Idiotic political take] | [Unveiled insecurities] | [Cringy punchline] | [Autistic pronouns] | Contrarian c***;11403;1088;196;8620;21307
afriquedemain;La plateforme Afrique de Demain;Plateforme apolitique . Pour une #Afrique #Africa forte. Soyez aux faits d'une Afrique qui avance.@bienvenueatous  #developpement.L'#info #tweet-ée #retweet-ée;10713;2568;2720;5289;21290
EricBezouSUD;Eric Bezou;"Militant à Révolution Permanente
Les #TartuffesSociopathes de la classe dirigeante capitaliste vont tous nous tuer, battons-nous
l'écologie est d'extrême gauche";12235;266;1071;7714;21286
sergeMNL;Serge MN;Je défends ce que je crois être les valeurs, pas les hommes.;9972;263;344;10699;21278
ReseauUQ;Université du Québec;Nous sommes l’Université du Québec. Le réseau collaboratif francophone de 10 établissements reconnu pour son excellence, son accessibilité et son ouverture.;7859;2262;8377;2753;21251
TeddyVaury;Teddy Vaury;Rédacteur en chef @LeRep91 / Journaliste local Sud-Essonne / Sur le terrain, les gens s'expriment sans complexe. #LiberteDExpression;13824;1979;1902;3543;21248
Boudaud2020;Alexis Boudaud Anduaga;Fondateur @ecoautrement « Comment en est-on arrivés là? » En se taisant à chaque fois que c’était la liberté des autres qui était visée 🐝 L’ÉCOLOGIE AUTREMENT!;9953;4827;1738;4701;21219
thenoobinvest;Jake | Le Coffre fort đ¶;Sois LE moteur dans la gestion de TON #Ă©pargne ! Comprendre đ GĂ©rer đ Diversifier đ Fructifier đž son capital, voila ce dont nous parlerons ici ! đ€;4812;162;1826;14415;21215
PascaleStOnge_;Pascale St-Onge;Députée | MP Brome-Missisquoi 🏳️‍🌈 Ministre des Sports et ministre responsable de l’Agence de développement économique du Canada pour les régions du Québec;6934;1575;5708;6997;21214
sebmadinchina;Sebmadinchina;;11319;310;69;9507;21205
ajeanse7;J-Sé Leclerc;Indépendantiste, féministe, athée, épicurien, fan de hockey/tennis/Fleet Foxes/Allo Simmone... dans le désordre heureusement;4734;122;152;16196;21204
BlackBondPtv;Black Bond PTV;Guerrier de la lumière 🦁😇⚔️ Leur tyrannie n'est pas possible sans notre conformité;9397;78;10068;1654;21197
maviau;M-A Viau;Directeur des relations gouvernementales | Director, Government Relations ➡️ @equiterre. Retraité de la politique ➡️🥇2017 |🥈2011 |🥉2015;14285;1070;2311;3523;21189
Louvelour;Racine Pourrie;"l Homme finira par s entre tuer 
trop de dégâts  l 'excuse Covid (+) 
c'était déjà dans l'air...l' Ère";10298;414;109;10350;21171
webrokker;cynara scolymus;;9371;3696;930;7160;21157
midy_paul;Paul Midy;đ«đ· DĂ©putĂ© de Paris-Saclay (Essonne) âą Membre du @CNNum âą Entrepreneur âą Co-fondateur de @paris_digitale âą #Numerique #FrenchTech #MidyĂ14h;3378;2806;7044;7928;21156
LaurentSln;Laurent;;11058;23;32;10039;21152
FlammeEtBougie;LaBougie;Love humans & animals  - Organic geek - Travel ninja - Music buff - Yogi - Lifelong communicator - #savetheplanet;2595;1328;1265;15961;21149
Ducrocq20245031;Ducrocq20245037;"Changer notre modèle économique, engager la transition bas carbone et combattre l'injustice sociale, sauvons la planète!!!
@TheShifters #ilnousfautunplan";10120;227;48;10752;21147
Moulrchwa;Legalize complotism;Everything I say is either an advice or a joke protected under the Freedom of Speech act;4836;685;78;15514;21113
slimanebh;Slimane BenHaddou;;4231;2372;131;14361;21095
DealHenri;DEAL HENRI;;2504;358;202;18014;21078
MikeLan73479808;Mike Lan;;2575;247;70;18166;21058
Nicolas13576445;Remo Williams π«π· π¬π§ππx 24 πππ¬π§ π«π·;dodging bullets ... and running on water and wet cement;5995;225;99;14730;21049
Rodalajoie;RDJ đ§©;taureau ascendant chelou.;12140;228;88;8564;21020
SFRIMAUDEAU;Stéphane Frimaudeau;Président du groupe Cocktail Vision #LRSY #Vendée #paysdelaloire #snpn #numérique #gustavbycocktail #cocktailCampus #publiscoop #videoled #pixity #LionsClub;10656;699;1742;7919;21016
blogthis;Jeremy Hardouin;#Web / #Marketing / #SEO / #Design / #Ergo / #Dev / #SysAdmin et #Geek IRL;20744;81;176;9;21010
Lets_go9999;Let's go;Ingénieur informaticien, passionné par les sciences, aéronautique, astronomie, photographie. Ne supporte pas l'injustice, la malhonnêteté et les fake news.;10939;367;82;9608;20996
BShirizadeh;Behrang Shirizadeh;"Researcher & Consultant in #EnergySystemModeling & #EnergyMarkets.
PhD in Economics from @cired8568, Engineer from @Polytechnique & @SharifSocial.
#NetZero đ€";4680;582;1864;13867;20993
cecile_natacha;Natacha PETIT #EAC compte perso;Référente Patrimoine-Musées DAAC Normandie, Service éducatif à la RMM, Formatrice academique CAFFA: Former les enseignants à la mise en place du PEAC;1112;3754;1161;14963;20990
EBaraille;Emmanuel Baraille;#Poleemploi #emploi #toulouse #recrutement #AvecPôleEmploi #aerodiag #digital #rh #Toulouse #Occitanie #TousMobilisés;11606;3540;1944;3882;20972
daillymoise;DAILLY Donald;Économiste, Consultant Expert en Commerce International Spécialiste de l'Industrie Manufacturière, (Fabrication Additive, Impression 3D);9742;2482;418;8323;20965
PYJeholet;Pierre-Yves Jeholet;Ministre-Président du Gouvernement de la Fédération Wallonie-Bruxelles;4284;829;9649;6182;20944
VOdille;Vincent Odille;tombé dans l'agriculture quand il était tout petit, passionné automobile, TPE contrôle technique pulvé, conseiller municipal.;15513;93;190;5148;20944
mariane_yogbag;Mariane.🇨🇲;"Love to have fun....
Passionate about laughing😹.
It isn't that serious 🌚...🇨🇲
In love with the one and only Jesus Christ❤️.";5032;373;919;14594;20918
apo_source_fr;APO Group Français;"Derniers #Communiqués liés à l'#Afrique & au #MENA émis par entreprises, gouvs, orgs intl #Actualité EN:@apo_source ; PT:@apo_source_pt AR:@apo_source_ar";18855;5;2054;0;20914
isisdibala21;isis;rien que la vérité;6155;4989;3853;5909;20906
Amalouking;Abdelfattah AMALOU;I'am a young self-educated wise&Courageous so i'am successful in my supremes jobs are imperialist,Monarch,Nazis,Dictator,Politician positive&Businessman*abdf*am;11953;5002;753;3196;20904
PFo76059148;CHAMPIONS 2021;;1912;458;88;18411;20869
_MaxLoisel;Maxime Loisel;De gauche @partisocialiste #NUPESđčLutte pour lâĂ©galitĂ© des droits @HES_France đłïžâđđłïžââ§ïž| PassĂ© par @ONF_Officiel | Jâaime bien les photos đž;3162;581;709;16409;20861
CyrusOuthala;Alioune Diallo;;20538;2;6;311;20857
RisukeAlchemist;Oly ð§ªâï¸;Rien ne se perd, rien ne se crÃ©e,tout se transforme, le monde physique est purement mathÃ©matique ð§ª;8663;663;1354;10161;20841
vis_spiritus;๐๐๐  ๐ ๐๐๐๐๐ก๐ข๐;"รtudiant en lettres modernes. 25 ans.

N'a d'yeux que pour l'essentiel.

ุฃูุง ุนุจุฏู ู ุฃูุช ุฑุจูุ ูุง ููุนุจุฏ ุฅูุง ุณูุฏู

๐จ๐ต  ๐ฉ๐ฟ";9732;444;721;9940;20837
ThibautGuilluy;Thibaut Guilluy;Haut-commissaire à l’emploi et l’engagement des entreprises / Initiateur du French Impact | ex DG du groupe Ares / Tenzing;4310;1377;8542;6588;20817
Renaud_83990;Reno;Contre la colonisation, même de la #France. Le #Wokisme étant un nihilisme tu finiras toi aussi excommunié par le dernier Torquemada #RadioLondres #Reconquête;8456;2825;1190;8343;20814
OctarRuga;Octar Ruga;De Lisbonne à Vladivostok ! 💤;15349;700;2668;2096;20813
MarieCoviaux;Marie Coviaux 🚵🏼‍♀️ 🌍 @MarieCoviaux@masto.bike;#cycliste #musicienne #voyageavelo #musiqueancienne #velotaf #feministe #musiqueceltique #bouquins #bidouille #ecologie....;2216;786;655;17152;20809
Newgoalnewlife1;Newgoalnewlife;Corazon;8536;389;346;11509;20780
BriereSimon;Simon Briere;Made in ­čçĘ­čçŽ MTL & TOR Strat├Ęge Principal at RJO Futures trading involves substantial risk of loss and is not suitable for all.;10269;1024;1742;7743;20778
Dr_abdoulahad;­Łôô­ŁôÉ­ŁôÉ;You donÔÇÖt need permission to be yourself... be your first fan P├ędiatre, cardio-p├ędiatre, sp├ę en PEC VIH ┘ä┘ä┘ç ěúěşě» ěž┘ä┘ä┘ç ěž┘âěĘě▒ #husband #medlife #urgentiste #OM;6803;1959;2961;9033;20756
moussak24368932;moussa kabore;Aime le sport, particulièrement le foot, la politique et les défis sociaux.;3465;750;130;16386;20731
luomanmpg;Luoman;;5450;146;44;15088;20728
LarameeDe;Valéry Laramée de Tannenberg;Journaliste. #Climat & #vin. Dernier ouvrage paru: Agir pour le climat, entre éthique et profit. Président @ajeasso Red'chef de @UsineGes;9731;2826;1206;6962;20725
VelotafAnnecy;#MamanVeloTafeuseAnnecy;passionnée de mobilités actives, stationnement, espace public et voirie à Annecy;5142;454;1018;14105;20719
ecolosceptique;GreatResistance!;ð«ð· ð¸ðª ð­ðºð®ð¹Je mange des ð et des ð en hivers parceque câest bon! Jâemmerde les socialos, les cocos et les ecolos!;1913;370;161;18267;20711
Laschamps2;Laschamps;Alternance de nuages et d'éclaircies;7095;53;82;13475;20705
esprism_spirit;Esprism;Je peux faire une analyse structurelle ?;18567;32;126;1979;20704
Convrocks;Greg ⚡️ The ChatGPT Post;Indie B2B Marketing Manager ⚡️ Building @ChatGPTPost;4651;645;468;14926;20690
VonbraunWerner;Werner Vonbraun;Gilet jaune amateur. Si t’as cinquante ans et que tu n’as pas de Jaguar, alors tu n’est pas un vrai gilet jaune.;18869;19;64;1724;20676
GregRoquett;Grégoire Roquette ن 🇫🇷🇪🇺🇦🇲;"Adhérent : @apfhandicap, @L214, @printempsrepub, @theShiftPR0JECT.

#JeSuisCharlie
#JeSuisMila
#JeSuisSamuelPaty
#JeSuisSalmanRushdie
#StandWithUkraine";5468;2348;380;12467;20663
AdamouMahamad2;Adamou Mahamadou;;5815;643;3688;10513;20659
dh_nicolas;Nicolas.E;;15714;98;95;4720;20627
ar_cunn;Lann ar C'hunn;Les riches et les pauvres sont injustement accablés;4588;1255;288;14487;20618
MajalisAlAdab;✌🏼ض🌿 طائر الهدهد 🕊️;Jeune terroriste intellectuelle φ ✨ #Sorority🔸#Antifascist🔸#ProtectTheOceans 🌊🐳🔸#Geopolitics 🧐🔸#WaterScarcity💧🔸#Poetry🌹۞s33v35۞🌿وأفوّضُ أمري إلى الله;7661;990;854;11113;20618
xandrerodriguez;Xandre Rodríguez;Celebrating photobooks goo.gl/VISK4C;15292;2522;416;2385;20615
tahiti_m;Juste une tahitienne;Neo insoumise. Punk à chat. Zadiste. Convertie au Mélenchonisme radicalisé ! Non à la disparition de la nuance….Ici c est humanité, écologie et démocratie ✌🏽;3560;668;386;15984;20598
severineboutry;severine boutry;CEO Le Nouvel Appartement, #digitalagency #socialmedia, #beauty #lifestyle #wine #retail, VP @CEWFrance;8786;3418;1213;7178;20595
CIP_ICU;CIP-ICU;Canadian Institute of Planners (CIP)│L'Institut canadien des urbanistes (ICU). The voice of Canada's planning community.;8546;1441;6877;3718;20582
Alainklain2;Lanceur D'alertesð¨;A la recherche de la vÃ©ritÃ©;12762;421;7252;145;20580
alainGomiS;Oupoyi Alain GOMIS;Président de l’Association Panafricaine ASILI. 📚Géopolitique Africaine🥇Politique👸🏿 Culture 🏭 Entrepreneuriat 🛰 Développement 🌍 Sport ♟;8993;435;689;10453;20570
Pierls1;Pierls;;9833;134;30;10571;20568
librefrancois;Ze FranĂ§ois Gerber đ;"20Y+ VC & equities fund manager
Cofounder & President of 400 MâŹ AUM AM company
Now long/short portfolio manager (prop trading)
tinyurl.com/francoisgerber";9172;2721;1534;7127;20554
stephantasme;gruno benesio;;6478;140;81;13833;20532
vdnbruay;Voix du Nord Bruay;L'actualité du Bruaysis passe par ici en... 140 signes maxi;18172;117;2190;43;20522
DawnyCedric;Cédric Dawny;Maquisard du bitume et anarchiste du dimanche - cosmopolite. P4;16290;406;390;3432;20518
CrisCri21572156;Cris Cris;;15377;279;67;4793;20516
Yosko_6;Un Bourgade;;4886;2720;2901;9989;20496
DoubleL77619382;"Louis ""Double L"" đż";"EsthĂšte et homme de goĂ»t...
""Jamais un envieux ne pardonne au mĂ©rite"" (Corneille)";12653;558;248;7021;20480
SolidLaique;Solidarité Laïque;Éduqué.e.s aujourd'hui, plus libres demain.;10861;1106;4721;3789;20477
Canard2feu;Pierre;Trentenaire dépressif;4731;202;116;15426;20475
RucheParis;La Ruche;ð La Ruche forme ð©âð«, accompagne ð¤, conseille ðââï¸, soutient, offre un espace pour vous rÃ©aliser partout en France ð« #UnImpactPositifEnCommun;4738;1023;13166;1539;20466
slash_anti;𝘼𝙣𝙩𝙞𝙎𝙡𝙖𝙨𝙝;J'aime pô les slash.;7476;299;57;12632;20464
WeAreLeonard;Leonard;Innovation, foresight and acceleration of transformative projects in #Cities & #Infrastructure by @VINCI || Prospective et projets innovants par @VINCI_fr;7602;2438;5593;4830;20463
MbulukuMoise;Moise Mbuluku;Diplomate de formation et Aspirant politique congolaisðŸ‡¨ðŸ‡©;3291;550;1070;15549;20460
JacquesBrouleau;Jacques Brouleau;Consultant (politiques éducatives) - Membre des #EditionsEPS - EPS - Sport - Santé - Activité Physique - Hovawart 🐾 🐕;6585;738;2029;11105;20457
sylze;Sylviane Zehil;NY & UN-based Bureau Chief for L’Orient Le Jour. Information is my passion, I believe in its power. The best way to connect the dots.;12782;3663;1405;2596;20446
recycquebec;RECYC-QUÉBEC;"Au coeur de l'action pour une gestion responsable des matières résiduelles.
#réduction #réemploi #récupération #recyclage #3RV #GMR";5262;870;12521;1770;20423
ArseneSoude;Arsène Soudé;Un but😎 est un rêve avec un délai👌;20349;11;41;0;20401
Verrecp;pascal verrecchia;;19039;596;528;227;20390
MartinB_Qc;Martin Brie;La #democratie, les #medias, l'#innovation, l'#environnement, la #transition, le zeitgeist. Fier non partisan! Compte personnel.;4912;1538;785;13142;20377
JCC71983000;JCC_UPR;"Adhérent UPR, @UPR_Asselineau
#FREXIT #BREXIT #NEXIT
#UnionSouverainiste";6237;1260;391;12467;20355
fondarespublica;Fondation ResPublica;Fondation de recherche reconnue d'utilité publique. Présidente: @MFBechtel. Président d'honneur et fondateur: @Chevenement. Directeur: @JLeFlochImad;10872;854;8495;132;20353
FredericRequin;Frédéric REQUIN 🍅🥚✊;;5676;220;48;14396;20340
claudinepier;pierron;#i4emploiR #Carriere #RH #Recrutement #Apprentissage #FranceApprenante #Digital #Réseauxsociaux #Lifelonglearning #Employabilité;16461;967;1111;1798;20337
KalundaFortune;Fortune KALUNDA;Fièrement Congolaise🇨🇩Offrir un Congo meilleur Assurer sa Grandeur #RwandaisKilling;1994;435;462;17437;20328
AzrodMaraeth;Maraeth Azrod;"Economie, Technologie, Histoire, Politique 🌍

National-Liberal, Gaulliste, réaliste🏰";11323;735;141;8114;20313
stertrais;Sébastien Tertrais;Directeur d'études, prospectiviste, entrepreneur, faiseur de liens. Science, culture, artisanat, numérique, politique, cuisine, boulange au levain. Autodidacte.;6454;443;1923;11486;20306
_pollhup42;The passager du transatlantique;C'est compliqué. Libertaire extrémiste. Fan des cartons rouges au stade France.  Ingénieur telco à ses heures perdues.;5744;1485;218;12858;20305
BGonthiez;Bertrand Gonthiez đź’§đźŚŤ;HydrogĂ©ologue, Directeur @KrauszFrance Industries  @MuellerWaterPro - Auteur #Eyrolles - Chef de projet @HSF_ONG - #Gers #BiodiversitĂ© #ODD #eau;3141;1668;791;14705;20305
smithmasela2;Smith MASELA;Criminologue de formation en sécurité intérieure,croyant du message de WMB,cordo CJACO/HK chargé du social à la thématique jeunesse de la société civile HK;635;731;1013;17915;20294
lapincoquin12;ME;membre depuis 2012 mais actif depuis 2022. Queb-juif centre politiquement, souverainiste.;10820;49;38;9371;20278
AgricultureFr;AgricultureFr;Suivez l'actualité et les dernières informations du monde agricole en France - #agriculture #elevage;12697;236;7342;0;20275
BretagneBDI;Bretagne Développement Innovation;"Agence de développement économique de la @regionbretagne.
📩 Suivez notre actu : bdi.fr/fr/newsletter/
🤝 Adhérez à BDI : bdi.fr/fr/adherer-a-b…";5790;502;11470;2493;20255
cremtl;CRE-Montréal;Org. de bienfaisance indépendant engagé dans la protection de l’environnement et contribuant à accélérer la transition socio-écologique sur l'île de Montréal;8963;1216;7362;2684;20225
TurbineCoop;La Turbine.coop;"Fabrique collaborative de services numériques d'intérêt général. Data, co-conception numérique, tiers-lieu d'innovation ouverte.  
🐘@TurbineCoop@piaille.fr";12196;1582;3794;2646;20218
Rue89Bordeaux;Rue89 Bordeaux;Infos, reportages et enquêtes dans la métropole bordelaise;5525;102;14458;125;20210
Forti_Saremu;Roy Lichtenstein;;9857;688;150;9509;20204
FaureDominique;Dominique Faure;Ministre déléguée chargée des Collectivités territoriales et de la Ruralité 🇫🇷🌳 | Élue du Lauragais | Élue à Saint-Orens-de-Gameville et @Toulouse métropole;2488;918;9394;7392;20192
willenk67;Willenk Von SchlagburgđȘđș;LibĂ©rons et protĂ©geons l'humain. Ecologie par la responsabilitĂ© individuelle. đȘđș mais pas Ă  l'đșđž . DĂ©centralisation & EgalitĂ© des chances. Pro @DavidLisnard;9016;177;62;10930;20185
VimMistara;MISTARA Vim;Born Free, Live Free;8584;507;225;10856;20172
DelanlssaysEric;Skylpatine;Professeur et Passionné d'Histoire  :  Egypte hellenist, Rome, 15e-18e Fr, Angl, Ier Empire, Restaur, Litterat. Polit. 😃...;8738;2964;377;8085;20164
bernardilboudo;Bernard ILBOUDO;"Actualités et opinions.
Systèmes de santé.";6354;306;714;12773;20147
RobertLortie;Robert Lortie đ;Chercheur en rĂ©mission n'ayant jamais rejoint le CĂŽtĂ© Sombre. SĂ©vĂšrement environnementaliste. Recovering researcher, would not join the Dark Side. Climate hawk.;4804;105;109;15111;20129
aleyhlarabi;aley;;18939;76;43;1066;20124
PhilippeRapha15;Philippe Raphael;Celui qui dit la vérité est toujours insupportable (Roger Fournier).;6314;5000;3996;4808;20118
cboissiere;Catherine Boissière;#culture #media #musique #spectaclevivant #artsgraphiques #communication / mes tweets n’engagent que moi;4641;1598;1851;12016;20106
Peter_and_pan;Peter And Pan;#FollowBackNupes;2535;521;76;16965;20097
PandaGraou;PandaGraou ð¼ðð¢;"Sombre optimiste. Ã gauche ! 
#Papað¨, en couple et amoureux ðð¤­ #Ferrovipathe ð aussi  #Ã©colo que possible.
Je sÃ©vis en Cerdagne â°ï¸ðððï¸ð¶ðð´ââï¸";8572;694;493;10335;20094
eduscol_prim;éduscol Prim à bord;Compte #Primàbord de @eduscol. Usages du numérique pour l'école primaire. Tenu par l'équipe Prim à bord. DGESCO/DNE;2822;488;10054;6719;20083
ParisSGodMod;侍 Bushido 武士道 🔻;''La crise historique de l'humanité se réduit à la crise de la direction révolutionnaire'';7972;141;71;11897;20081
falasociale;Groupe La Sociale Fédération Anarchiste Rennes;L'anarchisme tire ses origines du refus de l'oppression et de l'exploitation de l'homme par l'homme. Temps forts: France CGT 1906, Ukraine 1920 Espagne 1936...;8527;554;1231;9764;20076
PtiteRepublique;Petite République;Journal d'informations locales du Volvestre;19629;8;413;16;20066
MaisonDD;Maison dév durable;La Maison du développement durable est un projet citoyen qui se veut un pôle d’éducation, d’innovations et de rencontres sur le développement durable.;7004;1079;10493;1479;20055
Laure__Bourdon;Laure Bourdon;"đź’ĽDirectrice de cabinet/Chief of Staff to the CEO & Head of communication @Haffnerenergy #Industrie #HydrogĂ¨neVert #FrenchFab I
Ex @AssembleeNat I Compte perso";6001;2610;1399;10043;20053
Aerlhn;Aerlhn;Environnement ð³ð², science âï¸, espace ð, â¦;4210;98;49;15685;20042
MarlowSteve1;Marlow Steve;Oser entreprendre pour atteindre ses rêves;15487;648;375;3523;20033
Aclark1989;Alain Clark đšđ” đŹđ§đȘđș;Ceux qui fustigent les Ă©lites en font partie en rĂ©alitĂ© mais veulent s'approprier le pouvoir en faisant croire au peuple  qu'ils le reprĂ©sentent;9965;418;295;9348;20026
Soumaho11600568;Soumahoro Moussa;Le fait que je sois un artiste un peu olé olé.;16130;134;68;3692;20024
justinmakangara;Justin Makangara;Photojournalist @Reuters #congoinconversation #VIIinsider for assignment email:justmakson@gmail.com ☎️+243 997581539 @diversifyphoto up next @VIIacademy alumni;6301;2418;866;10426;20011
JeanTourloop;Jean Jean;Il n'y a point de plus cruelle tyrannie que celle que l'on exerce à l'ombre des lois et avec les couleurs de la justice - Montesquieu;10039;305;145;9517;20006
Donnatkalala2B1;Donnatkalala@2Best;Acteur social, défenseur de la vérité...®D©🇨🇩💯❤️💝💖💗 mon pays ... Never Say die💪;3290;2880;3068;10753;19991
sretailleau;Sylvie Retailleau;đź‡«đź‡· Ministre de l'Enseignement supĂ©rieur et de la Recherche | đź§‘đźŹĽâ€ŤđźŽ“ Enseignante-chercheuse en physique & en Ă©lectronique, ancienne prĂ©sidente d'universitĂ©;1022;637;16855;1476;19990
christianheitz;Christian Heitz;citoyenneté, tourisme durable, plein air, réseaux sociaux;16827;223;472;2455;19977
AnthoDegroote;Degroote Anthony;;8710;433;34;10774;19951
tuba_lyon;TUBÀ;Lieu d'innovation urbaine depuis 2014, fondé par des acteurs publics-privés 💡 #numerique #data #mediation #projetscollaboratifs #coworking 👥🔎🧪⚙️👥;4835;953;7182;6971;19941
marcelgarrigou;MGG;Médecin, CELLULE JURIDIQUE FMF, Pdt FMF Auvergne-Rhône-Alpes, Ordinal Rhône, Comité National d’Ethique de la télé santé, et du Numérique en AuRA;13483;267;933;5257;19940
Monnaiesvirtuel;Monnaies virtuelles *unhosted*;Depuis 2014, sélection hebdomadaire des tweets & articles de presse pertinents sur le #bitcoin, l'#Ether (#Ethereum) et la révolution des #cryptomonnaies;15751;79;720;3366;19916
PierreBonneels;Pierre Bonneels;Japanese Philosophy Specialist at @Philosophie_ULB. AOC in Metaphysics, Logic, and Formal Ontology. Chair @BJA_FriendshipC, Cool Jp Amb, JP-FR trad/int à Bxl;5390;1172;751;12576;19889
KarlSeinomarin;Karl;đđLes scientifiques ne sont que des enfants jouant sur une plage cherchant des beaux coquillages, tandis que sâĂ©tend devant eux lâinconnu de lâUnivers.;7963;1804;2196;7915;19878
agriculteursBzh;AgriculteursBretagne;L'agriculture fait bien plus que nourrir les Bretons ! Agriculteurs de Bretagne valorise l'ensemble des contributions des agriculteurs à la région.#Agribretagne;7985;1346;5479;5059;19869
djenzo27;Julien đ»;;12223;930;194;6520;19867
haropaport;HAROPA PORT;"Compte officiel du 1er port de ð«ð· | Suivez-nous â¤µï¸
#HAROPAPORT #portduHavre #portdeRouen #portsdeParis #Logistics #Innovation #EnergyTransition";5377;824;5089;8574;19864
TLGMorlaix;LeTélégramme Morlaix;Compte Twitter de la rédaction du quotidien @LeTelegramme à Morlaix.;18071;182;1581;30;19864
franckjamet;Franck Jamet ð¦;Fondateur Remix Culture Society, agent littÃ©raire, ex SIPA Press, eBay, Celsa alumni.;12909;3537;928;2474;19848
laBananeCrypto;La Banane;"Crypto convaincu ð

Animateur @TheDiggersDAO ð«ð· 
Chasseur de projet pour @TheDiggersDAO ðµï¸ââï¸ 

PassionnÃ© de $BTC $EGLD $CFG...";5079;572;6627;7564;19842
minasofficiel;Ministère des Affaires Sociales #MINAS;"Compte officiel du Ministère des Affaires Sociales #Cameroun / Official account of Ministry of Social Affairs #Cameroon

Contact : +237 699 712 527";629;39;18915;253;19836
RomainDasnoy;Romain Dasnoy (MacGuffin Maker);"ð¨ðµð¯ðµ
CrÃ©ateur Musique & Concert @WayoRecords @Overlook_Events Â· Auteur @YnnisEditions @PixNLove @ThirdEditions Â· CrÃ©ateur Youtube.com/MacGuffinMaker Â· åéºè";7222;221;1251;11134;19828
messagerdesbois;le messager;« that’s all fake! » les joyeux guérissent de tout! gauche ou droite tous dans le même sac #freeassange;5547;1007;280;12986;19820
CKetchaCourtes;Célestine Ketcha Courtes;Ministre Habitat et Dev Urbain du CAMEROUN. Membre AIMF, AWLN, CGLU. Reine-mère et Ancienne Maire de Bangangté et PDTE des Femmes Maires du 237 et d’Afrique.;752;65;18300;701;19818
TechnopolArbois;Technopole Arbois;Première concentration d'acteurs innovants travaillant dans le domaine de l'environnement #CleanTech #GreenTech #startup #recherche #science #ClimateChange;8427;839;2837;7711;19814
akimKabinda;Akim KABINDA 🇨🇩🇫🇷;Citoyen du monde #RwandaIsKillingInDRC;10030;574;323;8886;19813
FabienneGrebert;Fabienne Grebert;Conseillère régionale et  Présidente des Ecologistes à  la Région Auvergne-Rhône-Alpes 🌱 @EcologieAuRA;5519;2108;4861;7324;19812
PresidenceGabon;Présidence de la République Gabonaise;Présidence de la République Gabonaise;2331;656;16800;0;19787
PNUDSenegal;PNUD Sénégal;Le Programme des Nations Unies pour le développement (PNUD) est le réseau mondial de développement des Nations Unies |;2494;314;16103;861;19772
Romains18157720;Romains;;5219;2160;2489;9898;19766
FrHalper;Françoise Halper 🇫🇷 🇺🇦 🇪🇺;Anthropologie numérique... Auteure de @1cKiou : mieux vivre dans un monde numérique orienté #IntelligencesArtificielles;16014;303;876;2569;19762
jerry_silutoni;Jerry Ronald Silutoniđź‡¨đź‡©;Ă‰conomiste/Sans couleur politique/SociĂ©tĂ© civile/S.G de l'ASBL Force du futur de la Patrie/ Sans langue de Bois/chrĂ©tienâśťď¸Ź/ Patriote đź‡¨đź‡©;11568;977;263;6954;19762
Mynameis_Djamel;MYNAME Djamel;"Recherche la Vérité où qu'elle soit ! 
Combat et dénonce le mensonge d'où qu'il vienne !";5882;135;164;13556;19737
JulienDuressay;Julien Duressayđ«đ·;Conseiller municipal dĂ©lĂ©guĂ© #plages #energie #natureenville de #Royan, conseiller communautaire @aggloroyan #Gemapi. PrĂ©sident @iemroyan Porte-parole FORELE;5634;2044;1140;10906;19724
ALBourout_Oval;Anne-laure Bourout-Oval;Bâtir l’avenir toujours et encore « vers l’infini et au-delà »  sans jamais céder aux extrémistes ni aux cassandres;3212;1995;1229;13269;19705
Faouzia2AA;Faouzia;"Anime le Club des professionnels de l'information @ClubPresseHDF ✒ 
libre un peu pressée... mais pas sous pression...quoique  😎";6893;2532;330;9944;19699
a_leboeuf;Alain LEBOEUF;"Président du Conseil départemental de la #Vendée, du @VendeeGlobe et de @VendeeEnergie 
Président du groupe de travail #Énergiesrenouvelables de @ADepartementsF";6049;2400;6669;4580;19698
DidierCOURTADE1;Didier COURTADE;« Libre, non appareillé »;12928;198;309;6248;19683
lagueuse31;Meyerð¨ðµ marie christineð¿ð¨ðµ;;1519;866;347;16934;19666
VeloBucVGP;VeloBuc 🕊️🚲🇺🇦🇪🇺 @VeloBuc at masto.bike;Association loi de 1901, créée en 2004, d'intérêt général depuis 2010. Mobilités actives. Membre de la FUB. Initiation à la réparation entretien vélo.;14861;369;637;3795;19662
ULYSSEPERSONNE_;Ulysse Personne;Un peuple , une langue , un pays #SaintCiboireDeTabarnac ! Le français obligatoire pour devenir #citoyen de la République du Québec ! L'ONU à Montréal en 2033;15132;1770;1727;1031;19660
MedinaMichel6;Medina Michel;;4280;85;48;15234;19647
phumyste;Phumyste Phuneste;N'être rien c'est le pouvoir d'être oublié.Quand vous mangez, quand vous sortez, êtes au téléphone, en réunions, vous ne nous voyez pas mais nous observons.;8336;296;106;10902;19640
Max_Roy21;Maxime Roy;đDirecteur des communications de la vice-premiĂšre ministre et ministre des Transports et de la MobilitĂ© durable, @gguilbaultCAQ.;5023;1694;1675;11246;19638
gplantin;Gael PLANTIN;Prof d'informatique qui réfléchit sur ses pratiques et celles de ses apprenants...;19207;36;389;4;19636
SNRTNewsfr;SNRTNewsfr;SNRTnews est un site électronique marocain d’information, publié en arabe et en français, par la Société nationale de radiodiffusion et de télévision (SNRT).;16483;64;2997;70;19614
oddtvlive;ODD TV;"Web TV consacrée aux questions de #DeveloppementDurable
#OddTV, au cœur du développement durable !  #ODD #ONU #Team229";1782;4934;2305;10578;19599
andre_dredon;André Dredon;Porte-parole de la République Au Lit (LRAL), futur élu de la Somme. Diplomate pratiquant nuance radicale et respect. 🐌🐌🐌🛌🛌🛌;4650;345;344;14253;19592
NicoleMery16;Macronette #RenaissanceAdhérente;;10660;462;153;8315;19590
Technob14835535;Techno boy;prof de clavier et souris pour cro mignon. team choyés,sans filtre, stylo rouge,ancien prof d'ecologie en bts, juif et communiste;7223;201;314;11850;19588
EnergieDeDemain;EnergieDeDemain;Tout sur les initiatives qui réinventent le secteur de l’#énergie;16273;835;1367;1105;19580
MarchalLeclerc1;Docteur France Libre ☨ 🏅;Observateur attentif du vivrensemble. Directeur de recherche dans le traitement du sida mental à l'institut Pasteur.;5160;2278;1296;10841;19575
DomiHaut;Raminagrobisð³ðªðºâ;"Arbitre expert sur tous les cas. Mit les plaideurs d'accord en croquant l'un et l'autre.
#MajoriteSilencieuseRepublicaine
#LeRNentretientdesliensaveclaRussie";1948;1096;178;16352;19574
The_Stalker49;The Stalker;Ma saison préférée? L'hiver nucléaire.;441;180;59;18893;19573
MinFitzgibbon;Pierre Fitzgibbon;Ministre de l'Économie et de l'Innovation et ministre responsable du Développement économique régional au Gouvernement du Québec. Deputé de Terrebonne.;1121;43;18323;73;19560
Bodychanges1;Bodychangesð;CÃ©lia | 75kgsð| 70kgsð| 65kgsð | 60kgs â³ | Goal Ultime : 58kgs ð â¨belieberâ¨ insta : @caelumero;7613;1319;1415;9207;19554
L4ur3MD;Laure | SAUVONS LA SOCIALE;C’est très surfait les bios finalement.;9178;1603;548;8219;19548
BBadouard;Benjamin Badouard;ð Co-PrÃ©sident des @ecolosgrandlyon MÃ©tropole de #Lyon - Bureau ExÃ©cutif #EELV - Fondateur @coll_pleinlavue;3647;954;3732;11199;19532
dijon;Ville de Dijon;Compte officiel de la ville de #Dijon, Cité internationale de la #Gastronomie et du #Vin, capitale de la #Bourgogne #FrancheComte. Maire : @frebsamen.;4681;282;14143;421;19527
MyrtoTripathi;Myrto TRIPATHI;Ingénieure, laïque, proscience, humanité ET planète. Humble devant les faits. Les travestir ne sert aucune bonne cause. Présidente des Voix et RePlanet France;4869;718;8819;5113;19519
KangenetiP;ð¨ð©;"...NE JAMAIS TRAHIR LE CONGO
#Lumumbiste_Nationaliste...";4488;2397;358;12252;19495
VilleCourbevoie;Ville de Courbevoie;Le mois de juin sera bien orchestré à #Courbevoie ! Laissez-vous porter par le rythme de #CourbevoieEnFête 🎶;11880;61;6897;656;19494
MostafaFourar;Mostafa Fourar;Recteur de l’Académie de Toulouse - Ancien recteur chancelier des académies de La Réunion et de La Guadeloupe;2753;3486;8077;5173;19489
Shenmue0;Shenmue 🇸🇾;Prince de la ville 👑 963 @FcBarcelona @ManCity;6720;1476;1801;9490;19487
Luihn_n;*¤¸.•*nàdîôù ᕦ(ò_óˇ)ᕤ*•.¸¤*;"Freelance 2D Artist for board games & video games as @BeamGleamGame, something else for sure.
I'M VERY FOND OF MUSICALS.
ENJMIN P10 TAVU 🍉🍃";4435;1107;364;13577;19483
Baby_grace01;Sens_interdit;ig: Une_grace_pascale 👻:mpascalegrace //Fallylover❤️;8903;565;2499;7507;19474
Mobili6600;Mobilisation 6600 - Parc Nature MHM;"Nous revendiquons le départ de #RayMontLogistiques et la création d'un Parc-Nature sur tout le terrain Assomption-Sud.

#Résisteretfleurir pour notre santé!✊🌿";3374;1329;1170;13599;19472
MichelCucchi;Michel Cucchi;;8372;70;1498;9528;19468
jipefores;Crockett 🇷🇺🇲🇫🇮🇹;Et ce sont toujours les vainqueurs qui écrivent l'histoire   (Camilla Läckberg);10455;279;200;8510;19444
actualites229;Actualités229;;2777;1028;15523;115;19443
Prefecture42;Préfet de la Loire;Services de l'État dans le département de la Loire.;7175;500;10505;1261;19441
Valou_CVA;Valentin;;4616;180;12;14623;19431
BrunetJeanmarc7;Brunet Jean-marc;"Ni iliste, Ni rien 
Existe-t-il des intelligences Extra-terrestres ?
Assurément Oui, preuve en est, 
aucune ne contacte l'Espèce Humaine
( Bill Watterson )";15608;466;189;3167;19430
CWannyn;Chantal Wannyn;;13039;292;56;6032;19419
MissileV2;Missile Dominici;Mon prénom c'est Michel mais mes amis m'appellent Missile;9304;413;264;9438;19419
Geopolia;GeoPolia;le savoir géopolitique | geopoliaprivate@gmail.com;4478;151;13804;980;19413
bisdeclugny;Le migrant est un produit financier;Le migrant permet de créer de la dette et donc de la monnaie pour enrichir la finance et les ultra riches, rien d'humanitaire,;11179;675;539;7019;19412
loumichaelle;Mikalou;Vivre et laisser vivre ! 🇨🇬 🇨🇮;4972;160;176;14099;19407
ComMadison;Madison Communication;Agence de #CommunicationResponsable labellisĂ©e #NumeriqueResponsable #RGAA đźŚł #SocialMedia #RSE #Impact #CommunauteLucie #ODD #a11y #ESS #societeamission;11629;3650;3005;1114;19398
mohamedilunga;MOHAMED ILUNGA;Ns écrirons ensemble l’histoire d notre pays. Cette histoire parfumée d dignité, d liberté et d justice sociale Ensemble portons ls changements voulus . P.H.I;9317;1537;1471;7046;19371
jamiedmg;Jamie;;6993;175;215;11972;19355
BMineagrie;BURUNDI/MINEAGRIE;MINISTERE DE L'ENVIRONNEMENT, DE L'AGRICULTURE ET DE L'ELEVAGE;2960;265;16009;115;19349
david_billard;David Billard;"Professor, UAS Geneva;  IT court expert (FR,CH,ICC); cyberforensics, with a bit of AI, on land and aboard maritime ships. @david_billard@mastodon.social";13002;2368;1120;2850;19340
Aldarande;Lise;Intello adoratrice de géo environnementaliste (et oui!) grande planificatrice mais ici démoniaque: activiste de l'éduc nat et hippie modérée;2810;712;117;15696;19335
judhy77;Romain Djoudi;;9875;133;196;9125;19329
semoicelmar1;semoicelmar;"Dédé: ""Quand on voit c'qu'on voit, qu'on entend c'qu'on entend et qu'on sait c'qu'on sait, on a raison de penser c'qu'on pense.""
M'dame Michue: c'est ben vrai !";5994;806;109;12419;19328
libdemnightmare;Armée Nationaliste Révolutionnaire Bolchévique ☭;Place au peuple et à la révolution nationale prolétarienne. #augoulag les libdems et les azovites. #augoulag les wokes corrupteurs des mouvements 👩 et 🏳️‍🌈.;11569;149;291;7317;19326
Nouv_Energie;Nouvelle Énergie;Compte officiel de Nouvelle Énergie. Pour une nouvelle espérance avec @davidlisnard. Pour adhérer : payasso.fr/nouvelle-energie/…;1015;97;17696;506;19314
BokolaSerge;BOKOLA serge;Liberté égalité fraternité;12209;244;92;6769;19314
CA_alp_prov;Crédit Agricole AP;Suivez l'actualité, les évènements, les partenariats du Crédit Agricole Alpes Provence 05, 84, 13 #Banque du #Territoire ▶bit.ly/2v2uGWv;9199;1934;2390;5781;19304
JuliaDrylewicz;Julia Drylewicz;Assistant Professor | Biostatistician & Computational immunologist  at @CTI_UMCUtrecht #FR #NL š«š· š³š±;976;386;220;17722;19304
AngersRaaf;Réseau Angevin AntiFasciste;Réseau Angevin AntiFasciste;1004;445;1660;16190;19299
sd2776riseup;Stéphane DANIEL;;11074;196;90;7936;19296
SylvainGoiran;SylvainG;Parce qu'on se reçoit des pierres des trois côtés: Libéral conservateur de gauche. Flegme, politique et âge de bronze.;12397;883;429;5584;19293
TardieuCh;Christophe Tardieu;;8326;524;2639;7798;19287
emorucci;Emmanuel MORUCCI;Dr en sociologie, UCO, Conférencier Commission européenne #TeamEuropeDirect, Président-fondateur du Cercle Europe Citoyennetés & identités @cercle-ceci.eu;8922;3524;1400;5419;19265
Chloe_Brgn;Chloé Bourguignon;"Militante associative et syndicale - #Strasbourg #GrandEst #Europe @ETUC_Youth. Compte perso/Tweete aussi sur @UnsaGrandEst
🐘 @chloe_brgn@piaille.fr";3862;3671;1951;9766;19250
FreedomStandup;PPC-Bro;I’m not left or right I’m common sense.;5424;664;578;12565;19231
ascent_marx;trémie centre;photos 3d montage;6193;1676;126;11227;19222
_Tatayou_;Tatayou;"Toujours papa, souvent ingénieur, parfois secouriste.

Explorateur du sous-sol.";6988;272;269;11678;19207
stephaneledez;Stéphane Ledez;Directeur Territorial @enedis @departement59 - Pdt SLE #Flandre Membre du COS @CEHDF - Pdt @FNCS_HDF - @SFENorg - #TransitionEcologique #Universalisme #Music;5502;1552;1661;10463;19178
Araeshart;Araesha ๐๐จ Artist VTuber;Freelance Artist & Live 2D rigger | VTuber Name: Plume๐ | Twitch Affiliate | 80โ music lover ๐ธ| Fanart: #araeshart | Commission โ Waitlist;6961;1056;2507;8647;19171
Prefet54;Préfet de Meurthe-et-Moselle;Retrouvez-nous les autres réseaux : linktr.ee/prefet.54;5755;386;9754;3274;19169
S_Naan_;S-Nan;;2038;562;49;16485;19134
Jarawaaa;Jarawa;Étudiant en licence de sciences politique.;398;225;19;18463;19105
danielg42000730;Steve Austin mini cooper 2.0;Pour une gauche responsable et une droite intelligente. #Renaissance;10112;1760;586;6641;19099
Giscard37786374;Giscard2022;Maître de l'extrême centre, je fus l'homme le plus moderne du monde. Je vis  à la campagne et observe mes contemporains à la télévision. Compte parodique;18240;258;513;83;19094
barbaratrachte;Barbara Trachte ðð»;ð SecrÃ©taire dâÃtat Ã  la #TransitionEconomique et Ã  la #RechercheScientifique â¢ #BruGov | Ministre-PrÃ©sidente â¢ #CoCoF;4106;2298;5335;7336;19075
P_van_de_Weghe;Pierre van de Weghe ðºð¦;"Inspecteur GÃ©nÃ©ral de l'IGÃSR.
CollÃ¨ge ESRI (majeur) et Groupe physique & chimie (mineur) - GT Affaires Internationales.
Les tweets n'engagent que moi.";13972;1785;2510;805;19072
PetitPolnareff;ELIOTT;"Fluctuat nec mergitur.
Chanceux Papa d'un merveilleux petit garçon.
« L’amour c’est l’infini mis à la portée des caniches. »
#SocialphilePasDeGauche";12215;516;125;6215;19071
Ugo_Lebron;Ugo Lebron;51 piges. Bouquins, ciné, concerts.. « Parler à un con, c'est un peu comme se masturber avec une râpe à fromage : beaucoup de souffrance pour peu de résultats »;10708;681;130;7550;19069
joroy;Jonathan Roy;"Papa(2x) | #science | #engineering | #biomed | #compvision | #bioinfo | #pythonista
Rubicon: rpb-{fbpvnyvfzr, yvoregnver, nakvrhk}
đŠŁ @joroy@spore.social";3060;1317;153;14537;19067
ChGeourjon;Christophe Geourjon;"Conseiller Métropolitain @grandlyon #Lyon7 | Commission permanente | Conseiller régional @auvergnerhalpes | Président fédération @UDI_off ""Métropole de Lyon""";4866;1100;1935;11157;19058
FabPist;Pist Fab;"nageur de combat 
membre de place d arme. 
Actuellement reserve OP
Sortis du ventre de la nuit, ils sont porteurs des foudres de Neptune.
À la vie .À la mort";12232;208;163;6429;19032
Rupert_1969;Rupert69;Le juste milieu est le dieu des pauvres cons (Marc-Édouard Nabe).;9066;131;121;9707;19025
LaChronique35;Chronique Fougères;La Chronique Républicaine - Fondée en 1837 - Toute l'#actualité locale de #Fougères et de son pays. Sur Instagram : lachroniquerepublicaine;15922;488;2544;70;19024
MarieMagda6;Marie Magda;;11449;77;138;7351;19015
JolivertJonas;Dr Jonas Jolivert;"Médecin,  Neurochirurgien, Bac+12, Haïtien, engagé Insuffisamment,  écrivain ,  bloggeur,
Collection Haïti Recto Verso http:http://www.collection-haiti-recto-ve";14615;695;1679;2013;19002
luimaime;Luimaime;;939;314;41;17701;18995
NGodfroy;Nicolas Godfroy;;9912;134;180;8764;18990
MutMutandis;Mutatis Mutandis;Bonk Delivery System;6625;345;115;11902;18987
ingecube_;RLP;;1603;510;17;16855;18985
DwemeChristian;Christian Dweme;licencié en économie et développement, entrepreneur, expert du secteur de bois, Associé Gérant Woodexpert...;5683;4141;4278;4883;18985
gimenez15900344;lavandine;origine lotoise;7947;807;75;10155;18984
rdcforce;MBULA IPI;"Com. AP/ MUKWEGE

Chaque génération doit dans une relative opacité découvrir sa mission, la remplir ou la trahir. 

“Les Damnés de la terre”. Frantz Fanon";6528;2440;255;9757;18980
MAshuza;marcellin ashuza shamali;katumbiste au vrai sens;7413;559;670;10300;18942
cldudouyt;Dudouyt Clément;"Libéral et fédéraliste 
Qualité Sécurité Environnement
Devellopeur";10913;971;511;6547;18942
EELV_midi_py;EELV Midi-Pyrénées;Europe Ecologie les Verts Région Midi Pyrénées #EELV;8397;539;2033;7969;18938
delphine_riccio;Psy EN đ§ Ăducation;"Psychologue Ămancipation Nationale.
PrĂ©occupations #Ă©ducation aux HumanitĂ©s, mon quotidien est l'#orientation. Je bricole #concepts #outils. VP @apsyen";11116;689;1282;5843;18930
Amond39248773;Amon D;God amreys;6202;66;34;12625;18927
MichelDelooz;Michel Delooz;Ingénieur civil électricien-mécanicien. Président de section MR, conseiller communal Juprelle;5579;2724;487;10136;18926
Marcelpaixmonde;Papi 81;Je fustige toute forme de haine.;6560;444;226;11686;18916
St_Tison;Stephanie Tison;"Deputy Director International @medef
#international #economicsovereignty";12023;1608;1270;4012;18913
egorovagapii86;Hamilton Marleau;J'aime le #SEO, #google et ghstools.fr/forum/ !;13561;5001;347;0;18909
Electeur_;Electeur.Lambda;Ex-électeur gauche, cru 2019, désespéré. Exaspéré d muselage et d la récup' politique.;11690;80;53;7067;18890
MoctarDram5;Moctar Dramé;;7855;515;869;9645;18884
ManetPhilippe75;Manet Philippe;"insoumis
Réanimateur pendant 20 ans
maitrise en épidémiologie et DESS en système d'information.";6767;27;65;12019;18878
MisigaroDo2;Misigaro Déo;Quelqu'un d'ordinaire, journaliste reporter, ouvrier de l'information qui rêve d'un monde meilleur;7140;2890;1077;7757;18864
inrae_act;INRAE_ACT;Département #INRAE des Sciences pour l'#action, les #transitions, les #territoires #Agroécologie #Systèmesalimentaires #Ville #Innovationouverte #Actionpublique;8212;2103;5373;3174;18862
FlavienRJ;frj_lornithorynque đ°ïžđ©;Docteur đđ°đ« | Militant communiste Ă  @_MJCF et au @PCF, com. RĂ©volution NumĂ©rique, rĂ©dacteur @CauseCommunepcf | Diaspora berrichonne | đ«đ·đŹđ§đšđłđ«đźđȘđȘ;2963;867;196;14828;18854
GilbertAzoulay;Gilbert Azoulay;Spécialiste éducation-emploi-eco passionné du @parisfc speaker officiel. Agence @epoka, Dir Ass @NewsTank, Parisien Etudiant Rédacteur en chef @P_etudiant.;5474;397;1020;11960;18851
7783Lise;Lise;;11391;2046;707;4705;18849
CGCanMiami;Canada à Miami;Consulat général du Canada à Miami, responsable pour la FL, PR et les IVÉU. English: @CanCGMiami. En cas d'urgence consulaire,  composez le 613-996-8885.;13614;489;1229;3516;18848
ChCounil;Christophe COUNIL;Conseiller départemental (Le Mans 6) - Maire-adjoint du Mans Ville durable, urbanisme et grands projets - Président des groupes @ElusPSLeMans et @SartheaGauche;8354;445;2594;7439;18832
univtoulon;Université de Toulon;Université pluridisciplinaire, acteur essentiel de l’enseignement, de la recherche et de la culture en région PACA;6040;239;10751;1798;18828
Europe2Vendee;Europe 2 Vendée;📻 Radio 📢 Rédaction en #Vendée 🎙Flashs locaux en direct de 6h à 9h30 🔊 #LRSY sur 101.1 FM 🕔 Des tweets très matinaux 🎧 Actu  #️⃣ Europe2Vendée;10834;1000;2867;4125;18826
Niji_Digital;Niji_Digital;Niji accompagne la transformation numérique des entreprises, de l'idée à la réalité. Retrouvez notre actualité, nos coups de cœur, nos envies, nos tribunes, ...;6887;2233;5135;4568;18823
CostaNova9;Costa Nova đšđ”â€đȘđž;Non au wokisme. Je refuse qu'un groupe ou une secte m'embrigade et qu'on me dise qu'on pense mieux quand 1000 personnes hurlent la mĂȘme chose, Georges Brassens;5290;328;466;12724;18808
XLepoivre;Xavier Lepoivre ðªðº;Eco-socialism / Politics / EU / Economy / R&D / Mobility / Modern & contemporary art / Philosophy / Brussels. Views are my own;7877;2397;1789;6732;18795
Marc15936177;Pounchingolf đ«đ·đ·đș;;4113;476;75;14097;18761
revueconflits;Conflits;"#Histoire #Géopolitique #RelationsInternationales
Conflits n°4 (mai 2023) : ""Poutine. Main basse sur l'Afrique""";4803;282;11990;1658;18733
lechantdudepart;Astyanax;;4872;64;63;13728;18727
Chou_Mr___;đ Mr_Investisseur đ;đŒ Investisseur - Les petites capitalisations đŻ;8745;229;2129;7615;18718
PabloDeGrce1;Pablo Aiglon;;5158;129;215;13210;18712
nfroidure;Nicolas Froidure;"đ» Militant Ă©cologiste Ă  Douai
đ» Dev open-source / CTO @ DiagRAMS";13124;784;1439;3338;18685
RAP_Asso;Résistance à l'Agression Publicitaire;"Compte de l'association R.A.P dont l'objet est de lutter contre les effets négatifs des activités publicitaires. #Antipub
Mastodon : @RAPasso@framapiaf.org";8583;782;6036;3277;18678
thomash02140;HERBERT Thomas;;4916;253;219;13278;18666
MartinKoskinen;Martin Koskinen;Autodidacte assumé.  Directeur de cabinet du premier ministre du Québec.  Joueur de tennis au talent limité.;6035;1290;8653;2678;18656
gaallia1;georges regent;;13027;5000;603;11;18641
Hamady_Ardo;Président-Refondateur;"Engagé pour la construction Citoyenne, l'instruction civique et la bonne gouvernance.

#JAIMEMON🇲🇱";7453;2058;3130;5990;18631
Parisien92aze;Pia;Je ne bloque pas, même quand on m’insulte. Il n’y a pas de meilleur aveu de faiblesse que celui qui a recours à l’obscénité.;12959;150;59;5459;18627
B3njj92;B3njj92;Crypto-enthousiaste #Bitcoin | Crypto Dystopies ð­ | RÃ©dacteur pour @lejournalducoin ð¨âð»;3769;199;1323;13331;18622
LePMR;Le Plateau;Le compte officiel de l'arrondissement du Plateau-Mont-Royal. Informe les résidents des actions et services #LePlateau.    Requêtes et les plaintes: 311;7725;1146;9359;376;18606
GaillyGregoire;Grégoire GAILLY;Responsable Programme ZAE+ Afrique Ouest au @geres_fr Tweets à titre perso... #SolidaritéClimatique #TransitionEnergétique #SocialBusiness #OnEstEnsemble;7874;1121;693;8911;18599
Nicolas_Smeets;Nicolas Smeets;Consultant en Sécurité Financière. Spécialiste en lutte anti-blanchiment, et financement du terrorisme. #LAB, #AML, #LFT #KYC #compliance #RGPD.;7402;1322;516;9354;18594
mauvaisEsprit3;Superphenix fan account;"chimiste agréé, mauvais esprit reconnu

Casse des atomes de manière ✨professionnelle ✨

RNR supremacist";4236;1263;325;12766;18590
julien_trevisan;Julien Trevisan;Docteur en mathématiques. Agrégé de mathématiques. Collaborateur au @lvslmedia, spécialiste du Mexique. Enracinement, protectionnisme et souveraineté.;3030;590;223;14743;18586
EMoi45;EncoreMoi45;De Marseille à Bourj Hamoud aller l OM ne jamais oublier 24 Avril 1915 RT ne veux pas dire approuver mon compte a encore sauté 🇦🇲 🇱🇧 🇵🇸;9776;298;138;8369;18581
ProcessusT;Processus;Microsoft Security MVP đ» OSCP | CRTE | SOC analyst @Hexanet;3887;1200;4906;8584;18577
Outlaw_4_life;Veskass Nebbercracker;"Fan de Fables ðº
J'aime bien parler de Red Dead Redemption aussi. Un peu.
KPTUR User - Veskass kptur.co/user/1193";10045;424;168;7939;18576
hydrauxois;Hydrauxois;Rivières et milieux aquatiques à l'Anthropocène: patrimoines, environnements, usages. Analyse critique des politiques de l'eau et des choix socio-écologiques.;15637;409;671;1847;18564
MacAren12428084;Mac Arena;;3227;152;68;15099;18546
o_environnement;đ Orientation Environnement;"Orientation, formations et recrutements dans les mĂ©tiers de l'#environnement et du dĂ©veloppement durable
âą emploi, stage, alternance
âą guide des formations";13734;110;4162;526;18532
aticbernard;bernard crozel;"amoureux de la terre des arbres des oiseaux et de l'humanité. architecte urbaniste auteur de : urbanité citoyenneté ; y a t il une nation pour sauver l’Etat?";10745;235;205;7341;18526
unifr;Uni Fribourg;Official Twitter feed of the bilingual University of Fribourg (CH). Updates on studies, research and life on campus. Check also: facebook.com/unifribourg #Unifr;4408;665;10440;3010;18523
communelausanne;Ville de Lausanne;Compte officiel de la Ville de Lausanne: Information sur les activités municipales, les projets et les évènements. Contact: infocite@lausanne.ch.;3353;146;14298;720;18517
MkLaunier;Mikahel Launier;Dessin psychédélique en moins, petit doigt coincé dans un système de santé déficient, toile en attente et homocitrus sous études. Acide, masse et vibration.;8172;644;137;9542;18495
villedemarcq;Marcq-en-Baroeul;Compte officiel de la Ville de #marcqenbaroeul : infos pratiques, actus, agenda... instagram.com/villedemarcq/;11180;479;2033;4795;18487
ecosourcecanad1;ecosourcecanada;Ecosource Canada a world to discover in eco energy with over 500  family/ product providing turnkey solution for your project at best;16801;1011;260;413;18485
EEPU_Balzac_92;EEPU Balzac Nanterre;"Compte Twitter de l'école élémentaire Honoré de Balzac (Nanterre)

Ecole REP mb du réseau UNESCO engagée dans le projet international Aujourd'hui pour demain​";4478;156;295;13543;18472
isako_patrick;ISAKO Patrick;"Jeune CADRE au sein @CDER_RDC et @Cderjeunesse,
Administrateur Civil, Énarque congolais, Stagiaire au SPF Intérieur BELGIQUE";4922;5001;2014;6528;18465
DOGEto4201;DOGE to 420 π΄ ~=69 π²ππ;Letβs take over the world! And D.O.G.E. Follow @Doge420/MyDoge420 on MyDoge, Coinbase NFT, GitHub and instagram. Tyler Dogeden leader of wow club;8789;1407;611;7634;18441
journey6369;journey63;Save a CD, eat an Ipod;11561;69;43;6766;18439
Patriot32162436;🇪🇺🇨🇵Basique🇷🇺;Le doigt/ La Lune....;6932;411;233;10851;18427
byleth35;El Guay;;12665;236;85;5407;18393
UBellarmee;Umutare wo ku Mukenkeđ§đź;Juriste de formation,Ancien meilleur plaideur du Concours National de plaidoirie en DIH(2018),Msc en Enseignement Clinique du Droit des affaires;5232;176;555;12427;18390
YCaraisco;Yanis kalymnos/Linguizzetta;l'honneur c'est ce qui reste à un pauvre;11651;251;371;6114;18387
AntBoyet;Antoine Boyet;Recherche d'un job à projet #AgriUrbaine. Coopérateur chez @Demain_Coop | Passé par @arretsurimages @CUTVMontreal @Cirad @AFD_France | Photo: AP;10620;1654;3042;3057;18373
ilizur;Adrien Denèle;"Journaliste Scientifique (Science & Vie, Ciel & Espace, Cité des Sciences)
🤖Tweete des trouvailles sur reddit
📺Quoi de Neuf Chercheur ❓ sur Twitch.tv/Ylizur";5499;1026;2582;9265;18372
BourbonLionel;otto;"Pour l'instant ,on ne peut rien faire 
Mais dès que l'on pourra 
On fera le double !
(Jean Yanne )";13460;89;83;4713;18345
_GCFT;GCFrance&Territoires;Green Cross créée par Mikhaïl Gorbatchev. ONG présidée par Jean-Michel Cousteau, dirigée par Nicolas Imbert. Eau, énergie, alimentation, économie circulaire...;11262;4192;2095;795;18344
PilWoke;FC wokistan;"Aime les frappes du gauche à Saint-guidon.
Si les tweets engageaient qui que ce soit, la Belgique serait en plein emploi
Shizo selon @fannycharpenti5";9675;623;350;7694;18342
JoseeMani;Josée mani;Jeune femme entrepreneur;852;163;134;17174;18323
hullbanite;hUll'banité;"""La guerre, c'est le massacre de gens qui ne se connaissent pas, au profit de gens qui se connaissent et ne se massacrent pas."" -Valérie";15684;861;138;1631;18314
dapaarnaud;Arnaud Dapa;"Vice prĂ©sident de l'Association des #Blogueurs de #Cotedivoire
#Civ225 đź‡¨đź‡® - Digital Management";14434;479;3099;301;18313
TissotSacha1;Tissot Sacha;Re 4/4 II 11161 leading NightJet 471 to Zurich HB shot at Villnachern AG in the morning of the 08.01.2023 by Martin Gobeli;6921;447;244;10696;18308
Lamasticot__;FlashMcQueen;;3193;734;45;14310;18282
CRNievre;CoordinationRurale58;;17116;162;431;549;18258
mahamataliib6;DÉVELOPPEMENTISTE;"Bachelor en Sociologie de population et du développement. 
《Un Sociologue est celui qui va au stade pour observer les spectateurs 》";6630;733;1831;9060;18254
PPastedechouan;Pierre Pastedechouan;Aniccā, dukkha, anattā;8894;358;147;8848;18247
SeppiWackes;Wackes Seppi;"Agriculture, alimentation, santé publique... soyons rationnels -- seppi.over-blog.com
Né à 14-15q/ha de blé ; ingé. agronome promo 34q/ha ; retraite 72q/ha";15443;1032;1428;343;18246
Infoflash31;đ«đ· InfoFlash_31;"Informations officielles et alertes locales concernant le dĂ©partement de la Haute Garonne.
 âč PrĂ©vention des risques et information des citoyens.";18166;15;59;0;18240
AnthonyMeilland;Anthony Meilland 🇪🇺 🇺🇦🛸☢🚜🔭🖖🦄🍣🌐🍟🎸📈;Gauchiasse selon les Zemmouroïdes, social-traitre pour les Chonchonistes et chauve-souris mutante d'après le FSB. NB:  le RN a bien été fondé par des nazis;10115;671;228;7163;18177
Bernardo2Zoro;Bernardo;« Danser avec le système, sans jamais lui appartenir »;14893;169;63;3045;18170
joelbruneau;Joël Bruneau;Maire de @CaenOfficiel (#Normandie). Président de la Communauté Urbaine de @caenlamer #Normandie.;5735;438;10205;1783;18161
TLGCarhaix;LeTélégramme Carhaix;Compte Twitter de la rédaction du quotidien @LeTelegramme à Carhaix. Pour nous contacter : carhaix@letelegramme.fr;16166;248;1650;88;18152
JazzDeus;JazzDeus;Le pouvoir est de déchirer l'esprit humain en morceaux que l'on rassemble ensuite sous de nouvelles formes que l'on a choisies.;11950;186;388;5617;18141
Guillaumlevi;Solamente OM๐ ๐ 93 ๐จ๐ตโญ๏ธโญ๏ธ๐ฆ๐ท;#TeamOM #AJamaisLesPremiers #DroitAuBut;7892;537;437;9273;18139
ShannonSeban;Shannon Seban;Présidente @Renaissance en Seine-Saint-Denis | Conseillère municipale @RosnyOfficiel | Candidate #législatives2022 | Ex Bercy avec @BrunoLeMaire;2266;3668;6968;5217;18119
lp_materre;Le Parisien | Ma Terre;L'actualité de l'environnement et de la consommation responsable avec @le_Parisien;13726;84;4289;4;18103
TabacTresFroid;TabacTresFroid;"Contre ceux qui créent l'inquiétude et qui disent ce qui est inquiétant.
 ""ni#LFI ni#RN de moins de 100 abonnés""
Espère faire partie de la division supérieure.";4677;84;64;13276;18101
JordanMontel_;Jordan Montel | Investissements 📊;"📊 Partage d'expériences dans l'investissement depuis 2022 ☀️ 
🧵 #Thread, analyses et outils gratuits pour suivre les finances 👨‍💻
📈 #ChallengeBourse2023 🟢";4736;110;7248;6002;18096
energy_observer;Energy Observer;"đź‡¬đź‡§ Exploring positive energies
đź‡«đź‡· Explorateurs d'Ă©nergies positives
#FutureIsClean #FutureIsNow #EnergyObserver #HydrogenNow #travel #cleantech";4679;770;8010;4635;18094
MaximePerrin56;Maxime Perrin;Adjoint Finances | Délégué National & Porte-parole @terresdeprogres | @TdPMorbihan | @Renaissance | @renaissance_56 | 🇫🇷🇪🇺;6387;1998;1324;8374;18083
FredMilandu;Fred Mibat;"Époux, Père d'une famille, licencié ,
Cadre adm publique RDC, Étudiant en Sciences Pô  et Entrepreneur Agricole";6644;715;791;9931;18081
QuebecNewYork;Québec à New York;"Québec Government Office in New York. Stay current on Québec news and events happening in the NY area!

Délégation générale du Québec à New York du @MRIF_Quebec";9062;1242;4675;3095;18074
AgnelloFabrizio;Fabrizio AGNELLO;"Globetrotter, East-West relations, EU, Trade, Politics.
Like cats, bikes, rock, Japanese crafts & caramelized apples.
Contrarian & smartass opinions are my own";2723;631;666;14047;18067
misraimdu225;misraim;;1090;31;35;16908;18064
gfranchi2b;Guillaume Franchi;"Chef du CPI Antisanti                                    
Président de l'AS Antisanti";5648;675;1158;10582;18063
NicolasDpy_;WhiteMoose đ«;Si vous n'ĂȘtes pas rĂ©voltĂ©s alors vous n'ĂȘtes pas attentifs - Heather Heyer;3124;1125;1346;12463;18058
AssoJNE;JNE;Association des Journalistes-écrivains pour la Nature et l’Écologie (JNE);7204;4870;4955;1027;18056
artichaut101;L'artichaut;"Le légume ultime !
fr.m.wikipedia.org/wiki/Arti…";12424;348;187;5082;18041
CycloCitrouille;CycloCitrouille - @CycloCitrouille@masto.bike;Les citrouilles ūüéÉ √©gayent le v√©lo, et inversement;10264;195;225;7345;18029
dadamval;David V;#AndWhat? đđ»đ«đ·đȘđșđșđŠđđ”đȘ anti-extrĂȘmes;2972;295;488;14268;18023
Kinoon_;Kinøøn 🥧;94;4729;204;321;12767;18021
marc_tanguay;Marc Tanguay;Député de LaFontaine / Chef de l’opposition officielle à l’Assemblée nationale du Québec;4666;1837;7918;3590;18011
tkteka;Thomas Kurkdjian;Le meilleur de mes lectures : tech, politique, vie des idées, startups, public-privé... Compte personnel.;1733;3881;251;12136;18001
InfoFlash67;ðŸ‡«ðŸ‡· InfoFlash_67;"Informations officielles et alertes locales concernant le dÃ©partement du Bas Rhin.
â„¹ PrÃ©vention des risques et information des citoyens.";17900;6;85;0;17991
mariestuart4469;marie Stuart;;4319;420;244;13006;17989
Fatou______G;Zaphirðð§¡;"Cheikh_Al_Islam ci xolð 
#Sanar'Reineð
#communication_Multimedia_technologiesnumÃ©riques ð¥° webmasterjuniorâº
Webdesignerð¤
CMð
Pub_lover
#Leboumaalimarameâ¤ï¸";4352;1334;2483;9816;17985
soldat2verites;reality soldier;Soit le changement que tu veux voir dans le monde pour qu'il soit un paradis pour les générations futur.;5449;364;155;12013;17981
Prius_004;JPF-ERRY;L’esclave qui n’est pas capable d’assumer sa propre révolte, ne mérite pas que l’on s’apitoie sur son sort (T. Sankara);8971;6;2291;6699;17967
PechesOceansCAN;Pêches et Océans;Information relative à Pêches et Océans Canada | Avis : goo.gl/17fyn In English: @FishOceansCAN;11160;48;5205;1552;17965
juste_Caro_;Caro;Maman, citoyenne, curieuse;4791;291;381;12501;17964
Estaca_twit;ESTACA;ESTACA, école d'ingénieurs Acteur des nouvelles mobilités dans les secteurs automobile, aéronautique, spatial, ferroviaire, mobilités urbaines, naval.;9316;1531;4081;3031;17959
Mohamed02974899;Mo ✌🏽;Soutien inconditionnel à la lutte pour la liberté, l’égalité et la fraternité. « Au bord de l’abîme, vous n’avez qu’un mot d’ordre, faisons un grand pas. »;6054;280;87;11534;17955
Shaka_virgo80;Sylvain Bird;Arrêtez de chuiner un peu, sortez vous les doigts du cul et ne comptez sur personne. Notre vie est notre barque et nous en sommes le capitaine.;5240;675;696;11344;17955
ouinuc;ouinuc;"Association des Ecologistes Pour le Nucléaire
Blog : aepn.blogspot.com
- Environmentalists For Nuclear";10748;787;1133;5280;17948
FCCQ;FCCQ;"La Fédération des chambres de commerce du Québec compte sur un réseau de plus de 130 chambres de commerce et 1100 membres corporatifs.
#FCCQ #COREX #Mercuriades";7435;1139;8104;1270;17948
TDFEF;TD FEF;"TD Friends of the Environment Foundation đżđ #TDReadyCommitment
Fondation TD des amis de lâenvironnement đżđ #LaPromesseTDPrĂȘtsĂAgir";5499;2258;5846;4345;17948
AKH237;moyo laurel;Sports, crypto passionné, agribusiness et risk management;7924;3478;261;6262;17925
Cl_m76;Nifuro;;1434;352;64;16073;17923
MrSorhoImhotep;SORHO DOGNON;Informaticien, Crypto-preneur, Bénévole Environnemental & Social: YAFP (Young African For Planet) et membre de #DonateurBénévole), Activiste, Fan de muscu💪🏿;3466;552;163;13738;17919
michu_michu91;Madame Michu;Prof primaire;7919;4006;228;5747;17900
Somme_fr;Département de la Somme;Compte officiel du Conseil départemental de la #Somme. Actualités, initiatives, événements... une Somme d’infos à ne pas manquer ! #CD80;8323;365;7662;1539;17889
INSIS_CNRS;Ingénierie au CNRS;"Institut des sciences de l’ingénierie et des systèmes du @CNRS.
Comprendre la société d'aujourd'hui pour créer les technologies de demain.";4788;1031;8934;3133;17886
ArgentumAurum;Argent Or Infos;"Publié par/published by: A.A.Europa LLC  (Wilmington, DE, USA)
Depuis/Since 2003 - aaeuropa@gmail.com -
Nos analyses techn. sont uniquement des avis personnels.";14265;124;614;2877;17880
ALehenanff;Anne Le Hénanff;Députée du #Morbihan -5601 - Commission Défense #CSNP Pte GA France/Vietnam / parti : Horizons;5505;985;2989;8388;17867
top_studies;Top Studies @SurveyCircle;Online #surveys with a score of 150+ at surveycircle.com. Collect 150 @SurveyCircle points and your #research project will be featured here.;17359;58;369;81;17867
geholf;Gehol;;7198;541;142;9968;17849
LilyMonkey5;Lily 🇺🇦 🍃💧;🇺🇦 🍃💧;4789;203;50;12804;17846
semainevet;La Semaine Vétérinaire;"Pratiquer, entreprendre, partager, 100% vous, 100% vétérinaire !
#vétérinaire #santé #animale #Onehealth #entreprise";13012;403;4185;238;17838
FrVigne;François Vigne ن;#Entrepreneur, Président de #LaFranceEnMarche. facebook.com/lafranceenmarch…;6623;6227;3302;1684;17836
inffo_europe;Europe & formation;Toute l'information sur la #formation professionnelle, #insertion, #orientation en #Europe, #Upm et en #Francophonie;11917;460;5452;3;17832
SNES_Bretagne;SNES-FSU Bretagne;Section académique du Syndicat National des Enseignements de Second degré - 24 rue Marc Sangnier 35200 RENNES - s3ren@snes.edu - Tel. 02.99.84.37.00;11320;431;1598;4462;17811
Loris_Dalleau;Loris Dalleau;Master in Finance - Investisseur Long terme - đź‡«đź‡·đź‡şđź‡¸;4560;221;9874;3152;17807
shellyj25178398;Alexis Casgrain;Création de site #internet, application #mobile, #référencement et #graphisme #SEO #SEM #SMO;17781;0;18;0;17799
Prefet89;Préfet de l'Yonne 🇨🇵🇪🇺;Compte officiel des services de l'Etat dans l'#Yonne (89) - Charte de modération de ce compte : goo.gl/dHbSDb;10007;598;6819;373;17797
JeandeRB;J de RoquetteBuisson;Cons. municipal @VilledeNeuilly délégué #Handicap #Aidants & #Accessibilité - Remplaçant de @JCFromantin @hautsdeseinefr - SG @AutismeInfoServ - Aidant bénévole;9721;763;956;6352;17792
Boursovision;Boursovision.com;Gestion d'un portefeuille réel d'actions et d'ETF, marchés Europe et Japon. Sélection sur base Analyse Fondamentale (tendances) et Technique (momentum).;8122;825;3411;5419;17777
rplellig;Romain Poirot-Lellig;Former diplomat and international security teacher @sciencespo Paris - Founder & CEO, @kwikafrica - vessies ≠ lanternes;8524;572;912;7749;17757
mauberli;Michel AUBERLINDER;"CED Conduite nucléaire à @EDFGravelines.
@insarouen.
🎮 à mes heures perdues.
#Ecolo convaincu mais pas assez pratiquant.
#Environnement #Respect #Débat";10215;212;369;6941;17737
vincent_monot;Vincent Monot;Ãcologiste ð± Vice-PrÃ©sident @SYTRALmobilites, Conseiller Municipal de Lyon, Conseiller de la MÃ©tropole de Lyon, Conseiller #Lyon7 Voirie/MobilitÃ©s/TranquilitÃ©;3612;640;2213;11267;17732
MINES_StEtienne;MINES Saint-Étienne;"Grande École d'ingénieurs internationale actrice de l'#Industrie et de la #Santé du futur
Membre de l'@IMTFrance";7462;1152;5143;3975;17732
evergier;EVergier;Retraité Actif. Je fais mienne cette citation d’Anatole France «Si cinquante millions de gens disent une sottise, ça n'en reste pas moins une sottise.”;9959;4736;2215;817;17727
groum_groum;🚂Gaaab🚂;il faut sachez qu’il s’est pris des râteaux phénoménales par nabilla, bien sûr que ouiiiiii;3710;346;427;13237;17720
mila_moris;Mila Moris;;4072;743;195;12705;17715
plamondon_mario;Mario Plamondon 🇺🇦⚜️🍁;Fier ⚜️Indépendantiste ⚜️ et pour un Québec Libre et Français #PQ #BQ;7428;477;256;9553;17714
YannickBrohard;Yannick BROHARD đ»đȘđș;Conseiller rĂ©gional #HautsDeFrance | CPR #EELV | Enseignant Formateur histoire-gĂ©o-laĂŻcitĂ© | Citoyen europĂ©en de nationalitĂ© franĂ§aise;9314;709;1265;6414;17702
SytiNet;Sylvain Timsit;Créateur de sites web;5056;66;1252;11308;17682
FrexitOtanExit;AlainBnđšđ”đ·đș;;12223;15;46;5393;17677
Taovos;Taovos đź‡«đź‡· đź‡Şđź‡ş đź‡şđź‡¦ đź‡µđź‡¸ đź‡ąđź‡Ľ;Rien Ă  dire, un simple geek-otaku fan aussi de roman-sĂ©ries-livres;9201;117;39;8316;17673
samy_dykema;Samy Dykema;"twitteristan state of twitter 
.
.

make twitter great again";3945;3032;159;10537;17673
Pastisdu28;Pastis;Pastis Par Temps Bleu ! Pastis Delicieux !  I Support @EbranMaxime : Maxxie The King #mAxxieCREW #B3LAFight;13571;508;124;3470;17673
FondationSNCF;Fondation SNCF;"Notre mission đź‘‰ aider les jeunes Ă  s'insĂ©rer dans la sociĂ©tĂ© et Ă  se construire un avenir durable #PourNousTous.

#MĂ©cĂ©natDeCompĂ©tences
#FondationSNCF";7387;563;5741;3981;17672
AbHEhO_YT;Marvin;ð¸: Marvinc_off â¢Fervent supporter du @psg_insideðâ¤ï¸;379;123;16;17153;17671
JusticeCanadaFR;Justice Canada;Compte de Twitter officiel du ministère de la Justice du Canada. English: @JusticeCanadaEn Avis : ow.ly/r3Eg3;9094;125;8410;37;17666
4mer_Voldemor;voldemor;;6638;283;16;10728;17665
Prefecture50;PrĂ©fet de la Manche đź‡«đź‡·;Compte officiel des services de l'Ă‰tat dans la Manche;8982;286;7723;670;17661
horizon49860371;Agence horizonnews;journaliste-reporter;9860;4157;3642;0;17659
Vincent48557733;Vincent;“Les médias donnent à voir, pas à réfléchir, encore moins à comprendre. L'image ment lorsqu'elle isole.”;4791;36;73;12716;17616
lamayenne;Département de la Mayenne;Suivez-nous pour connaître l'actualité du #Département de la #Mayenne ! #CD53;8202;171;7924;1315;17612
MilianiAdel;Adel MILIANI;Head of Customer Experience @T1_RATP @RATPGroup. | Public Transport | Tram Operations | PR | We are committed to sustainable and resilient cities & territories;8374;2279;1097;5857;17607
MathieuVVyve;Mathieu Van Vyve;Prof of Applied Math at LSM and President of CORE (UCLouvain). Avid runner, sailor, climber... anything outdoors. The ecological catastrophe breaks my heart.;5532;228;992;10845;17597
GuibePatrick;patrick guibe;;4803;283;344;12161;17591
BillHoutteOne;Bill Houtte;Mi chui ch'ti, ET ti ? Pro Vax, LREM militant, moitié mouton, moitié pigeon, i m a mougeon !;6058;106;103;11319;17586
AlainPitous;Alain Pitous;#ISR #SRI #Sustainable #ClimateChange;10817;603;4823;1314;17557
AnDaolVras;La Cantine Brestoise;"Communauté de télétravailleurs · FR
Wild Wild Remote Workers Community · EN
#Brest Même 
#Digital #Dev #Conferences #Startup
#CyberSecurity | @UYBHYS Founder";6787;1823;5009;3930;17549
Enzo_Ferreira79;Enzo đ đ;Moderniste passionnĂ©, Enseignant Histoire-GĂ©ographie du second degrĂ©, Â« les convictions avant les postes Â» A - â„ïž @Nouv_Energie;6773;287;343;10141;17544
Ordo9;Ordo;“Délivrez la patrie, vos enfants, vos femmes, les demeures des dieux et les tombeaux de vos aïeux !” Eschyle;6825;561;294;9864;17544
onoblecourt;Olivier Noblecourt;Engagé dans l’investissement pour l’environnement et l’inclusion sociale ex @DelegPauvrete #social #éducation #développementdurable #Grenoble;7618;619;5827;3478;17542
Almohsen40;Ｍohsen;universitaire;3132;1359;202;12832;17525
valentinp72;‹ valentinp72 ›;PhD student in computer science (Natural Language Processing) mastodon.social/@valentinp72;13462;331;113;3613;17519
Yisiaka_;Yisiaka;#TechAdvocate Telecom & Electronics Engineer | Congolese Rumba Lover 🎵;4871;339;401;11907;17518
FabriceDrouzy;Fabrice Drouzy;Rédacteur en chef adjoint à Libération, responsable des hors-séries, suppléments, cahier été et du site Montagnes.;3338;1324;11094;1761;17517
Loic_Guilpain;Loïc Guilpain;🇫🇷 Secrétaire Général @JeunesMacron | 👨‍🏫 ex-Délégué Général @jmpe_france | 🇺🇸 @AlumniFulbright | 🏊🏼‍♂ #RoadToFukuoka2023 @Fukuoka2022jp 🇯🇵 | 📍 Tours;3622;2402;4290;7177;17491
sis_2b;SIS 2B - Cismonte;Contu ufficiale di u Serviziu d’Incendiu è di Succorsu di u Cismonte | En cas d'urgence : ✆112 ou ✆18;7367;327;7838;1945;17477
Nilap72;Ni™;Fan de hockey, F1, Nascar.;6572;1701;1578;7616;17467
ThinkSmartgrids;Think SmartGrids;Développer la filière Réseaux Electriques Intelligents en France et la promouvoir en Europe et à l’international 🇫🇷🇪🇺🌎 #SmartGrid ⚡️;6008;1665;4581;5203;17457
nouvionjulie;Julie Nouvion ✍🏻;Stratégie éditoriale, conception-rédaction | Translation Studies at Sorbonne Nouvelle 🇺🇸 🇫🇷 | Ex conseillère régionale écolo 🌻 | Autrice de #NaîtreAuCalme;12392;880;2225;1957;17454
EstherJade8;Esther Jade;“Une ère de barbarie commence et les sciences seront à son service” Nietzsche;9271;88;681;7412;17452
PascalRio3;Astérix avec nous;Je déteste la pastèque politique. De droite patriote, complotiste, lépreuse, populiste, toussa, toussa et + si affinités. Insultes et menaces = BLOCAGE DIRECT.;14745;639;476;1585;17445
MoTuDem;MoTuDem;Mouvement Tunisie Démocratie Pour Tous;13186;3512;452;293;17443
ablanchard31;Blanchard Alain ن;Adjoint Maire des Sables d’Olonne à la vie associative/ VP agglo des Sables à l’économie, au numérique et aux finances/ Directeur développement Cocktail Vision;7812;795;1363;7467;17437
_Ow_en_;Owen 𒌐;🔥 Set your heart ablaze 🔥;10619;784;144;5878;17425
Loutrefugace;Loutrefugace;"Fan de sciences et de théologie. Disciple de Jésus
Sciences and theology enthusiast. Jesus follower";11453;434;152;5381;17420
charlesmillar3;Charles MILLAR;Ex-journaliste/éditorialiste/cadre scolaire, rêveur d'indépendance, amoureux d'Afrique, réaliste mais optimiste, père de trois petites princesses brunes;9023;4999;2464;931;17417
scythez;SYLVAIN THEVOZ;Député au Grand Conseil. Travailleur social. Genève.;3821;3260;3237;7094;17412
Francis11046547;Francis Deschamps;;4717;81;61;12546;17405
belilan;Alain B.;Je débats politique et sujets d’actualité, ne réponds pas aux insultes (blocage immédiat). #NIKKIHALEY2024;7178;90;172;9958;17398
trotanoy;Trotanoy;Je ne suis pas allé partout,mais je suis revenu de tout.;5136;232;54;11975;17397
_LeDome;Le Dôme;Centre de #sciences de #Caen #Normandie. Tiers-lieu #OpenInnovation, #Recherche. Rassembler, partager, explorer, imaginer et bâtir collectivement des projets.;5379;1436;4521;6048;17384
EyeOnMorocco;EyeOnMorocco;Human rights researcher - Real-time news & analysis about #Morocco #Maroc;17188;15;135;3;17341
Odenfrancee;Odenfrance;;12560;418;1458;2899;17335
AnnieGaldin;Galdin Annie;Je ne suis pas une personne spéciale mais une terrienne universelle;8655;61;114;8498;17328
Reweill1;Reweillđ;#ecologie #spiritualite #christianisme #laicite #politique #franĂ§afrique #educnat #maths ...;4847;426;359;11694;17326
DredShnn;Dred;Lisez Berserk | CSM et Dark Souls sont des chefs-d'œuvre | Jouez à Sekiro, Dark Souls 3, Bloodborne pour être heureux | Compte secondaire de @SharkShn;3841;772;102;12599;17314
Mr_Zakka;Terence Zakka;Conseiller en communication de @ThierryBreton đȘđș Communications adviser;3965;347;4968;8033;17313
Vander7535;YVDW;;9385;218;33;7676;17312
EnactusFrance;EnactusFrance;Notre métier : accompagner les lycéens, les étudiants et les professionnels à développer leurs compétences pour innover et agir au service du plus grand nombre.;6926;2296;4518;3567;17307
Silvest54801194;Silvestre;Méditerranéen, pas de cinoche, pas de pathos !un peu moins d Europe, please..;6130;129;62;10976;17297
WILL_Solutions;Will Solutions;Expert en mesure, réduction, et compensation carbone. Crédits carbone certifiés à impact positif sur la réduction carbone. #carboncredits #netzero #ESG #Bcorp;11902;2268;1022;2096;17288
Goulran_;Goulranðððâ¢ï¸;"L1 Administration Publique a l'UJM ; epicurieux qui a la flemme de tout mais qui veut changer le monde 
â¤ï¸AnimÃ©, aerospacial, F1, Science, GÃ©opolitic, politic";5520;250;33;11483;17286
guy_sword1;Guy Sword đ;critique clinique brouillon;5133;775;44;11331;17283
SamiaBhm;Samia Bhm ð¥ðª;#digital #socialmedia #relationspresse ThÃ¨se sur #Ã©cologie #numÃ©rique ð±;16014;479;377;411;17281
0xPinson;.MieCarlie;#AntiGouvernementInvisible #IndustrialisonsLaFrance #ÃconomieFrancaise #Bitcoin #AntiAgroIndustrie ð«ð·;10305;322;86;6558;17271
libeEvenements;Libé Événements;Travail, sciences ou culture... Venez refaire le monde, découvrir nos hors-séries et discuter avec nos invités lors des forums @libe;10261;1986;3394;1600;17241
giromusic;Giro Music ­čî║­čî│­čîĆ;Booking & Production Agency @seliamusic @vaiteanimusic @giuliangabriele @HonoWinterstein #FanfaraStation @korajazztrio @ayommusic @kandyguira;4900;4279;1107;6955;17241
Auphelle;Gab_Auphelle;Professeur de Français. Dieu rit des Hommes qui déplorent les effets des causes qu’ils chérissent. (JB Bossuet) Apprenti surfeur. NAZ REID. #BTC;8017;355;91;8778;17241
2geek4you1;2geek4you;Fou de voitures… et amoureux du vélo. Accro à la nature… et adepte de circuits automobiles. Photographe avec toujours le cœur perdu au milieu du Paradis Blanc.;6430;314;168;10321;17233
CCMBenchmark;CCM Benchmark Institut;Pôle formation et conférence du groupe @Le_Figaro / CCM Benchmark. #digital, #ebusiness, #ecommerce, #emarketing, #mobile;6488;2078;7701;948;17215
Farida_Amrani_;Farida Amrani;Députée #NUPES de la 1ère circonscription de l’Essonne / Conseillère municipale d'Évry-Courcouronnes ✌🏼 /  📲 linktr.ee/faridaamrani;2623;578;11172;2839;17212
Prefet976;Préfet de Mayotte;Compte officiel de la préfecture et des services de l’État dans le département de Mayotte.;4412;302;11938;542;17194
maximeboldeau;Luc Normandin;Illustrateur pigiste, je fais aussi des bijoux et du taichi. Père de famille, nature freak. Freelance illustrator, practising jewelry making and Taichi.;10575;2433;1674;2501;17183
ainakuric;Aina Kuric;Conseillère régionale #GrandEst | #Reims #Champagne 🍾 | #ODD | Députée 2017-2022 | @HorizonsLeParti | VP Centristes et Territoires;2952;989;4778;8460;17179
ParisRoux;PARIS-ROUX;Pour découvrir plus vite et autrement  .;16830;25;34;289;17178
nevillemashita4;Neville Mashita;"Jeune #Leader  Patriote de #kamonia  
Acteur Politique FP,  #Co-fondateur et Coordonnateur Prov.  de #U'J'I'D'G'K/Asbl  Grand-Kasaï #RDC";3047;5002;3533;5592;17174
LaFabriqueEcolo;LaFabriqueEcologique;Fondation #pluraliste de l'#écologie // Pluralist foundation of #ecology #Recyclage #Agroécologie #Biodiversité #Climat #TransitionÉnergétique #Mobilité #RSE;6292;1252;9115;513;17172
SKerbarh;Stéphanie Kerbarh;Députée 2017-2022 Admin @Obsar_asso #RSE #Energie #Médiation Secrétaire Nationale à l’indépendance énergétique @partiradical;4488;1589;6478;4612;17167
IIWF;FIMI-IIWF;Mechanism by #indigenousWomen leaders from Asia, Africa, Americas, Pacific and Arctic for Capacity Building, Advocacy, Leadership, Rights and Co-investing;4593;5012;5461;2096;17162
LesEchosLEE;Les Echos Entrepreneurs;Partage d'expérience, bonnes pratiques et conseils pour créer et développer son entreprise. #entrepreneur #Startup #entrepreneuriat #pme #autoentrepreneur;13710;146;3229;68;17153
BertagaTweet;Bertaga;Petit agité;11859;901;472;3919;17151
NiniBobota;Bobota Nini;Savoir rester en hauteur;11621;208;577;4736;17142
matchu_pichu;↙️Matchu↙️Pichu↙️;(◠ᴥ◕ʋ);2080;221;27;14813;17141
ferhat_kouider;Kamel914869961;Retraité Sympa,Optimiste.Respecte et aime la nature sous toutes ses formes,stage de perfectionnement à la S.I.P Genève Suisse 1979/1980 .;1518;352;473;14798;17141
CedricMora;Cédric Mora;Security, Health & AI @AWS (ex #BigData #cloud #AI @DGEntreprises @orangeBusiness @Blue_DME #Startup #strategy @AXA). @univParisSaclay @HECParis;6265;2734;1208;6930;17137
ferrari_e;ferrari_e;Développement #numérique du territoire. #Prospective #corsica #TIC #Geek « strada dirita è core in fronte.»;7439;3103;2073;4521;17136
BugsAreArt;Bugs supplier;ChatGPT has eaten my EBITDA.;5158;275;97;11596;17126
EstelleDeMarco;Estelle De Marco;Freedoms/PIA/data protect + info-sec-crime since 98, PhD priv/penal law, (electric) harp, Linux & blockchain beginner/explorer;5433;1765;796;9128;17122
tisse_ma;tissema;Membre de la @RevueBallast – Adhérent Solidaires informatique;11631;504;391;4591;17117
wstraw;Will Straw;Professor of Urban Media Studies, McGill University;8349;1525;2353;4863;17090
isasevere;Isabelle Sévère🌻🌻🌻;Ex -Adjointe écologiste du Mans, en charge de l'enfance. Exclue de la majorité au bout d'un an par Stéphane Le Foll. Prof d'HG au lycée Yourcenar;5579;2183;1895;7427;17084
YvesBesan;Yves Besançon;"Économiste, Citoyen de la Terre, allergique aux mensonges des politiques et soi-disant journalistes les diffusant. 

Trolls et/ou abrutis bloqués illico !";14802;151;979;1136;17068
Tetrapharmak0n;Tetrapharmakon;Vu qu'on m'demande: Ingé Fct Pub démissionnaire, Finance (algo), Maraîchage, Autoconstruction, Souverainisme, Chrétien prudent.;6165;146;635;10120;17066
Prefet68;Préfet du Haut-Rhin;Compte officiel des services de l’État dans le Haut-Rhin.;6118;321;9889;724;17052
Youth_Ottawa;Youth Ottawa;Youth Ottawa is a leader in providing empowering programming in Ottawa, impacting over 8,000 youth per year and growing. Account managed by staff.;5570;2644;4141;4695;17050
PerruchoudMICHE;Michel;;9899;372;82;6693;17046
ThierrySergio1;Thierry Sergio;Expert Professionnalisation concepteur EDF #transitionénergétique #énergie #pédagogie #smartgrid #digital #EDF #formation #Relationclient #bascarbone;4050;298;191;12506;17045
survivalfr;Survival International – en français;Le mouvement mondial pour les droits des peuples autochtones. Nous luttons pour les peuples autochtones, la nature et toute l’humanité.;6906;3053;4169;2914;17042
FabriceCarles;Fabrice Carles-Fahnauer;Esprit libre - européen-centriste et humaniste. corse et toulousain tombé sous le charme de Metz, épicurien - ♿️;4816;431;94;11699;17040
LeMansplainer;Le Mansplainer;"''Il était difficile de savoir s'il était singulièrement fin, ou seulement très lourd.''

- Marguerite Yourcenar, L'Oeuvre au Noir";2977;141;83;13832;17033
AlthausMH;AlthausMH;UNIGE Sciences de l’éducation et curieuse de plein d’autres domaines comme l’Art, l’Histoire et les sciences notamment du climat. J’♥️ les sources fiables.;9639;438;330;6617;17024
mykowutazoqu;Mireille Bizier;soyez visible sur #internet;11622;5000;392;0;17014
Yask20434333;Yaské🇨🇮🇨🇮🇨🇮https://adherezcp-gps.ci/;"Panafricain
adherezcp-gps.ci/";2741;3033;2869;8366;17009
TontonSergio_;Tonton Sergio;"Marseillais à Montréal - J’ai fait Motus et QPUC - ""gaucho de ses morts"" d’après les haters";2471;847;190;13501;17009
Anthony_Alyce;Anthony Alyce;Fondateur @Ecofoot - Contributeur ponctuel @CercleLesEchos @latribune - Tout ce qui concerne l'économie du sport m'intéresse !;8542;1121;3103;4237;17003
AnnickCousin_RN;Annick Cousin;Députée @RNational_off de la 3e circonscription de Lot-et-Garonne | Conseillère régionale @RNational_NA de Nouvelle-Aquitaine;4300;316;2638;9746;17000
louriealexandre;Alexandre Lourié;Leading international and systemic activities of @GroupeSOS. Also novelist (La Dissimulation) and  collector of Art Brut and Generative Art;3681;992;1409;10917;16999
lordvanvan;lafont;;16106;117;77;697;16997
Robert57191213;Robert;;10056;173;74;6693;16996
Presse_Afrique;M5 RFP;POURQUOI PLUS DE 80% DES AFRICAINS ONT TENDANCE A CROIRE D'EMBLÉE CE QU'ILS LISENT, CECI SANS SE POSER LA MOINDRE QUESTION ??;6056;72;532;10329;16989
jeanmarcgrogneu;Crypto 🏳️‍⚧️ 🏳️‍🌈 🇺🇦 Macron 2027 🇫🇷;Qu’attendez-vous ? 👹 lgbthahdiabxoakfvaydoznrgrownavshwkzbfiqkbcfgakdbklshabdntmfdp;1837;143;67;14942;16989
CH_RonRon;Le RonRon;• Affilié Twitch • STREAMEUR • Présentateur chez @JVMag_ch • Multi-Gaming • 🏴‍☠️• Caster pour @FlamberesportOF •;1581;297;222;14871;16971
BertolaGerard;Gerard Bertola Therapeute holistique;;9610;338;127;6872;16947
IamEntry;Entry ð«ð·ðªðº;Conseiller technique presse dâ@Elisabeth_Borne | Ex conseiller com et presse de @StanGuerini & cab @FranckRiester | Ex @francediplo & @economie_gouv & @ausambfr;2547;1071;847;12471;16936
JbDeDouay;Gg.Ghost.Of.Time ( © GyjbB , 1974 );Un fantôme du temps dissident , en une époque bien incompréhensible…;10089;785;630;5415;16919
Perez_Ronan;Ronan Perez;Faire changer les choses sur : aménagement du territoire (#infranerd), mobilités actives, énergie, démocratie, social. J'❤: 🚲📖🏒🌳🐕🚀;5344;391;275;10906;16916
Petitscarab2;Petit scarabé;Rien;8214;75;75;8546;16910
RCF_CdC;RCF Cœur de Champagne 📻;Compte officiel de l’association RCF Radio L’Épine / Radio locale, chrétienne et généraliste dans la #Marne l’#Aube et la #HauteMarne / ☎️ 03.26.21.26.26;12698;656;853;2696;16903
MassartJulien1;Massart Julien;Instrumentiste à la centrale nucléaire de Tihange, amoureux de nature, passionné par le trail pour les découvertes natures et l'esprit de dépassement de soi.;7721;185;421;8574;16901
BienEveille;Tips and the City 2;"J'inspire la paix, j'expire la peur
Ne laissez rien ni personne perturber votre paix intérieure

Langues :  🇫🇷  🇪🇸 🇬🇧";7929;1657;586;6721;16893
PhilNfp;Phil NFP;Commerçant , investisseur, trader.;12518;75;86;4213;16892
AnneFrancoeur1;Anne Francoeur;;5013;25;318;11528;16884
karlblackburn;karl blackburn;"Authentique bleuet et porte-parole engagé des employeurs du Québec.
Compte officiel du Président et Chef de la direction du @conseilpatronat.";5090;2259;4926;4603;16878
GolColar;Colar Gol;C'est mort.;9133;2235;1237;4265;16870
KamikaAnne;2KA;IR refining & petrochemistry.Master Geoengineering.Professor of universities in becoming.Only the sky is my limit. Education|Intelligence Heritage of my parents;4168;1723;1719;9260;16870
KaAbboud;abboud;;16639;24;38;162;16863
Trilobi06631698;Trilobite;Anticapitaliste et sceptique.;8340;384;192;7943;16859
jo_delahaut;lelo;Bendele ekweya Te;8089;529;70;8165;16853
LInforme_;l'Informé;"Média d'investigation avec une rédaction de 15 journalistes.
✍️ Commencez votre essai gratuit : linforme.com/abonnements
📩 DM ouverts";3661;28;13040;93;16822
MacHugues;Hugues C. Masheka;I’m in love with my country ❤️🇨🇩 and Arsenal @arsenal;9534;1469;1020;4797;16820
FFatmospheres;Festival Atmosphères;Festival international de cinéma, arts et sciences pour un monde durable, plus juste en harmonie avec la nature. 13e édition : 11-15 octobre 2023.;3391;4767;2125;6506;16789
IlonaSwenne;Ilona Swenne;⚖️ Brusseleir sinds 1997 with 🇫🇮 roots;2084;809;1309;12577;16779
TomBryChevalier;Tom Bry-Chevalier;"Doctorant sur les enjeux économiques et environnementaux de la viande cultivée. ♿

Protéines alternatives, environnement, et altruisme efficace.";1623;545;3539;11034;16741
Frezelee;Freze Businessđšđ©đ§đȘ;Il est plus dĂ©sirable de cultiver le respect de sois que lâamour de lâargent.;7871;64;184;8619;16738
Samoripille;Sam H🍓O🍓R🍓Y Non au Pacte Enseignant!;PLC pour une école républicaine exigeante,du savoir et de l'excellence contre l'école au rabais du socle de l'inclusion à marche forcée et des compétences.;13162;256;243;3067;16728
DavidGuillerme;David Guillerme ✏️;Délégué académique à l’action culturelle #EAC📚@acrennes | Chef de mission académique #EDD🌍| Secrétaire général du Comité national EDD Océan et mers 🌊⚓️.;5580;1675;1959;7500;16714
PabloRebanne;Pablo Rebanne PRIME 🐢🇫🇷🇫🇷;si vous ne faites pas attention, les medias vous feront detester les opprimés et aimer les oppresseurs. Nouveau compte Pablo Rebanne ✊🐢🐢🐢🇫🇷;5750;2797;2309;5842;16698
EmmanuelCapus;Emmanuel Capus;Sénateur #MaineetLoire @indep_Senat Vice-président commission des finances délégué 49 @HorizonsLeParti Conseiller départemental @maine_et_loire Avocat;3943;3015;3726;6005;16689
BenjaminDelrieu;Benjamin Delrieux;Conseiller régional Nouvelle-Aquitaine. Élu référent pour le #PerigordNoir• #Apiculteur 🐝 • #Dordogne   🌳🏉;6849;2436;2480;4880;16645
mina_slh;mina🇳🇱;ni frère ni beau-frère;3767;56;48;12762;16633
s_yoncourtin;Stéphanie Yon-Courtin;Députée europénne @RenewEurope @Ensemble_UE • Coordinatrice #ECON • Conseillère régionale @RegionNormandie • #IMCO #PECH• Présidente de la délégation 🇪🇺-🇨🇦;3339;989;5722;6578;16628
anne_sicard;Anne Aubin-Sicard;Vice-présidente du Conseil départemental de la #Vendée, 1ère adjointe #LaRocheSurYon, Docteur #droit public #Europe #TransitionÉcologique;8735;1087;1876;4910;16608
ArianiLaurent;Laurent ARIANI;I am particularly interested in geopolitics.;6294;3885;1554;4864;16597
HoudoEric;Le Vigilant;Founder Think Tank Génération des Vigilants, le premier laboratoire d'idées de Jeunes cadres/ Founder ODD TV/Labs La GV/SDGs Advocate;1220;4057;1438;9873;16588
realYatcheu;Henri Yatcheu ð¨ð²;Paysan, non diplÃ´mÃ©, amoureux de la nature.;10124;2189;1451;2812;16576
ph_dussault;ph.dussault;"Fondateur MAGIC SUNDAY 
La fraternité est abîmée et tout doit être fait pour la restaurer.
Elle est un horizon citoyen et un horizon politique.";7427;587;119;8443;16576
IRISrecherche;Institut de recherche et d'informations socioéco.;Institut de recherche et d'informations socioéconomiques - à but non lucratif, indépendant et progressiste. Devenez membre pour soutenir notre travail!;5014;1029;9918;607;16568
snapqc;SNAP Québec;Porte-parole des milieux naturels québécois, la SNAP Québec agit au quotidien depuis plus de 20 ans pour la protection de la #nature et de la #biodiversité.;6626;1280;5150;3503;16559
C_E_R_4;Sam Cera;;576;326;40;15609;16551
CERIUdeM;CÉRIUM;Centre d’études et de recherches internationales de l'UdeM - Pour le développement des connaissances sur les enjeux internationaux;8807;438;6122;1176;16543
DrGonzo34693801;Dr Gonzo;En quête d’ataraxie;6111;1336;528;8564;16539
annie41315609;annie;Empathique;11963;101;189;4271;16524
AbiolaMoutairou;Ebenezer HOUESSOU;🧵COMMUNITY MANAGER at t.me/GenesisUniverseFr| Tg ID:@christ737|CONTENT CREATOR|DESIGNER|📍 BRAND AMBASSADOR for @certik. Manager for @Xwinnerfrench;8256;458;1280;6529;16523
MuambaMukalenga;Mukalenga Dieudonné (ya corre la saeta);ingeniero civil y rural, especialista en ordenamiento territorial y desarrollo sostenible, recursos hídricos y abastecimiento de agua potable.;1470;3997;1130;9918;16515
ElizabethIsar1;Elizabeth Isar;"Énième connasse qui ouvre son claque-merde
Accessoirement étudiante en histoire";1782;856;157;13714;16509
serge_rossi;Serge ROSSI;Passionné des sciences, Citoyen du monde et toujours émerveillé par la beauté de la planète.;7909;317;77;8204;16507
mpungidady;Dady Mpungiđź‡¨đź‡©đź‡¨đź‡©;Je suis un homme rĂ©flĂ©chi/Congolais de PĂ¨re et de MĂ¨re đź’Ż%đź‡¨đź‡©. Fan de Vita-Club/Real de Madrid/LĂ©opardđź‡¨đź‡© âš˝âš˝âš˝âš˝;4946;995;1028;9537;16506
MartinageSnetap;regis.martinage.snetap;"Co-secrétaire régional SNETAP-FSU des Hauts-de-France.
Pour la défense de l'EAP, actualités syndicales agricoles et maritimes dans les Hauts-de-France.";12219;160;121;4003;16503
nolan_173843;No./Lan;not ununfair;2515;76;42;13865;16498
FranceClusters;France Clusters;"@FranceClusters fédère les clusters, pôles de compétitivité et grappes d'entreprises de France ! 

Membre fondateur de @AlliedClusters 🇪🇺
 
Rejoignez-nous !";9854;1047;3777;1813;16491
LiceoFrancoMx;Liceo Franco Mexicano, A.C.;Institución que desde 1937 brinda en México educación francesa de excelencia, plurilingüe y pluricultural.;9256;1434;2726;3072;16488
VilleduGosier;Ville du Gosier;"Twitter officiel de la Ville du Gosier, Guadeloupe | Commune membre de la CARL | Appli Gosier Connect sur Google Play & Apple store |
ℹ Suivez notre actu ici !";9379;1764;4608;730;16481
thomasposco_13;Thomas Posco ð«ð·âï¸âï¸;"Chromosomes XY, Anti-Woke-TQIA+, Anti-Macron, contre l'islamo-gauchisme, contre l'U E. 
ð«ð·Patriote, mon Drapeau, mon Pays, ma Nation, mon IdentitÃ©.ð«ð·";3396;1608;1274;10191;16469
AgroQuebec;Agro Québec;Suivez Agro Québec et restez à l’affût de l’actualité et des tendances de l’industrie #Agroalimentaire.;3769;4988;3572;4129;16458
M_Alazon;Alazon;;16235;44;12;156;16447
TheoBouille;Théo Bouillé;Apprenti biologiste à l'@UniStra 🔬⏳ Amoureux de ma ville #Mulhouse 💚;223;127;635;15454;16439
KombeMarcel;Marcel Kombe;Economist and Researcher;3629;1790;1140;9879;16438
NupesNews;NUPES NEWS ⚒️🔻🌹🌻🇨🇵🇺🇦;"🎙️ Sondages Twitter (promis, pas de 49.3)
et Actualités (📰 Mediapart, Le Média, Libération, Courrier International et Le Figaro)";6675;105;955;8701;16436
Moussa__Sougui;Moussa Mht Nour SOUGUI;"Étudiant en licence 2 professionnelle en Technologie de Transformation des Produits Agricoles (TTPA).

Passionné D'ART🎨 et de la LECTURE 📚";1097;1855;1055;12429;16436
StefenS01;Stefen Send Nuclear HCB ð»ðð¿ð¦©;;5591;170;256;10418;16435
RIPlaliberte;Winston Smith 1984 Orwell;soldat digital car la guerre est virtuelle et d'informations mais pas que ...;3489;637;214;12085;16425
DAACBretagne;DAAC Bretagne;Délégation régionale académique à l'éducation artistique et à l'action culturelle de la région académique de Bretagne;5669;393;1880;8483;16425
Prefet80;Préfet de la Somme;Compte officiel des services de l’État dans le département de la #Somme - Charte de modération et d'engagement : bit.ly/3ScoR1H;5223;422;9269;1502;16416
NiortNumeric;Niort Numeric;Pour une dynamique de la filière numérique à Niort par @NiortAgglo. Organisateur du salon #NiortNumeric (7 Ed.), des #LiveSessionsNiort (2 Ed.) et du #SalonINNN;10492;559;3696;1666;16413
lememento;Mémento;Le mensuel des entreprises des Outre-mer et de l'océan Indien depuis 1970;14229;29;1973;179;16410
CadrerD;Cadrer•DECADRER;Un compte critique de l’anthroposophie. #Anthroposophie_Non_Merci;9963;296;489;5657;16405
GordonG64403666;Gordon Gekko;"Greed is Good
 
#RedPill
#Politique
#Trading";13219;575;730;1876;16400
varake80;M8 Varake 🇮🇹;"Supporteur du Stade Malherbe, de Ferrari,  de Peugeot, de Gasly, de Grosjean, de Quartararo,
bref je suis dépressifs....
Mais M8 me redonne un peu le sourir";2003;237;35;14124;16399
DarkVaDoors___;Mim's 🕋🇹🇳🇨🇵;Pour les Associations Tout est gratuit. #AdobeCC #C4D #DAZ #Zbrush . Animation et illustrations. Mim's م.;10856;807;363;4361;16387
BoureimaKabirou;Boureima M Kabirou;YALI RLCDakar,PrJUDD,Ecowas Youth Concil,YALINetwork, Alumini AUDA-NEPAD,C1000,Bpifrance,Leadership Jeune,defenseur de l'environnement,Promoteur de Nubi-Startup;8979;587;899;5920;16385
ActuPerspectiv;Vvv;"Le monde ne sera pas détruit par ceux qui font le mal, mais par ceux qui les regardent sans rien faire.
#francophonie #nation #humain";7894;235;1046;7203;16378
Khad_Brahim;ܐܒܪܗܝܡ #The_Estranged;Que la noblesse d'esprit m'empêche de tout acte vil, et non la crainte qui me retienne.;7893;283;280;7915;16371
poissonpodcast;Comme un poisson dans l'eau;"Le podcast contre le #spécisme animé par Victor Duran-Le Peuch 

#sentience
#véganisme
#éthiqueanimale
#animalstudies
#antispécisme
#oppressions";2827;1131;1668;10724;16350
MissEliGreene;Elisabeth Greene;#Hochelaga tatoué sur le cœur - un p’tit peu inquiète pour notre planète - découragée par nos décideurs, mais encouragée par certain.e.s du genre humain.✨;1922;395;369;13655;16341
MerGouv;Secrétariat d’État chargé de la Mer;Compte officiel du Secrétariat d’État chargé de la Mer du @gouvernementFR.;967;511;13734;1118;16330
ei64100;Iriba;;11673;103;42;4506;16324
philoinfos;Philoinfo.fr;L'actualité philosophique en vidéos ! philoinfo.fr Des milliers de vidéos sur notre site ! Diffusion numérique partenaire @MediaPhusis #philosophie;9199;3922;3200;0;16321
ThPellerin;Thomas Pellerin-Carlin;"EU Programme Director at Institute for Climate Economics @I4CE_
ex-@DelorsInstitute
Thinking EU #Investment #Innovation #Climate
Teach @SciencesPo @TP_Coleurope";4894;2073;5358;3986;16311
pressegauche;Presse-toi à gauche;"Presse-toi à gauche un journalisme engagé , tout à la fois rigoureux et pluriel, mais qui ne tergiverse pas; loin de toute pseudo objectivité.";13282;502;2504;21;16309
FiniLarnaque;In solo veritas;"666 ðdosâ¬$, variole du ðµð¦ðð¾, fan de Rothschild et du crÃ©dit social pour les autres, pilote du WiTiCi7 le II/O9
#ZeroTestNiDose, salut aux ex-abonnÃ©(e)sð";3118;249;194;12745;16306
MontignySerge;Serge Montigny;La liberté est un Idéal que personne ne peut nous empêcher de poursuivre. Freedom is an ideal that no one can prevent us from pursuing.;7241;1307;369;7388;16305
cestpasmonidee;C'est pas mon idée !;L'innovation dans les services financiers, par Patrice Bernard – patrice(à)cestpasmonidee.fr – #FinTech #InsurTech #Banque #Assurance;8262;66;7840;136;16304
Bellmousse88;Dans la matrix 8.8 {}¥££₩;@Game @Informatique @Mangas @IT;4635;720;207;10735;16297
Doggybag20;Shifumi;;2586;412;53;13242;16293
heritagemtl;Héritage Montréal;"📢 Promoteur et défenseur de l'ADN de la métropole
🏛️ Promoting and defending the city's DNA 
#montreal #heritage #patrimoine #polmtl";6315;1604;7049;1296;16264
RV_Joly;Hervé Joly;Chercheur CNRS, historien beaucoup, sociologue un peu,des élites, des entreprises, etc. et autres études ou avis n'engageant pas le CNRS!;10674;219;1967;3399;16259
joe_mbaya;Joe ⚡️🔋 🚙;#Passionné #EV & #BEV. Sans fanfaronner, 🇨🇩 a vocation à devenir la pierre angulaire de la transition énergétique écologique mondiale ⚡️🔋🚘;4978;1361;1230;8686;16255
pelleport33;Antheor Bordeaux;Teamchocolatine. Girondins de Bordeaux;6378;890;374;8610;16252
FederationCinov;Fédération Cinov;Fédération #patronale des #syndicats de la branche #BETIC : #conseil, #ingénierie, #numérique / #esn, #bureaudetude, #construction;10024;1098;2631;2499;16252
advocnar;Association ADVOCNAR;ADVOCNAR défend les populations victimes des nuisances aériennes. #Bruit et #Pollution chimique du trafic aérien : un véritable problème de #Santé publique!;4721;1489;1183;8856;16249
lascelle3232;Mathieu Lascelle;Passionné du Canadiens et NHL;9282;442;194;6329;16247
mickamej;GJ for ever;;10154;61;22;6009;16246
1837patriotes;patriotes1837;⚜ #PaysQc ENSEMBLE PATRIOTES!;12042;720;501;2975;16238
TMaugier;Thomas Maugier;;12220;879;635;2503;16237
Tombasse;Daz;"Prof et Dazou.

Le reste du temps, je cuisine, jardine et joue de la basse.";12443;130;128;3534;16235
EmonLusk2;Edgar ,Flo ð´ââ ï¸ð;Un irresponsable pas vax malgrÃ© la forte propagande mediatique payÃ©e par Bill Gates et ses amis milliardaires qui nous gouvernent;7687;861;358;7313;16219
Prefet61;Préfet de l'Orne 🇫🇷;Compte officiel du préfet et des services de l'État dans l'#Orne (61);8125;602;6409;1073;16209
AhramHebdo;Al-Ahram Hebdo;Hebdomadaire égyptien en langue française, publié depuis 1994 par la fondation Al-Ahram.;9209;46;6950;4;16209
FranckSarrazin7;Franck …;;4684;441;245;10824;16194
tuttoto1;DARKER;Mankind is currently chosing its fate... I am here to help...;5682;345;283;9882;16192
kharumtoupitoup;JP;«On ne voit bien qu’avec le cœur, l’essentiel est invisible pour les yx»«Ceux qui optent pr le moindre mal on vite tendance à oublier qu’ils optent pr le mal ».;2551;196;23;13409;16179
aline41343692;Ce matin...;tu veux savoir quoi ? perds pas ton temps à répondre à mes tweets.;10156;36;28;5959;16179
pays_ajaccien;CAPA;Compte officiel de la Communauté d'Agglomération du Pays Ajaccien: 10 communes, + de 80 000 habitants.;9630;426;3899;2207;16162
Christo82610665;Christophe Moreau;;6564;157;89;9349;16159
ScarabeeO;Scarabée D'Or;;6986;875;158;8127;16146
JLucDesbonnet;Jean-Luc Desbonnet;S'il est bon de ne rien dire avant de parler il est encore plus utile de réfléchir avant de penser.;13063;695;107;2269;16134
OnuGuinee;NATIONS UNIES GUINEE;"Compte officiel des Nations Unies en Rép. de Guinée. 

24 Fonds, Programmes et Agences du SNU appuient le gouvernement guinéen pour le Développement et la Paix.";1913;139;13193;883;16128
AurelieDelm;Aurélie Delmas;Journaliste indépendante (dans la Drôme et ailleurs), souvent @Vert_le_media / Coordinatrice pédagogique @cfjparis (à Lyon) / écologie / DM ouverts / ex-@libe;9351;1892;3184;1699;16126
thomasbreuzet;Thomas Breuzet;entrepreneur PME bio Sud-Ouest (QUINOAK : Péchalou-Baskalia-Granabio) - MBSO Resto-Co- SYNABIO - INTERBIO NA - Ingé agro qui adore sur les épaules de Darwin !;3680;2017;1051;9377;16125
SMABTP;SMABTP;Retrouvez les actualités de SMABTP, les dossiers thématiques #Prevention, #Assurance, #BTP pour tous les professionnels de la construction et de l'immobilier.;7094;2867;3416;2747;16124
Mr_25000_Volts;Mr 25.000 Volts;;4457;88;176;11398;16119
AngaliMabiti;Mabiti Angali;Journaliste vétéran;5186;5003;4548;1364;16101
NickSchabernack;Nick-Nack;;7597;293;27;8178;16095
MattGomes21;Matt Gomes;“Democracy and liberty are not the same. Democracy is little more than mob rule, while liberty refers to the sovereignty of the individual.”― Walter E. William;4496;634;186;10773;16089
RemiVanel;hervé;@reveilecolo;3699;1295;207;10863;16064
joel_arseneau;Joël Arseneau;député des Îles-de-la-Madeleine, pp du PQ en santé, famille, environnement, transports, affaires municipales, habitation, pêches, relations internationales:;6315;465;5950;3320;16050
smoTr39;Tom;ce qui manque au Président c'est le courage de faire ce que personne n'a fait depuis des décennies. Ils abandonnent tous une fois élu, en conscience.;6139;1982;621;7306;16048
Conservateur20;Souverainiste 2.0;Comment passer les pointes d'hiver avec seulement 50% de nucléaire ? Les EnRi produisent peu l'hiver. On revient au charbon/gaz comme l'Allemagne?;11686;2654;1242;455;16037
ahaoups;Phi;;6593;151;24;9266;16034
BiPgazpetrole;BiPgazpétrole;"Seul quotidien français de l'industrie du #petrole et du #gaz, de sa #TransitionEnergétique & énergies alternatives
Suivi des politiques énergétiques";11115;1594;1789;1530;16028
ErnestPriarollo;Ernest Priarollo - Réforme & Travail;"Ingénieur, MBA et entrepreneur engagé.

PRT: la révolution productive pour que la #FranceGagne !

#LR #NouvelleEnergie";8566;51;307;7096;16020
BndicteRobert;Bénédicte Robert;Rectrice d'académie @acpoitiers | #éducation | #RH | #numérique | #sororité | ex directrice @ih2ef | 🌍💚 | 🇨🇵🇪🇺;1823;1053;6353;6784;16013
HERBELIN7;SEB_AST_IEN;;15223;405;203;164;15995
ColonelBiscuit_;Dr Biscuit mi-fatigue mi-raisin;"Un petit biscuit au cœur moelleux. Mais méchant. 
Dr, MCF.
#écolo, #féministe, #cat addict.
PP @grillaum";3643;356;51;11944;15994
DirectionInfo;Direction informatique;La source d'informations et échanges en technologies de l'information et des communications (TIC) interentreprises au Québec depuis 1988 zurl.co/IU0Y;10820;1311;3705;148;15984
missclimat;ADAMOU Maïmouna #GreenWeek;Génie ruralist / T.S en #Anglais #Didactique , #Activiste #Environnement, #Consultante J #Genre & #Climat , Directrice Camp Climat Régional des Jeunes @FFFMAFA;2753;257;1149;11824;15983
alainmundeke;Alain Mundeke;Entrepreneur & Business Consultant;7653;282;432;7606;15973
Portail_IE;Portail de l'Intelligence Économique;Centre de ressources et d'information sur l'#Intelligenceéconomique et stratégique : articles, brèves, annuaire, évènements, ressources diverses. #PIE #IE @AEGE;3812;185;11577;395;15969
GrenierJeanBap2;Grenier Jean-Baptiste;"Diplôme en énergie de Centrale
Ecologie, Service public,
Bifurcation écologique à Trappes
Rédacteur écologie #lvslmedia";579;703;407;14278;15967
Mdiallo289;Diallo mohamed;passionné d'architecture,d'histoire et de littérature et profondément humaniste. Oeuvrons à laisser un monde meilleur aux prochaines générations.;4666;240;214;10846;15966
StephanArnaud;Arnaud Stephan;ex-conseiller communication de @Marion_M_Le_Pen | Chroniqueur TV | Communicant | Fondateur de lanotedecom.com | Mes publications n’engagent que moi.;6772;2174;3223;3796;15965
PXMRJ07;ʝҽɾҽɱ 🇨🇵🇪🇺 ジェレミイ;"🇨🇵•🇪🇺 
Principalement des tweets cinéma très grand « FAN » de l'univers DC Comics.";10669;103;103;5071;15946
Alcool2Riz;Grain de riz;Grain de riz fournit des analyses politico-stratégiques et économiques.;10542;0;112;5290;15944
SocBotaniqueF;Société botanique de France;La Société botanique de France est une société savante qui participe aux progrès de la botanique par des études, travaux et l’organisation de rencontres.;1475;450;13592;426;15943
rafaelmaychmaz;Rafael Maychmaz;"Conseiller Municipal à #SaintCloud
Avec @EmmanuelMacron @renaissance / CN @TerresDeProgres.
Ingénieur";2915;3488;1289;8249;15941
IPSA;IPSA;L’école d’ingénieurs de l’air, de l’espace et de la mobilité durable – Formation d’ingénieur.e.s en aéronautique, spatial, transports – Membre de @Groupe_IONIS;6545;1018;3288;5089;15940
shawnmickeyy;Fan2Football;Amoureux du foot et surtout de @OM_Officiel #TeamOM #TeamFootball;15130;355;155;299;15939
Reality_Canada;Climate Reality Canada / Réalité climatique Canada;Supporting mobilization and education for community-led #ClimateAction / Nous soutenons la mobilisation et la sensibilisation pour l’#ActionClimatique citoyenne;7520;1550;2589;4261;15920
melanie_rsn;Mélanie Roosen Ⓥ;"✍️  Rédac' chef #RSE #Leadership @intelekto_media (melanie.roosen(a)intelekto(.)fr) et contenus @777_corp 
👋  Ex @Novethic, @LADN_EU 
👊  ♀🌱";7405;975;2263;5276;15919
ahermant;Antoine Hermant;Député régional du PTB, chef de groupe PVDA-PTB au Sénat et président du PTB Centre;7632;790;1004;6492;15918
IFGeopolitique;Institut Français de Géopolitique;L'Institut Français de Géopolitique a été créé par le Ministère de l'Enseignement supérieur au sein de @UnivParis8 et est lié à la revue Hérodote;1656;276;12722;1240;15894
Maritza617;Maritza 6;Compte de secours de Mila;7037;1525;635;6687;15884
DemeterVTM;DΞΠΞΓΞЯ;Passionné d'EDM, d'automobile et d'animé/manga. A le malheur d'être souvent mal compris... Futur VTuber ? Compte musique : @edm_eter;14997;336;74;471;15878
leekui1080;leekui;;2055;77;51;13692;15875
niccpianc;Niccolò Pianciola;Historian. Formerly @UniTrento, @lingnanuni, and @NUedukz, currently @UniPadova. Born at 328 ppm.;8986;5000;1087;795;15868
lepourmener;Philippe, le Promeneur;J'ai décidé d'être heureux et de marcher parce que c'est bon pour la santé;12164;499;317;2882;15862
villedeputeaux;Ville de #Puteaux;Compte officiel - puteaux.fr | Instagramđ· : bit.ly/3D9JF2N | Facebookđ„ : bit.ly/2ZVNier | LinkedInđ : bit.ly/3a4ubR8 | â 01 46 92 92 92;9427;497;5211;726;15861
maxilacoste;Maxime Lacoste;Conseiller municipal Saint-Sulpice-la-Pointe (81) | Justice Ă©cologique et sociale | services publics | @StopTERRA2 | đ paniques morales | Groucho journalism đ„ž;9216;1580;1866;3186;15848
chris_goethals;Christophe Goethals đ;Software Engineer in healthcare sector. Passionate of IT tech. , gravel and Photography . Concerned about global warming.;6157;891;299;8491;15838
benmesot;Benoît Mesot🇨🇭;Papa, Agriculteur, producteur d'électricité, fan de sport en général (hockey en particulier) et j'en passe... vaches Angus !;5574;716;472;9065;15827
ZartokRU;oleg 🇷🇺🇭🇹;;8293;557;115;6861;15826
KZarL_;Soma 🌊🇫🇷;Lost soul;2398;272;44;13109;15823
NicolasMaubois;Nicolas Maubois;Passionné automobile et fondateur de Watture ⚡️ Road trips réalisés en électrique : 🇫🇷🇨🇭🏴󠁧󠁢󠁥󠁮󠁧󠁿🏴󠁧󠁢󠁳󠁣󠁴󠁿;5169;415;5649;4587;15820
DomieKouaho;Dominique Severina Kouaho;Astuces zéro déchet  | Gerante de DOMEES | Fondatrice à @Donneursdespoir👩‍👧 | @oeci__225 #crochet #food #foot;6839;816;747;7415;15817
BogeyUrsule;Bogey Ursule;"""Tout est poison, rien n'est poison: c'est la dose qui fait le poison""
Paracelse.";14130;188;220;1266;15804
PsyPierreLouisF;Frandy Pierre-Louis;"Psychologist,BA|Dev. Leadership @CoadyStFX at @stfxuniversity|Membre associé @DIVERT_mhsm|Correspondant Int. à @FrancophonieSF
Initiateur #DialogueSantéMentale";3327;2560;444;9471;15802
Mangasushi2;­čçĘ­čçÁ­čľĽMangasushi ­čąĽ­čąĽ­čąĽ;Lecteur de mangas. Mangeur de sushis. Patriote. #ZOZZ;6950;2558;917;5367;15792
Emile_Doigts;LA SENTINELLE FRANÇAISE;"JE SUIS UNE SENTINELLE. J'ai pas voté l'Europe je suis français.
Macron n'est pas mon président. il m'a insulté j'ai le droit de n'avoir aucun respect Pour lui";9838;1208;484;4258;15788
lbonvieuxx;H o l y f i e l d🏴‍☠️;J’suis le même enfoirer qu’Eric Cartman. Coeur en titane, paire de tzigane. 🇲🇦;11472;107;87;4114;15780
thierryB75015;thierry;Mes Tweets n’engagent que moi et personne d’autre, Républicain tendance David Lisnard mais pas ultra libéral, prêt à débattre de tout mais avec courtoisie.;7449;424;135;7766;15774
alfaa_19;alfa;non;8363;362;138;6910;15773
OdietVincent;Odiet Vincent;Paysan dans l'âme, jurassien indécrottable. Le bonheur se cache dans les petits plaisirs du quotidien. Faire comme les autres, c'est s'exclure soi-même.;5783;383;147;9454;15767
Philo_Makiese;Philo Makiese;Ingénieure Projets | Spécialiste en Communication | ancienne Journaliste | Présidente fondatrice mvt Le Congo Mérite Mieux (CMM) @mouvementCMM & @RadioAfriqueFr;5794;1455;3980;4530;15759
PatLaurent;Patricia Laurent đ«đ· đȘđș đșđŠ;Cofondatrice et directrice de la rĂ©daction de @GreenUnivers, le mĂ©dia des professionnels de la transition Ă©nergĂ©tique;7076;1860;2686;4131;15753
martinrbi;Martin R. Bilodeau;"Vive la communication écrite; pour une presse libre et diversifiée. Intérêt envers les enjeux politiques, le cinéma, l’économie, la course, le vélo.";3720;851;160;11012;15743
Katumbi_;Katumbiste Non Silencieux;"Association #Katumbiste pour le bien être du #Congo.
Le Défenseur permanent du Katumbisme et de #Moïse #Katumbi.
#RDC #Kinshasa #Lubumbashi #Katanga #Lualaba";5230;1949;5022;3532;15733
chancard_nsangi;NCD🇨🇩🌹;"Ingénieur BTP🇨🇩.                                       
*jeune entrepreneur 🇨🇩
*l'hoe qui veut le changement de la RDC";6015;2267;1341;6110;15733
edelareguera;E. de la Reguera đ @edelareguera@mastodon.nu;"""The chief trap in life is one's own identity"".";6728;764;154;8067;15713
BlazkoLeBarjo;Blazko le barjo;"đ«đ·
IngĂ©nieur, CAO, Impression 3D, Usinage CNC, Electronique, Programmeur Web & C/C++";9604;487;463;5150;15704
sonia_ratte;Sonia Ratté;"La Vérité vaincra.
The Truth will prevail.";5745;1235;277;8442;15699
pascal_dmr;pascal;;7557;219;223;7693;15692
LP_Debats;La Presse Débats;Éditoriaux, caricatures, lettres d'opinion. Suivez l'équipe de Débats de La Presse.;13567;147;1977;0;15691
huguette_krain;huguette KRAIN;;8058;152;86;7384;15680
colinedejean;Coline Déjean;Le climat change, peut-être que nous devrions faire de même. #ZeroWaste #LowTech #CriseClimatique 🔥;2367;1369;432;11504;15672
nt1_;nt1;Ligne éditoriale en vrac, punchlines à la bière, zor pacifique, design et charbons ardents.;14989;204;381;97;15671
droitdelacom;RIVOLLIER HENRI;Expert en Droit de la Communication #DroitDeLaCommunication. #Déontologie #RSE #CommunicationResponsable #ConsommationResponsable #612R;9946;1822;1873;2028;15669
awky2;awky 🇫🇷 🇺🇦 🇦🇲;;13651;374;212;1429;15666
BregiMikael;JO lasavate;Ta rage n'est pas perdue.;4920;313;68;10363;15664
Thebuzzlydotcom;Thebuzzly;TheBuzzly News a des histoires de rupture et des reportages originaux sur la politique, l'actualité mondiale, les médias sociaux, les tendances virales, la sant;15520;38;25;61;15644
LightJuggernaut;Grizzly;"Nationaliste français, anti-anti-capitaliste. Les socialistes sont des cons.
Paie ton loyer et rage en silence.

Kabyle de sang parfaitement assimilé.";5415;188;88;9937;15628
guerinot77370;Sébastien Guerinot;Agriculteur dans le middle east du 77 🚜 élu chambre agri IDF / #JA /#FDSEA/#agripapa #colza #blé🌾#pois #orge #maïs 🌽#tournesol 🌻;3433;625;1120;10448;15626
Jeanbat31;jeanbat 31;đąđąđąđąđą / Fallait pas voter Macron !;9175;1395;573;4471;15614
filodigiulia;L͢e͢ f͢i͢l͢ r͢o͢u͢g͢e͢ 💄🐢;De la Commune à la future Révolution citoyenne.;9859;461;1899;3388;15607
LeluOlivier;LELU olivier;Fils d’agriculteur, ingénieur agricole, depuis 27 ans protection cultures, respect de toutes les agricultureS HVE, BIO, conventionnelle. tweet perso;6683;1600;1189;6128;15600
IMT_NordEurope;IMT Nord Europe;#IMT#GrandeEcole #Ingénieurs @hautsdefrance #Numerique #cybersecurity #Environnement #Industriedufutur #énergie #Géniecivil #IT #Plasturgie #Telecom #innovation;7815;1021;2472;4291;15599
Gloubib57321230;Gloubi boulga;;957;260;55;14308;15580
CNRSIdFSud;CNRS Ile-de-France Gif-sur-Yvette;L’actualité des laboratoires du @CNRS sur le territoire #ParisSaclay, cluster scientifique, technologique et d'innovation;4382;1502;4226;5463;15573
guigrinch;Guillaume Côté;Montréalais, 29 ans et amateur de politique. Social-démocrate, indépendantiste convaincu. Vive le Québec libre 💙⚜️🤍;2110;886;557;12017;15570
VinsPaysdOcIGP;Vins Pays d'Oc IGP;"Compte Officiel des Vins de CĂ©pages I Pays d'Oc IGP đđ«đ·
#paysdocigp Indication GĂ©ographique ProtĂ©gĂ©eđ #Occitanie
Ă consommer avec modĂ©rationâ.";7116;1144;4745;2558;15563
Berenos_Celte;Je ne supporte pas les TROLL.;Retraité;6297;37;53;9174;15561
Zorglub597;Zorglub597;Passionné par la politique, l'écologie, la finance et la blockchain depuis longtemps. Non je n'aime pas les sujets non clivants 🤣🤣🤣;5812;375;105;9251;15543
cresp_sante;CReSP - Centre de recherche en santé publique;Le CReSP est issu d’un partenariat entre le @ciusss_csmtl et l’@UMontreal. Il vise soutenir des actions de #santépublique fondées sur des données probantes.;6989;322;2151;6076;15538
barim_deniz;Deniz ERDOĞAN BARIM;🇹🇷Türkiye Cumhuriyeti Fildişi Sahili (Kotdivuar) Büyükelçisi 🇹🇷Ambassadeur de la République de Türkiye en Côte d'Ivoire//Compte personnel;1861;402;2294;10975;15532
VMO_81;Vi_R;Ingénieur en infrastructures hydrauliques et hydroélectricité;10273;220;351;4680;15524
Noctis84477894;Noctis64;;7904;703;395;6499;15501
DansReel2;Julien Boetto;Mes tweets n’engagent que moi. Référent 13/14eme arr Marseille @Nouv_Energie Père, entrepreneur, artisanat.;7416;566;1704;5807;15493
TyphaineOff;⌬Tytou🔻;"Chimiste amateur
Pseudo 𝔸𝕓𝕤𝕥𝕣𝕒𝕔𝕥 𝕒𝕣𝕥𝕚𝕤𝕥";3508;266;81;11634;15489
crypto_tom1;cryptotom;CTO on demand, Blockchain, crypto and ICO, interested by blockchain related projects;9368;63;80;5975;15486
LetigreSamuel;The real Trumpette;;12707;98;239;2432;15476
LogistecGroup;LOGISTEC;"An innovative player in the marine and environmental industry.
#LOGISTECFamily";6545;906;795;7230;15476
apyroman;Apyroman;Réfractaire au suicide.;5984;555;163;8771;15473
Pierre_Jean_75;Jean pierre Delorme;Any territory conquered by obscurantist and hateful ideology, tends to be populated exclusively by oppressed and oppressors, fall into violence and end in ruins;8515;1543;1020;4394;15472
dcfrenchloos;David Cameron French;QUI SONT CES BARBARES IMPÉRIALISTES COLONS EUGÉNISTES DÉSHUMANISÉS QUI VEULENT HUMILIER LES NOIRS AFRICAINS & AVOIR LES RICHESSES AFRICAINES SANS LES AFRICAINS?;4570;5001;857;5043;15471
FSaconnet;FredSaco !;Socialiste fidèle, ni passé à droite, ni passé à l’Est. Ça m’arrive de courir aussi. Et arrêtez de regarder Cnews et BFM. La vie c’est la musique.;2700;357;207;12205;15469
Mercier08913200;Mercier Patrick;;14059;10;19;1369;15457
lewaf;Le Waf đ„©;"J'aime le #bitcoin et les CDBC.
VĂ©gan gay dĂ©fenseur des boucheries et anti-sodomie. 
Pour arrĂȘter la guerre, envoyons des armes.";9927;419;268;4842;15456
hermine_megane;Bebecitaa 🧚🏽;I’M PRESSURELICIOUS 🤰🏽;4900;772;1957;7821;15450
europe_tp;Nicolas Gaubert đź‡Şđź‡ş;"#Europe
#Infrastructures
#Territoires";13743;526;1121;58;15448
edstertwit76;ross76;Pas de destin mais ce que nous faisons.;10970;6;25;4444;15445
enufCanada;enuf;"A B-Corp on a mission to do whatever it takes to fix the #wastecrisis.  email: community@enufCanada.ca 
#enufIsEnough #CUcompost #Sustainability #Montreal";3268;5197;5520;1459;15444
MoriePhilippe;Philippe Morié;"Délégué général / Executive Director - @AEDHmonde
Représentant / Representive - @TournonsLaPage Europe";4693;4980;2184;3585;15442
flotauto;Flottes Automobiles;L'actualité de la gestion des véhicules d'entreprises et collectivités. Organisateur #RencontresFlotauto;9923;503;3431;1582;15439
Nu_Cleon;Patronus đź‡«đź‡·;"J'aimerai pouvoir sauver tout le monde.

Je ne reste pas passif en prĂ©sence du mal.
đźŹ€
VolontĂ© inĂ©branlable.";14725;501;118;95;15439
patrlane1;Petrolan;Directeur de club de gym .Déteste l injustice et les faux-semblants.;6648;123;102;8557;15430
FactsShop;Johnson Ndahiro;Congo is short of leaders. Tshisekedi and Muyaya crying like babies when they are trouble makers won’t solve any problem.;1184;634;13264;340;15422
Laurent27378652;ParfaitLeDieux;"Passionné d'histoire, je ne peux supporter ceux qui me donnent des argument historiquement faux en débat
C'est à dire la plupart des gauchos et des pro 🇺🇦";8412;36;25;6939;15412
_Victor_RG_;Victor Roux-Goeken;"Journaliste @Contexte ð Paris
DÃ©celer le politique sous le technique vrg at contexte dot com 
PGP 53E5FF8FA28F93B6 
DÃ©passe les ð";7082;1020;3875;3434;15411
O_Kowalewski;Oskar Kowalewski;Professor of Finance @IESEG School of Management;667;501;211;14032;15411
MissMwambe;Miss Mwambe 📚🇫🇷🌻🇺🇦;« Ils parlent de vérité mais choisissent des trucs qui les arrangent et ignorent le reste. » Thomas Pesquet;10236;167;137;4863;15403
gregory_sdd;Gregory SDD;;9013;360;185;5841;15399
johann_ndom;Johann;environnemental engineering student. 🇨🇲 🙏🏿 #halamadrid;10180;219;319;4681;15399
NatureQuebec;Nature Québec;Sensibiliser, mobiliser, agir! Depuis 1981, nous menons des projets pour biodiversité, le climat, la forêt et l’environnement urbain au Québec.;5280;347;8831;937;15395
jerome_dede;dede je;;1246;156;21;13964;15387
gimsicdatgwem;Irénée Akilimali 🇨🇩;"Electrical and Electronic Engineer.
Interests : Renewable Energy | Solar energy |battery technology|iot|ML/
I AM BECAUSE WE ARE✊🏿";4649;840;465;9430;15384
dcarlach;Dominique Carlac'h;Chef d'entreprise engagée | Candidate à la présidence @Medef 2023 2028;3694;1408;3529;6752;15383
LeRequinNoir971;Melkisédec97One🇫🇷;"#Bible 
🔥Le retour du #Christ est imminent et les prophéties sont là, mais à l'instar des contemporains de Noé les incrédules seront à nouveau surpris.🔥";6313;1840;1739;5482;15374
LabFabfr;LabFab;LabFab, comme laboratoires de fabrication. Découvrez l'actualité du réseau du LabFab étendu #FabCity #Makers;3756;973;6482;4135;15346
AdrienBalG;AdrienBàlG;Cueilleur de plantes sauvages, apiculteur, naturaliste, wikipédien, rural, athée, omni-locavore, agro-écolo, triple vacciné, curieux, lecteur de sciences.;6165;388;150;8641;15344
koeo_net;KOEO;#ESS accompagne entreprises/salariés à offrir leurs expertises pro/perso aux assos d'intérêt général - #pionnier dès 2008 du #mecenat de #competences #RSE #RH;4086;4882;3680;2696;15344
1375sosmi;Thierry;Ingénieur es sécurité des infrastructures et des données;2059;2295;1263;9726;15343
mayalc9698;Mayalc;Les bibliothèques, la doc., la veille;14339;261;215;522;15337
mtrauchessec;Marc Trauchessec ðªðº;Le vent se lÃ¨ve, il faut tenter de vivre (Paul ValÃ©ry)  #LibertÃ© #LaÃ¯citÃ© #DÃ©mocratie #Universalisme #Climat #Arts #Rugby;10253;271;308;4501;15333
Goneri76;Gonéri - @Goneri@mamot.fr;"Retrouvez moi sur Mastodon et LinkedIn!
mamot.fr/@Goneri/10937827982…
linkedin.com/in/gon%C3%A9ri-…";3552;2796;3336;5647;15331
RmdCoco;死;(mon ig c'est _philotes._);6041;183;57;9046;15327
Physettes;Alexandre Fisette;Professor of Medical Biology at @UQTR. My lab studies the neurobiology of obesity. Dad, cyclist, beer-geek. Views my own.;5353;1146;870;7933;15302
fne_mp;FNE Midi-Pyrénées;France Nature Environnement (FNE) Midi-Pyrénées, fédération régionale des associations de protection de la nature, de l'environnement et du cadre de vie.;6511;754;1650;6369;15284
InformEnergie;Énergies Informations;"Un jour j'en ai eu marre du traitement médiatique des questions d'énergie, donc j'ai créé mon propre média.
On est jamais aussi bien servi que par soi-même.";3460;1036;283;10496;15275
JPierre_FABRE;jean-pierre fabre;#lemans #sarthe #laseynesurmer #ollioules;8389;1594;2045;3217;15245
TelegrammeAuray;Le Télégramme Auray;En direct avec la rédaction du Télégramme Auray, de la baie de Quiberon à la forêt de Camors.;14238;233;674;91;15236
catbouvier11;Catherine Bouvier;#Marketing #Communication print digitale FR/EN #Japon #Traduction #Littérature anglo-américaine #ClimateChange #i4Emploi Tweets my own;9815;486;221;4683;15205
copinmalin;Copinmalin;"un homme comme les autres, 
bitcoiner classe 2017
Créateur @annecybitcoin meetup
Co-fondateur @alpinechain_xyz
traducteur bitcoinoptech";7283;497;470;6949;15199
FORMISANOROBER2;JENAIMARRE;;11769;234;384;2808;15195
ljmontcalm;Louis-J. Montcalm;Louis Joseph de Montcalm-Gozon, marquis de Montcalm (28 février 1712 à Nîmes - 14 septembre 1759 à Québec);11317;711;567;2599;15194
AntoineLaVoix;Antoine;;14965;16;39;156;15176
Hugo_neppel;Hugo | Trader ⚡️;"Trader FX | Finance moderne
Building hubtrading.xyz";8315;385;459;6015;15174
Rachacha63;Rach;Une position inconfortable est le prix de la constance de ses opinions;4345;252;131;10444;15172
OkayDays_;OkayDays by OkayDoc;Portés par @Okay_Doc en #France et en #Afrique les #OkayDays sont le point de rendez-vous des #sciences et de la #Tech #AfricaTech #FrenchTech;3015;2154;1231;8765;15165
investir_canada;Investir au Canada;L'agence nationale de promotion de l'investissement qui appuie l'expansion des entreprises mondiales au Canada. Avis: ow.ly/okEL50B3MyX EN: @invest_canada;9264;397;5256;248;15165
LPhilosophique;ð«ð·La Chaine Philosophique;ð«ð·NICOLAS GUGLIOTTA, Essayiste Philosophie, Coach Sportif/Bien-Ãªtre @LibreCollectif des Bdr Ce qui ne tue pas rend plus fort. Nietzsche #SoutienSuspendus;6103;2207;1518;5330;15158
RougePhenix84;Fernand lebatard;Dans la mare aux mensonges, les poissons finissent toujours par mourir. ...;3608;1799;225;9517;15149
RadioInzamba;Radio Inzamba;La radio Inzamba a commencé à émettre sur le net le 10 juillet 2015.Vingt journalistes et techniciens produisent 2 journaux en Kirundi et en français par jour.;4159;485;10379;116;15139
jibe_jeybee;jibé;;3491;5002;364;6270;15127
LondeStephan;Stéphan;"6eme régions de France 📍64
#fraisage  CN  #turning CN ⚙️ 🖥️ 🏍️🚄🏎️🚢🚁🚀🛰️🛩️✈️ 🔩  #plaquiste ✏️📏📐🪚 #commercial 💼";6498;1367;838;6422;15125
ChadOwban;Chad Owban;Welcome to Idiocracy ð¤¡ðð¥¬ððð! Educate yourself towards sustainable financial freedom. Study the unteached. Ne comptez sur personne ! â®ï¸ðµð¸;3098;754;83;11189;15124
MobuliMalick;Malik;Licencié en génie informatique. Apprivoisable parfois…Domptable, Jamais! ☝🏾;4458;436;249;9980;15123
SergeLetchimy;Serge LETCHIMY;Président du Conseil Exécutif de Martinique • Président du Parti Progressiste Martiniquais  #AliansMatinik, notre programme 👇🏿;4047;639;10137;297;15120
cyrilpasteau;Cyril Pasteau;Rage, rage against the dying of the light. ð» conseiller mun. @EELVMontrouge @MontrougeES // #jdr L'HÃ©rÃ©sie cathare (VAdT20), Thoan / imaginair.es/@cyrilpasteau;1811;1563;612;11129;15115
adleon__;Léon;"Justice sociale, écologie, droits humains, démocratie, inégalités.
#Climat 🌍 🌱 #ServicesPublics
#StandWithUkraine 🇺🇦";7498;1325;2421;3871;15115
DecrypteEnergie;Damien Salel;Ingénieur généraliste énergie-climat, analyses et opinions sur les discours de la transition énergétique (compte personnel / actuellement en ALD).;5531;509;5582;3486;15108
_WillyBee_;G.B. Stone;Chercheur d’or en Amérique, auteur en herbe, cynique reconnu par des paires.;7986;173;34;6908;15101
fi_ilunga;Tango india;Manager Ets TANGO FULL BUSINESS;6730;1223;780;6366;15099
MouginThierry;MOUGIN Thierryð«ð·ðªðº;Amoureux de PARIS, mais celui d'avant... 2000 !!!;7236;254;177;7422;15089
sicoval31;Sicoval;Le fil institutionnel de la communauté d'agglo du Sud-Est Toulousain. Compte officiel;3730;339;2500;8516;15085
IHEE_Institut;IHEE - Institut des Hautes Études de l'Entreprise;Programmes d'ouverture, de réflexion et d'inspiration pour #dirigeants #leadership #LearningExpeditions #PedagogieImmersive #international #entreprise #mutation;911;784;336;13044;15075
stephan63789885;Stephanie Andre;Responsable Souscription collectives direction services clients;8113;170;193;6598;15074
Jonathanmayele2;Jonathan mayele;gradué en science & technique du secrétariat de direction, licencié en secrétariat de diplômatie, maîtrise en développement personnel, formation en management;687;4209;949;9222;15067
EmiliElonore;libertaire ðŸ¦¢;"-la fin de pÃ©trole est une bÃ©nÃ©diction, assurÃ©ment 
-chimiste et Ã©cologiste
piped.video/rxKoIXYjsgE";5601;292;160;9007;15060
CoureauFrederic;Coureau Frederic;Journaliste - Modérateur - Consultant en stratégie éditoriale, production de contenu et marketing d'influence...;7370;1599;665;5421;15055
CRoumegue;Citoyen Roumegue;;5166;157;23;9705;15051
baneskio;🌞 Neskio;Omniphobe & intolérant | Prince & prophète de l’âge de bronze;4679;295;208;9867;15049
667sc;đšđ”Yvanseđšđ”;#jambonbeurre;4850;1727;1205;7265;15047
la_quile;La_Quile;!!!?;5669;545;226;8595;15035
ludovicherve33;Ludovic HERVE;"Developpeur Durable #Ecologie #TransitionEnergetique 
Ensemble tout devient possible, le changement c'est maintenant , en marche vers un nouvel horizon đ€đłđ";8177;39;146;6650;15012
BlogueursAlsace;Blogueurs Alsace;Blogueurs professionnels spécialistes de la création de contenus, de la stratégie #socialmedia et #marketing et dans la diffusion #vidéo en direct en #Alsace;7131;548;4829;2492;15000
ousmane_diagana;Ousmane Diagana;Vice President, Western & Central Africa @WorldBankAfrica @BM_Afrique | #PeopleFirst #AfricaACTs #LAfriqueAgit;2274;983;8315;3409;14981
AbouShaar_Abyad;أبُو الشّعْر الَأبْيَض🇷🇴;;7026;70;1711;6173;14980
LoetscherV;Neety - Vay;;2128;199;38;12614;14979
IESEGResearch;IÉSEG Research;"🇫🇷/🇬🇧 @IESEG #research Twitter account
Tweet with #IESEGresearch #CSR #Sustainability #IA #BigData #Ethics #Finance #Marketing #Management #Entrepreneurship";7086;816;947;6128;14977
drakken7384;🇨🇵🇮🇹🏴󠁧󠁢󠁥󠁮󠁧󠁿🏴󠁧󠁢󠁷󠁬󠁳󠁿🇳🇴🇩🇰;les français sont morts en 14-18, la France en juin 40 et l'Europe lors de la crise de SUEZ en 1956...;5481;425;206;8865;14977
flotouchard;Floriantouchard;;4675;2010;767;7523;14975
marchal_o;Olivier Marchal;La vie est courte, mais elle est large !                        @BainCompanyFR @ConseilSyntec @espebanlieues @ODDO_BHF @Positiveplanet_;5740;1089;1930;6194;14953
yves_ndayy;yves nday;IR en environnement pétrolier : suivi des PGES, MGP, évaluation CGES, EIES, PAR, PHSS, Audits environnementaux, gestionnaire immobilier commercial;1505;1538;1508;10398;14949
MwamiAfrica;MWAMI AFRICA;Maison Conseils d’achat, Supply Chain , Fabricant et Think-Tank! (Apolitique). Importateur , Distributeur et logistique.;990;3927;7429;2602;14948
KiusSuik;Kius Suik;Oui;14461;48;36;401;14946
ChloeJayneAdams;Chloe Adams;British Consul General Montreal, Consule générale du Royaume-Uni à Montréal 🇬🇧 Representing the UK in Quebec⚜️Loves: 🎶 📚 🥾 🌲 ⛰ 🛶 🚴🧘‍♀️@UKinCanada;1439;785;1013;11705;14942
Jotre10;Jotre10;Contre la bêtise et l'ignorance.;2202;83;46;12604;14935
EzequielBarada;Ezequiel;Le socialisme a toujours été une idéologie confortable, elle crée l'illusion que l'être humain n'a pas besoin d'assumer la responsabilité de ses propres actes;11972;227;161;2566;14926
_UgoSansH_;Ugoऽanऽは🌙;鳥のように自由🍃Homme à part entière et tout à fait à part💫CPE👨‍🏫Explorateur du monde🌍Éducateur équitable🌅Optimiste🌠Marcheur de rêve✨Déclencheur de potentiel 🎇;4240;1171;77;9428;14916
prixdupetrole;Prix du Baril;"ūüõĘÔłŹLes prix du baril en temps r√©el, l'actualit√© du p√©trole dans le monde.
#p√©trole #√©nergie #p√©troli√®res #opep #carburant #essence #fioul #brent #wti";11450;318;2767;381;14916
Francis93541695;Francis D;;6018;289;71;8534;14912
NeodiaFr;Neodia;"⚡️ Toute l'actualité en temps réel.
Retrouvez-nous sur Telegram t.me/neodia !";3899;1;11007;5;14912
ym270;Yo L'abeille;"Garder le Cap contre Vent & Marées🇩🇿

Pour une Algérie Libre et forte Économiquement. Une Algérie ou la Justice n'est pas suspendue à un téléphone.";10121;668;221;3900;14910
lauraaasnt;๐ฟ๐ถ๐๐๐ถ โก;je pense que je pense trop;5595;154;548;8579;14876
stevenmackinnon;Steven MacKinnon;Fier Gatinois et député de Gatineau. Whip en chef du gouvernement 🇨🇦 Proud Gatinois and Member of Parliament for Gatineau. Chief Government Whip 🇨🇦;6432;1917;5481;1046;14876
Iauradee;Laura Dee;;9798;452;93;4533;14876
yacineferguson;Yacine Ferguson;"Le Football en Personne ⚽️🏆                             
Recruteur IDF @vafc / Animateur VériTalk @taIkfoot / Spécialiste Musique @generations";6557;987;2444;4888;14876
matthieublaise;Matthieu Blaise;Radio producer, team manager in Paris and digital lover. I enjoy chocolate too. Start a talk;8691;884;496;4803;14874
AltusDun;Julien K ðªðºðºð¦;AthÃ©e, rationaliste et universaliste;7248;746;255;6612;14861
FredericChp;Fred Chp;🇫🇷🇧🇷🇪🇺🌻🤝🌍☢️ | Écologie | Énergie | Politique | Bénévole @Les_shifters | Étudiant 1ère promo @EcoleEngagement | Alternant dans l’énergie I YOLO I;3515;437;418;10490;14860
kgall75;Shearer;;11149;43;56;3602;14850
Fr_Grunewald;Francois Grunewald;"Directeur ""Veille et Prospectives"" - Director for ""Anticipation and Foresight @GroupeURD Les tweets sont mon opinion personnelle et n'engagent pas le Groupe URD";9942;2253;2361;288;14844
CanadaOSC;Canada’s Ocean Supercluster;Changing the way ocean business is done. Growing Canada’s ocean economy in a digital, sustainable and inclusive way.;2836;1870;4673;5457;14836
RotondeSciences;La Rotonde;"Centre de culture scientifique, technique & industrielle @Mines_StEtienne #CSTI
ð#expositions Ã  #Soucoupe, #ateliers Ã  #Explora
#sciences #soyonscurieux";6784;701;2894;4444;14823
SGPI_avenir;Secrétariat général pour l’investissement;Préparer l’avenir en investissant dans la recherche & l’innovation - #France2030 - @gouvernementFR;2508;726;10010;1576;14820
enedis_npdc;Enedis en Nord-Pas de Calais;"@Enedis - Départements 59 (#Nord) et 62 (#PasdeCalais)
#ServicePublic #TransitionEcologique 
Gestionnaire du réseau public de distribution d’électricité";6381;1255;3681;3499;14816
Blak2Archangel;Dragon Ultra Instinct;;8165;981;601;5066;14813
Foulques44;Foulques Chombart de Lauwe;Conseiller municipal de #Nantes | Pdt Commission des Finances | entrepreneur | adhérent @lesrepublicains et @Nouv_Energie;2366;3539;2836;6054;14795
Glubrun;Godson Lubrun;Avocat / Msc Dévelopement/ Master2 enManagement des Médias ESJ Lille-Communicateur Social / Journaliste/Professionnel en Tourisme / TV-RADIO PERSONNALITE;7695;1330;2040;3717;14782
StanislasPrche1;Stanski đšđ”;;3183;148;31;11410;14772
_amydala;mimi;citadine bourgeoise qui vient de la campagne et étudiante en situation précaire;9816;63;64;4816;14759
carlistjc;carlist;;9003;712;382;4631;14728
KaciHouas;houas kaci;;11432;69;37;3185;14723
ElasticPlastic9;Elastic Plastic;"Humain.

2022 :  je suis maintenant un défenseur du 'ne jamais faire confiance au gouvernement '

18 avril 2023:  Encore plus clair.";5249;229;104;9130;14712
eustachel;Eustache;;739;73;82;13802;14696
FrancaiseGroup;La Française;"Asset Manager à dimension mondiale : #ValeursMobilieres #Immobilier -
Mentions légales : lfgrou.pe/6Ss7K4";5013;1283;5152;3239;14687
Gzfloflo;Flo_GZ;Tout est moral dans les individus, tout est physique dans les masses. Génération Z 🇨🇵;10773;185;136;3592;14686
stefninie;Stéphanie SOARES;#thinktanks @udi_off /Conseillère municipale déléguée à la #transitionénergétique et aux subventions @VilleCourbevoie / Conseillère territoriale @EPT_POLD;3129;3069;2088;6392;14678
SuperRareNarko;Toutoune89;⚽ SoRare manager - Crypto enthusiast & dev 💻;7688;125;889;5966;14668
david_mawena;David Mawena;Chaque génération dans une relative opacité doit découvrir sa mission, soit l’accomplir soit la trahir *Frantz fanon* Panafricain très convaincu ! 🇲🇱🌍🇧🇯;4603;525;1667;7867;14662
GouttegataS;SamSam;"Fabriqué en France. 🇫🇷

₿itcoin whole coiner 💪

UOS/WAS/MATIC believer 🔥";3544;137;138;10827;14646
ElodieVercken;Elodie Vercken;Chercheuse. Ecologiste. FĂ©ministe. En lutte contre toutes les violences đ„. Pop dynamics, invasion biology, biocontrol. @ElodieVercken@fediscience.org;2309;501;736;11088;14634
ellisphere;Ellisphere;Ellisphere est la référence française en matière d’information sur les entreprises du monde entier. #compliance #risk #datamarketing #IA #data #RSE;10419;504;2388;1312;14623
chedhmann;chedhmann;J'ai servi la France et j'en suis fier. tant pis pour les imbéciles qui n'arrêtent pas de la dénigrer.;6145;96;63;8298;14602
l_insolent32;SHOOD SZN 🔌;🦋⛈**+_!;6299;199;259;7844;14601
USEmbassyBrazza;US Embassy Congo-B;The U.S. Embassy in Brazzaville is the official representative of the U.S. government in the Republic of the Congo.;2015;199;12251;129;14594
villecolmar;Ville de Colmar;Compte Twitter officiel de la ville de #Colmar. Actus, événements... Retrouvez-nous sur Facebook @villedecolmar, Instagram @colmar_officiel et Linkedin #colmar;4483;648;6098;3347;14576
Maximiliendarr;Amish4ever;Connais toi, toi même avant de connaître les autres !!!😀😈🤣 pourfendeur des suprémacistes;7802;171;72;6524;14569
DruIDeavide;David;Le changement, vous préférez le choisir en douceur ou le subir brutalement ? Allons moins vite, vivons mieux. 🌻🌍🚲;7366;2240;995;3966;14567
Mokres3;Mokres;;2303;68;45;12150;14566
bernard_gerin;bernard gerin;;10141;42;67;4315;14565
HyongaG;Hyonga Gaya;"C'est l'heure des retours de BOUMERANGS......!!!!
Chacun en fonction de ses actions..
CA VA PIQUER SÉVÈRE";5361;847;390;7962;14560
ContactEnt972;Contact-Entreprises;"Promouvoir l'image des entreprises.
#Communiquer #Connecter #Contribuer";6535;1028;5792;1199;14554
rococo321;rococo;aha;1257;1029;109;12152;14547
connarddevegan;Vivien;Tweets chaotiques et photos en slip.;3512;569;865;9601;14547
jmjoannes;Jean-Marc Joannès;Docteur en droit  - Rédacteur en chef achatpublic.info;9320;455;2107;2659;14541
laurentgerault;Laurent Gerault;#Angers #PdL- Action locale- Engagé - #TransitionEcologique #Climat ex CR PdL et CM Angers - « Il n’y a richesse ni Force, que d’hommes»;6955;1044;2735;3802;14536
MedefPDL;Mouvement des Entreprises de France #Paysdelaloire;« Fédérer pour agir et partager » Le Medef PDL = 6 Medef territoriaux et 13 organisations professionnelles soit + de 18000 entreprises. Président : @Samueltual;8679;1149;2070;2634;14532
chinemagazine;ChineMagazine;Chine-Magazine.Com propose chaque jour de l'actualité sur la Chine aux francophones du monde;11820;864;1400;444;14528
max_ptt20;MP2 (Paul Quetsches);Ingé, transports et mobilité 🚲🚌🚋🚇;2249;425;64;11786;14524
guedwig;Guedwig Bernier;Adore la politique. Président de Projet Montréal. Milite pour une plus grande intégration des citoyen.nes ayant une diversité de parcours dans notre société.;2877;956;761;9924;14518
lvffyy_;mvrinette 🐞;저는 9개 국어를 구사합니다 . الله only;13715;105;121;575;14516
scopalto;scopalto;"Revues d'Art, Magazines Culturels et Fanzines Créatifs
#pressenumérique #kiosquenumérique #presse";13513;151;676;172;14512
JC_Exether;Exether;Citoyen concerné, ingénieur.;3406;116;29;10948;14499
TLConseil;Thomas Legrain, Directeur général;Directeur général Compétences et Développement, réseau d'#écoles 🇫🇷 🌎 #sport #pédagogie #encouragement #valeurs #accompagnement - Fondateur Club de l'Audace;7837;1715;1683;3263;14498
traductionauto;Traduction automatique;Le fond politique de la discussion est tellement couvert d'ordures que je n'envie pas l'historien qui plus tard voudra creuser jusque la racine des choses;2414;70;51;11938;14473
dpignot;Dominique  Pignot;Économie, finance, #assetmanagement #socialmedia, Éducation , #Afrique, #Inde, #asie #energierenouvelable, #eolienne, cinéma;9335;634;1251;3252;14472
yberezaie;Yannick BEREZAIE ð;CEO @ISODOM Conseil en #TransfoNum #GreenTech #QVT #RSE #LaRÃ©union #Maurice #Lyon #MontrÃ©al DR @numeum_ @MEDEFReunion VP @Digital_Reunion VP @ClusterGREEN;7233;1124;2035;4052;14444
LaVieEnWeb;Manuel Pardo;;3825;381;69;10164;14439
Valzen10;Valzen LAL 🟡🟣;"Je stream, lien de ma chaîne Twitch : twitch.tv/valzzen?sr=a.                
Plus grand fan des Lakers";5280;213;86;8858;14437
sylvainbl1;Sylvain Blomer;;5467;165;67;8731;14430
eddyfougier;Eddy Fougier;Expert-Consultant, Chargé d'enseignement @Sciences_Po_Aix @audencia @uvsq @ISFJ_Paris, Conférencier, Fondateur de L'Observatoire du positif - @feelgood2021;5971;1670;2997;3791;14429
blu3plant;plantebleue;"plante de couleur bleu
arrosez moi 2-3 fois par jour";3684;268;22;10455;14429
Thomas_Anais_;Anaïs Thomas Ⓜ️;"Conseillère Régionale de Normandie & Conseillère municipale Rassemblement National à Port Jérôme-sur-Seine,
Seine Maritime.";5792;126;772;7725;14415
Tobeliv;Tobelive is back;La vie est comme une boîte de chocolat, c'est meilleur avec un peu d'alcool.;13062;109;65;1176;14412
sarah_tanzilli;Sarah Tanzilli;Députée @Renaissance de la 13ème circonscription du Rhône • Commission des lois • Humaniste, progressiste, réformiste;1601;2799;4374;5637;14411
CreteilS;Generation.s Créteil;Compte officiel du mouvement Génération.s - CRÉTÉIL #PrintempsEuropeen #ViveLEuropeLibre #AvecBenoitHamon;8879;183;146;5195;14403
berarddemalavas;Luc Bérard de Malavas;"Citoyen engagé (ancien Conseiller général et président groupe PS-EELV du CG 92).
Aux côtés des représentants du personnel #CSE - @cabinetSecafi
(tweets persos)";3361;692;1099;9251;14403
Maxime_Villa;Maxime Villa;"Professeur des écoles - Adjoint au Maire #Sedan Culture, Sport, Associations, Animations            
Élu Ardenne Métropole 
#culture #sport #nature";8076;624;1230;4472;14402
hakim2400;hak;;7932;308;146;6010;14396
fr_1960;Frederic Moret ðºð¦;MEng, PhD Physics, worldwide CTO, COO, CEO in energy, aerospace & automotive. Senior expert, speaker. Opinions are my own.;7153;232;1209;5794;14388
maniacgeek;Maniac Geek;Compte officiel du site Maniacgeek.net;14353;1;31;0;14385
YBarille;Yves Barillé;Helicopters by admiration, Airbus by passion. @AirbusHeli Communications VP. Ex-MBDA. @EM_Dircom member. Tweets are my own and don't commit my company.;5636;615;2471;5660;14382
olivserge;alain;"je suis un homme, libre, non injecté car j'ai fait mon choix. 
Debout après presque 3ans.
Personne ne dictera ma pensée.";4663;298;136;9282;14379
BDF_III;⚜️BDF;« Combattu souvent, battu parfois, abattu jamais. » François-Athanase de Charette de la Contrie;4805;118;1654;7801;14378
SunshineRebel5;Sunshine Rebel;"Libre et capable de penser, analyser, critiquer, comprendre. Un peu complotiste sur les bords ð¤ª
Redpilled and sovereign,conspiracy theorist for othersð«";4735;846;469;8327;14377
MarcelParis2014;Marcel de Paris;Observateur attentif de la vie politique parisienne. Team đČ .;11184;698;363;2119;14364
IPSL_outreach;IPSL đ;8 laboratoires + 2 Ă©q. associĂ©es/1500 personnes/10 sites #Climat #ModĂ©lisation #Observation #Instrumentation #DonnĂ©es #SystĂšmesSolaires;8158;739;3249;2217;14363
ChantrelG;Gaël Chantrel;Citoyen engagé pour la justice sociale | Passionné de politique, de tennis et de football (le vrai ⚽️) 🇨🇦🇫🇷;3746;968;760;8885;14359
lrkcrypto;CryptoLOL 🇨🇵;Crypto✌🚀🌕;1952;168;77;12151;14348
Univ_Orleans;Université d'Orléans;#Blois, #Bourges, #Chartres, #Châteauroux, #Issoudun, #Orléans. Et si la réussite était proche de chez vous ?;4003;643;5817;3876;14339
MouvementSOLIHA;Mouvement SOLIHA;#SOLIHA Solidaires pour l’#habitat, acteur de l'#économie #sociale #solidaire. 1er acteur national associatif de l'habitat privé à vocation sociale;2830;2931;3753;4816;14330
GuillouRachel;Rachel Guillou;"IA-DAASEN du Pas-de-Calais
Experte associée IH2EF

#ValeursdelaRepublique
#climatscolaire
#egaliteFG #education
#culture #littératuretoujours";2048;569;1189;10524;14330
Emesve;Mercedes Sanchezđ±;close follow- up on EU - as viewed from Brussels #climate #EUfuture #commitment #bxlactivist;2819;977;468;10063;14327
Omarou2506;Omar Ismael;Economiste, Bureau du Coordonnateur Résident du système des Nations Unies en Guinée;4128;1722;2856;5607;14313
BenoitSerra;Benoit Serra ðð²â¢ï¸ VCG;Barbare de la route. Les vues exprimÃ©es sont les miennes. RT & Like Ã§a veut dire d'accord avec vos propos #TeamSarcasm @oupsman@social.oupsman.fr sur Mastodon;9985;517;140;3668;14310
edd_acrennes;EDD Académie de Rennes 🌿🌍;Compte twitter de l'Éducation au Développement Durable #EDD de l'académie de @acrennes #E3D #ODD #EcoDelegues #AMER;3703;665;1578;8360;14306
Sou07_;Sou-07;"""La dignité c'est d'avoir un Rêve, un rêve Fort qui vous donne une vision, un monde où vous avez une place."" de Fatima Mernissi";5954;3073;2083;3187;14297
JLDEPRESSE;Journal La Dépresse;Petit Journal coquin pour divertir le p’tit peuple.;6250;892;3934;3195;14271
frederic_sape;SAPE Frédéric;"discuter avec un con c'est l'instruire. Bonapartiste. si vis pacem para bellum.
1er GMS plateau d'Albion. Sicut Aquila 🇨🇵🇨🇵🇨🇵";8021;1069;937;4242;14269
etoile1235813;etoile123581321;;6587;342;61;7278;14268
oibi92;CHEIKH' CONGO ð¥ - TABU LEGACY;"LUTECE FALCO â ï¸ FAXIO **âï¸ PSG 
SpÃ©cialiste Foot 
ðspace @revplusgrand2 go follow.                    
instagram.com/oibi_92/
ð¼ð¯ðâ ðð± 
ð¨ð©ð¬ð¦";8217;354;285;5412;14268
lekri6969;lekri gilles #no certified;nul part  et ailleurs. mais pas là.;9816;230;38;4181;14265
nperchat;Nathalie Perchat;Pointe et clique dans l'#Allier. Collab du groupe PSđč- #CD03 et Collab parlementaire de @yannickmonnet3/@JP_Dufregne - #AN;9909;926;1227;2202;14264
esg_uqam;ESG UQAM;L’École des sciences de la gestion mise sur la combinaison d’esprits uniques et de gestes forts pour changer le cours des affaires. #ESGUQAM;6943;452;4757;2112;14264
muendofirmin;Me. Firmin Muendo _LE PATRIOTE_ð¨ð©âï¸;PÃ¨re d'une Fille, Avocat prÃ¨s la cour, Libre penseur et chercheur. Fan du FC Barcelone â¤ï¸ð;1333;950;1029;10951;14263
antoine_pattyn;Antoine Pattyn ð´ð¦¦â³ðð;"Militant Ã©cologiste - âï¸ du trafic âï¸ et lutte contre les inÃ©galitÃ©s sociales. 
Repenser notre faÃ§on de vivre le Monde et notre rapport au Vivant.";3367;953;326;9608;14254
EchosParisien_M;Les Echos Le Parisien Médias;Régie publicitaire du Groupe Les Echos-Le Parisien : @LesEchos, @le_Parisien, @InvestirFr, @Cdesarts, @radioclassique et @Boursier_com;7787;1468;2345;2650;14250
SERCE_France;SERCE;@SERCE_France regroupe les entreprises de la #TransitionÉnergétique et #numerique. 260 entr. spécialisées #energie - CA France 20 Mds€, 135000 collaborateurs;5550;1158;2047;5492;14247
DaniloV70;Danilo V;"Un italiano in Francia
J'aime le football et... la vie e je n'aime pas les idéologie  !! 
Con l'Italia 🇮🇹 e il Salento sempre nel cuore!💛❤️";12340;55;55;1797;14247
MaudOyonarte;SARMaud;« If I can’t dance, I don’t wanna be part of your revolution » (pas Emma Goldman). La process comm me dit travaillomane persévérante. Team 💚🕊🌈;5529;855;793;7066;14243
veromaillet;Véronique Maillet;"Maire de @Bouchemaine49🇫🇷
 Vice-Pdte @AngersAgglo
conseillère départementale déléguée harcèlement- cyber-harcèlement    collèges @Maine_et_Loire";3995;788;1704;7755;14242
rouleauchantal;Chantal Rouleau;Députée de Pointe-aux-Trembles | Ministre responsable de la Solidarité sociale et de l’Action communautaire;3158;2176;4957;3949;14240
AeconGroupInc;Aecon Group Inc.;Canadian leader in construction and infrastructure development. // Chef de file canadien en construction et en développement des infrastructures.;3975;460;8857;947;14239
laernoes;Julie Laernoes;Députée de la 4e circonscription de Loire-Atlantique 🌈 💚 #Ecologiste #NUPES;2730;1145;7086;3277;14238
DomoSayle;F;Do more - Say Less;6789;83;74;7288;14234
zuffy23;Clo Tom;;5120;151;15;8930;14216
PIERREMAURIN;Pierre Maurin;"đEntrepreneur  - Elu de Paris @GpeChangerParis - 
9e arrondissement #Paris";5257;1395;1309;6254;14215
drfrvnckgreen;Dr. Frvnck Green;MD ⚜️ - Afropreneur - Founder & Managing Director @SvinteHelene, @petit_potager & @ghreencorp - Libra Sprectum Parabellum;8035;145;333;5688;14201
MegereAcariatre;David;je ne suis pas rancuniĂšre mais je garde la liste đ;5891;216;57;8034;14198
IsabelleRauch;Isabelle Rauch;Députée de la Moselle • Présidente de la Commission des Affaires culturelles et de l'Éducation • Conseillère régionale du Grand Est.;2993;1328;3338;6535;14194
JardoZouille;Jardo Zouille;;3719;187;64;10203;14173
eleven_string;noname;Apparemment ennemi numéro un des quotats de Twitter, serviteur perfide des investisseurs.;7766;257;114;6034;14171
Helene_0787;Hélène BOISGARD;"Conseillère Municipale Déléguée (ST-AIGNAN 41) 🇫🇷 |
Ambassadrice touristique du Val de Loire 🏰 | Adhérente et trésorière @Renaissance 41🇪🇺";3178;534;189;10270;14171
TrisGalb;Pujo65;History Student📜/Rugby Player🏉/Bordeaux🍷🇨🇵;10727;258;83;3100;14168
PunisherStef;Punisher ⚡️☠️⚡️;;8956;451;144;4616;14167
ChrisLavaquerie;CHRIS LAVAQUERIE-KLEIN;Autrice d’essais et d'ouvrages documentaires, Conseil en médiation culturelle, Patrimoine, Histoire de l’art, enseignante - @ICOM_france @SGDLauteurs @icom_ceca;1953;2786;792;8628;14159
CIRANOMTL;CIRANO;Centre interuniversitaire de recherche en analyse des organisations. Allier savoir et décision / Knowledge into action - Le CIRANO a fêté 29 ans d'existence !;4509;2483;2789;4378;14159
Les_Canaux;Les Canaux;Les Canaux conseillent, forment et accompagnent les acteurs économiques engagés pour la solidarité et la planète #ESS #SocEnt;4844;767;5294;3243;14148
Lolicus3;Europarabellum;đź‡«đź‡·đź‡Şđź‡şđź‡şđź‡¦ Compte Twitter du blog sur lâ€™actualitĂ© gĂ©opolitique du continent europĂ©en;13831;21;200;95;14147
Ariel87804127;Ariel;Seigneur Jésus Christ;11977;1764;371;33;14145
Conso_Collab;Conso Collab;Le seul compte à suivre pour se tenir informé de ce tsunami qui déferle sur une société de consommation actuelle ,individualiste et dépassée !;12763;86;1276;13;14138
tiborvancutsem;Tibor Van Cutsem;Biologiste de formation, community manager de profession. Team @lbqfr đž;4468;302;601;8765;14136
sockdem;Sandwich Berlin;Be yourself, everyone else is taken.;9772;1090;571;2703;14136
Psy04065762;Psy;;8341;78;21;5695;14135
pascallepetit1;Pascal Lepetit;Nivernais, souverainiste. Auteur d’un roman (Mélodies...) Président du Cercle de Réflexion Nivernais. @CercleNivernais cercle-de-reflexion-nivernai…;5050;1323;1237;6510;14120
laulecoeur;Laurence Lecoeur;Conseil #RSE #UrgenceEcologique & Projets citoyens  Co-référente Génération Écologie 92 Co-fondatrice de l'émission Le Monde à côté;8566;538;559;4456;14119
francois_poitou;FranĂ§ois Poitou đ»;"ingĂ©nieur, contrebassiste, GĂ©nĂ©ration.s Montrouge
co-rĂ©fĂ©rent du comitĂ© thĂ©matique ""Ănergie"" de GĂ©nĂ©ration.s @GsEnergie";6192;940;302;6678;14112
ChCambon;Christian Cambon;Président de la Commission des Affaires étrangères, de la Défense et des Forces armées du @Senat, Sénateur du Val-de-Marne.;1720;1668;5962;4754;14104
arkokabi;Alexandre-Reza Kokabi;Journaliste & rédacteur en chef tournant à @reporterre / 📝 Climat, luttes, justice sociale, sport. « C’est pour ma ville, sauce magic beau gosse » 🥙;4241;912;3543;5403;14099
cordeau_;Hugo Cordeau;"Environmental Economist | Ph.D student at @UofT | Administrateur @equiterre | Boursier @FRQSC. 
Ces opinions sont les miennes.";2764;1471;775;9061;14071
MsangeBleue7;Mésange Bleue;Citoyen du monde.  Ancien travailleur social. Peintre et Scuplteur amateur...;9442;225;130;4270;14067
RenaissanceBNL;Renaissance Benelux;"Compte twitter du parti Renaissance au #Benelux
Rejoignez nous! parti-renaissance.fr";5634;1142;1449;5832;14057
Virgovignon;Virginie Govignon;Prof agrégée Biologie-Géol(Andorre/Fce) ancienne athlète Trail photographie et télépilote drone;6756;428;421;6450;14055
Beaulieu06310;Beaulieu-sur-Mer;Ville de Beaulieu sur Mer đ L'esprit #CotedAzurFrance & #ExploreNiceCotedAzur đ #BeaulieuSurMer;10492;1150;1662;750;14054
007Kuntz;KTZ. Vince;;6216;471;220;7146;14053
biguideck;biguideck;"sceptique par nature.
we need to get rid of all billionnaires. We need to create a limit to personal wealth because if we don't democracy is just an empty word.";13388;174;22;460;14044
AstroCharts5;Astro5;"Gaulliste souverainiste
#UPR";4492;409;185;8949;14035
PatrickGlesener;Patrick Glesener;Ambulancier Urgentiste retraité. Actuellement Chef d'Unité Départementale dans une Association Agréée de Sécurité Civile. Entraîneur en Auto Défense.;6776;2230;972;4056;14034
SarahToumi;Sarah Toumi;Donor relations officer @GreenWallAfrica #AcceleratorTeam at @UNCCD #GlobalMechanism / Exploratrice d'un monde en mutation & Designer de solutions;1961;1951;4274;5843;14029
MariaLo83180905;Ness 🇩🇿;;4939;225;40;8825;14029
Alexis_IZARD;Alexis Izard;Député de l’Essonne 🇫🇷 • Commissaire aux affaires économiques • #IndustrieVerte 🌱• Administrateur @inafr_officiel;1293;2028;4289;6418;14028
JF_Trucchi;Jean-François Trucchi;Prof_Biotechnologies #lycéeMarieCurie @marseille @univamu #voietechno #formation #enseignants #CAFFA #servicepublic #éduc #santé #environnement #MOTCHUS #teamOM;2237;931;391;10466;14025
MARCHALJacques3;Actio4Marchal;""" La Net Com est avant tout affaire de Stratégie et de Méthode """;4605;847;168;8397;14017
TWLorz;Desperated french;Point de vu franc et sans filtre avec une touche d’humour et de second degré, ici vous trouverez de quoi oublier les horreurs qui défilent sur le fil d’actu;3275;4734;5609;399;14017
FiesingerEcobiz;FrancisBiz;Expertise tourisme  montagne, knowledge management, curation, veille, intelligence collective, prospective, études, conseils, animations...;10945;1896;976;200;14017
etats_sauvages;ETATS SAUVAGES;Préservation de la biodiversité, sensibilisation et éducation à l'environnement - Partage des connaissances autour des écosystèmes 🌿 Membre #1%ForThePlanet;4867;343;614;8188;14012
MoseMirevo1;Moïse Mirevo;Cellule de communication UNC N_K;7307;904;1343;4456;14010
FR_Slonner_v2;FR_Slonner;"Libertarien repenti.

Souvent avocat du diable, commis d'office.

Militant pour la remise en cause des croyances.

De bonne foi, apparemment trop franc...";8269;572;429;4731;14001
SylvainAllemand;Sylvain Allemand;Journaliste, essayiste - secrétaire général de l'Association des Amis de Pontigny Cerisy. Intérêt pour l'innovation, le DD, IA & territoires;4515;1280;1771;6431;13997
wolf312433;Wolf;;6666;152;41;7137;13996
ShoyaWest;$HoYa;Dream Seller / Artist Of Life {Producer / Manager} Instagram: Shoya_west;11419;255;454;1864;13992
PortMTL;Port de Montréal;#PortMTL Plateforme de commerce mondial, moteur économique régional. / Global trade platform, regional economic engine.;5482;469;3807;4233;13991
jeanmic05727814;Jean-Michel C.;;2933;314;50;10690;13987
EMonraisse;Estelle Monraisse;Directrice Alter'Com Conseil #RP #Omie_fr #XAnge #Ledger #Rosaly, #Jolimoi, #Algosup, ex PriceMinister/Rakuten... #startup #innovation;5558;1360;1407;5649;13974
Rudboy83;rudboy 83;"ultras style 

#Om
#Knicksfan #KnicksNation
#RaidersNation";5873;217;58;7825;13973
DenisCousineau;Denis Cousineau;Enseignant, formateur DELF-DALF, FLS.;10883;346;1531;1182;13942
Bdelor1054;Bernard Delor;Biologiste créateur de la biosophie (Fusion de la biologie avec la philosophie);13416;123;217;182;13938
XcentY;Xcent Centy;;13547;61;62;267;13937
Kon_Fuzon;Kon Fuzon;Patriote #Pionnier #Reconquete #jambonbeurre;3054;1644;1039;8195;13932
MyTransitParis;MyTransit Paris;Actualités des transports de Paris: #RATP #RER #Transilien #SNCF #Paris;13576;140;125;71;13912
valparisis;Val Parisis Agglo;Compte officiel de la Communauté d'agglomération Val Parisis (95), 284 369 habitants, 15 communes / Facebook : @ValParisisAgglo Instagram : #valparisis;7850;204;1351;4506;13911
ig_____________;ꜞg;"j'aime souvent les sites en free․fr
    ●     PP par Léon Spilliaert
        
« cette meuf a des cheveux »";5952;208;97;7653;13910
MathieuViviani;Mathieu Viviani;Journaliste ð @LesEchos | Un regard passionnÃ© du rÃ©el quotidien | Mes sujets : #Ãconomie #Ecologie #Droitshumains #XXIsiÃ¨cle | Sk8 for Life ð¹;5006;2716;1335;4845;13902
KyngKhroma;โธธ ๐๐ฒ๐ง๐  ๐๐ก๐ซ๐จ๐ฆ๐ โง;Content creation account of Dum B. Khroma. Vocalist of Cries of Blood, WrPole, Mutilated Crow, and Devour the Rich. Streamer, YouTuber, and Blogger.;5122;853;248;7678;13901
JTLeveille_LP;Jean-Thomas Léveillé;"reporter environnemental à La Presse
514-285-7000 #4871 • jleveille@lapresse.ca";3871;3760;6199;55;13885
J2Christophe;Ignatius;;1469;845;93;11466;13873
bpetitjean;Baptiste Petitjean;"Conseiller au @HCP_Le_Plan #industrie #agriculture #énergie #prospective #planification #CNR. Directeur @fondarespublica de 2010 à 2020 (@chevenement).
#Belfort";9366;1862;1774;871;13873
Ortofon76;Ortofon;;8839;149;46;4837;13871
mali_invest;MALI INVEST;Promouvoir l‚Äôentreprenariat au Mali ūüá≤ūüáĪFollow @dixneufsoixante;411;5773;7247;437;13868
NiceMatinEco;Nice_Matin Eco;Le compte Twitter du service Economie du groupe @Nice_Matin. Animé par Karine Wenger, Agnès Farrugia et Marie-Cécile Bérenger.;7293;889;4334;1351;13867
Pm11946594;Pm;;11660;257;139;1807;13863
Gendarmerie_091;Gendarmerie de l'Essonne;Compte officiel de la Gendarmerie de l'Essonne. En cas d'urgence, đ±17 ou 112;3134;284;7277;3147;13842
LAutreCentre;L'Autre Centre (2654) ðÂ³;Opposition du Centre contre l'exercice Macronien du pouvoir #Humanisme #RÃ©publique #ÃtatDeDroit;10237;147;75;3372;13831
BergeFrederic;Frédéric Bergé;Journaliste , ex-BFMTV.com et ex-BFMBUSINESS.com;10875;758;1854;343;13830
Chris_Bouillon;Christophe Bouillon;"▪︎Président @PetitesVilles @laFHFnormandie
▪︎Maire de Barentin
▪︎Conseiller Départemental du Canton de #Barentin 

contact@christophebouillon.fr";2776;1407;7202;2437;13822
cmoilebaptman;SaliBapt;HeatNation mais je défends Dame Dolla comme si c’était mon daron. (COYG & Téfécé également) Prince Wilo Salibard Fan Acc.;5857;451;53;7452;13813
TheBeerLantern;The Beer Lantern le terroriste intellectuel 🍺🍻;"In brightest day, in darkest night, 
No Pub shall quench my thirst,
let those who fear alcohol's  might,
Beware my power...Beer Lantern's light!";8200;1379;1036;3195;13810
PariaSans;Paria sans portefeuille;« Si vous voulez aider la planète, plantez un arbre. Si vous voulez la sauver, plantez un riche » - François Avard #PaysQc #ÀBasLeNéolibéralisme #LibérezAssange;6540;141;87;7042;13810
MadCapitaliste;W. Falcon;;12297;124;64;1300;13785
emeline_owen;Emeline;"Couloir clair-obscur,
Être ou rêver d'être,
Se survivre ou naître.
Paul Éluard. 

Amoureuse de la Liberté et de la Vérité.";2908;325;108;10437;13778
jccm_mtl;Jeune Chambre de commerce de Montréal;La Jeune Chambre de commerce de Montréal (JCCM) a pour mission d'accélérer le développement de la relève d'affaires. Devenez membre!  #jccmmtl;2506;1970;7059;2241;13776
P1erreLagrange;pierre lagrange;science studies, history of debates on sciences & pseudosciences, for a symmetrical study of human and non humans, @ProjetCrank, @pierrelagrange@mamot.fr;3249;1357;156;9012;13774
SylvainTekris;Tekris Sylvain;;5571;535;84;7582;13772
danelgeorges;danel georges;Development Economist.;6173;1364;1456;4779;13772
ThymRomarin;thymetromarin;;6351;282;130;7002;13765
IMTMinesAlbi;IMT Mines Albi;Grande école d'ingénieurs @IMTFrance, membre de @Univ_Toulouse et certifiée ISO 9001:2015;7825;557;2943;2439;13764
PDriout;Pierre Driout;;13606;76;68;9;13759
ArnaudZacharie;Arnaud Zacharie;Secrétaire général du Centre National de Coopération au Développement, Docteur en Sciences Politiques et Sociales ULB et ULG;4430;182;3550;5584;13746
Hguillaumeb;Hugo Guillaume;"Membre du Parlement de @generationsmvt
#NUPES #Unitaires #Ecosocialiste #Décroissance
| Mes tweets n'engagent que moi";713;1261;746;11005;13725
Noia_spl;Noïa;"🇨🇵🇪🇺
Splatoon 3 Player";5023;53;153;8494;13723
adamsjunior95;kokari jr馃嚦馃嚜;juriste en formation|droit public|timide |villageois |football |R茅al Madrid;6100;686;624;6312;13722
melggo;Mélanie Goffi;#projet #transition #management #FPT - formatrice #CNFPT - garante #concertation #démocratie #CNDP, Militante & Féministe , Docteur en sciences économiques;6410;1489;800;5017;13716
A_Masson06;Alexandra Masson;Députée des Alpes-Maritimes | #Circo0604 | Conseillère régionale @RN_PACA | Membre du Bureau National et Porte-parole du @RNational_Off | Avocate;2880;999;8766;1065;13710
leonard_lukengu;Leonard Lukengu;Homme normal. Je m’abonne à tout celui ou celle qui s’abonne à moi.;3045;566;171;9920;13702
LeaBouchoucha;LÃ©a Bouchouchağ¬;Journalist /NYU Alu/Early bird /FactsMatter/Tweets not necessarily the opinion of my employer/Keep a churchill quote : Never, never give up/Dare to be different;10470;1212;476;1536;13694
patweetone;Patrick Remot;#DirecteurJuridique #Conformité #Legal #Compliance @ClearChannelFr #BoardMember ex @bouyguestelecom #OOH #DOOH #Electro #Jazz et bien d'autres choses...;12911;408;370;4;13693
felix_nga;Jean Félix Mwema;Founder and Executive Director of Buswe Institute. Initiator of Community Service Day CSD. Yali2015 Public Management, Howard University. MPG2014, IPLG.;1194;3622;3739;5126;13681
danielfr40;Danielfr40;"Je suis pour discuter idées, politique.
Je suis passé de gauche à droite. plutôt europeiste.";13054;100;63;459;13676
PharelKesner;Kesner Pharel;Master Pub Adm Harvard University Kennedy School of Government - BA in Economics, BA in Political Science George Washington Univ. - MA Admin. sportive à Un.Lyon;1376;1071;11122;83;13652
frederic_lajoux;Frederic Lajoux;Directeur Territorial @Enedis mes (re)tweets n’engagent que moi;3224;858;858;8707;13647
Almousta92;Moustapha Moussa🇳🇪🇳🇪🇳🇪;juriste environnementaliste...;211;333;113;12988;13645
cans_laure;๐ธ๐๐๐๐-๐ท๐๐๐๐ ๐ฎ๐๐๐ ๐ฆ;Lโavantage quโont les dรฉmolisseurs de civilisation sur les bรขtisseurs, cโest que dans leur domaine dโaction, la connerie nโest pas un handicap mais un avantage.;4861;289;220;8267;13637
MCDP;Musée canadien pour les droits de la personne;Le MCDP est le premier musée exclusivement consacré à l’évolution des droits de la personne, à leur avenir et à leur célébration. In English: @CMHR_News;9411;526;1247;2437;13621
BOIS_LANDRY;Bertrand Monthuir;Forestier-chasseur-agriculteur resp. du Domaine du Bois Landry, vitrine vivante de la forêt privée, mosaïque et de la stratégie multifonctionnelle.;6420;1700;540;4956;13616
c46d333ca0554b6;Ed;;2186;870;44;10515;13615
IRVRCIX;⬅️🕊️🕚irrévérencieux;Why Socialism: monthlyreview.org/2009/05/01… Pourquoi le socialisme: revue-progressistes.org/2020…;982;429;25;12175;13611
NebedaySenegal;ð«Nebeday ð±â»ï¸;L'environnement au coeur du dÃ©veloppement. Facebook : bit.ly/2SF9UIQ , Instagram: bit.ly/2weB7ut , LinkedIn: bit.ly/2tUYybk;1980;1702;5940;3989;13611
FroggyKaf;Olivier Devaud ð¶5Gðªðºðºð¦;"mobile network engineering, telco, information technology, computing.
#NoFakeScience
My tweets only represent my personal opinion.
@Froggy@pouet.chapril.org";4025;216;180;9188;13609
Noelherve5;Noel herve;;4079;1995;1404;6129;13607
GreentechInno;Ecolab - Greentech Innovation;l’Ecolab soutient l’écosystème #greentech et facilite le développement de projets #data & #IA pour répondre à l’urgence de transformation écologique 🌍🌱;4613;864;3541;4585;13603
reforestaction;Reforest'Action;@reforestaction is a #BCorp certified company whose mission is to preserve, restore & create (agro)forestry ecosystems around the đ;4588;1257;4785;2972;13602
Hypericine;Hypericine 🇺🇦 🇨🇵;"🌍🐝🎶 #NAFO  - the Truth is not with those who always claim to know it - #100
Note: Drama = I block. Let's focus on support to Ukraine";3191;1921;1833;6646;13591
mint_eco;Mint đ±;Entreprise engagĂ©e pour la planĂšte qui vous accompagne dans la fourniture d'Ă©lectricitĂ©, le solaire et la tĂ©lĂ©phonie mobile đ±đĄđż;4687;659;2034;6199;13579
trucmuc28502451;truc muche;La curiosité est un vilain défaut.;10793;478;50;2217;13538
BucFrancois;de Buc Francois;Douter pour Innover;3376;43;67;10044;13530
ExpertsUQAM;Experts UQAM;Opinions d'experts de l'@UQAM sur des sujets d'actualité parues dans les médias et sur le web. Alimenté automatiquement par fil RSS.;12281;6;1236;6;13529
ACHEDFR;ACHED ð«ð· Heure Equitable & Durable NGO depuis 83;ACHEDFR Association Citoyenne pour une #Heure Equitable & #Durable pour la fin de l'#heuredÃ©tÃ© double pour une #heurelÃ©gale plus proche de l'heure solaire;3966;3034;325;6196;13521
Bible_othecaire;Bible_othecaire 🌍 📖 🕊️ 🇪🇺 🍊;🪔 Bibliothécaire, chrétien, ignatien, époux, papa, européen, explorateur de livres et du Livre, #LaudatoSi #FratelliTutti. Pour une Église sûre et cohérente 🪔;4790;427;622;7678;13517
man_yield;Yieldman;Crypto/FX trader ð;4653;200;6195;2468;13516
Larroude_ph;Larroudé-Tasei;Assistant Professor at Grenoble University and researcher at laboratory LEGI   & Photographer 500px.com/philippelarrou…;6768;566;185;5978;13497
BVR22203674;BVR;"R.I.O.T (Revolt, Initiate, Operate, Transform).
Esprit armé, toujours à la recherche de nouvelles munitions.
#AEC2022, non militant, pragmatique.";9988;582;276;2639;13485
AMORCE;Association AMORCE;Association des collectivités territoriales et des acteurs locaux dans les domaines : #déchets, #énergie, #RéseauxDeChaleur, #eau #assainissement;4735;1162;5621;1959;13477
BusinessCoolFR;Business Cool;BusinessCool est un site dédié aux étudiants en Grande École et aux jeunes actifs. Par l'équipe du site @MajorPrepa !;7848;297;3731;1590;13466
Filoute12;LTL PLC SYLVIE;Ătre moi ! đ€·ââïžđȘđčđ;5181;64;28;8188;13461
NathalieLebas;Nathalie Lebas;Conseillère Régionale Hauts-de-France Présidente de la Commission Enseignement Recherche;3282;4994;2500;2684;13460
AfricaMutandi;Africa Mutandi;Une approche unique pour porter les stratégies inclusives & l’innovation sociétale des acteurs publics, privés & société civile au service des ODDs en Afrique!;7953;2059;1003;2442;13457
pelerins1;evhane;;8908;509;176;3862;13455
TriomphEternel;Yannick BOKA ð;Formateur/Consultant Social Media Marketing â¢ Founder @LKsportif + @SMR_Africa â¢ CinÃ©ma Content Creator;5828;1135;1896;4590;13449
ericdupau;Eric Dupau;Conseiller Municipal Versailles, Délégué Les Républicains de la 1ère circonscription des Yvelines;4505;642;832;7469;13448
GaelLeBris;Gaël;Aviation & civil engineer. Planner. | Vice President at @WSP. @GroupeADP alumnus. | Tweets reflect personal opinion. Following, likes & retweets ≠ endorsements.;3561;316;255;9314;13446
BabyloneHenriIV;BabyloneHenriIV;Ni Soumis, ni Facho;7100;117;29;6195;13441
raphael800lima;raphael800;"Tournament Staff for @IPLesport
Coach League of legends
Ygo player: Fur Hire and CyberTrap enjoyer";6111;1051;166;6105;13433
KaderSoze;🏴‍☠️🇩🇿KADER SOZE🇩🇿🏴‍☠️;"FLN🇩🇿🏴‍☠️ دولة عسكرية
🇩🇿🇩🇿🇩🇿🇩🇿🇩🇿🇩🇿🇩🇿🇩🇿🇩🇿🇩🇿🇩🇿🇩🇿🇩🇿🇩🇿🇩🇿🇩🇿🇩🇿🇩🇿🇩🇿🇩🇿🇩🇿🇩🇿
les vrais algériens se mélange pas";10767;1455;193;1015;13430
ChenkoChristia1;Christian Chenko;;5377;64;43;7943;13427
lapg34150440;LaPresseGalactique;La PRESSE GALACTIQUE a comme objectif la publication quotidienne de  nouvelles concernant le processus fondamental de transformation  individuelle et collective;13083;7;329;3;13422
LucRabouin;Luc Rabouin;Maire du Plateau-Mont-Royal - Membre du comité exécutif responsable du développement économique et commercial, du savoir, de l’innovation et du design;5344;647;3122;4306;13419
Richlafrance1;Richard Lafrance;2 X vaxx étant très reconnaissant envers les non vaxx. Désillusionné depuis cette ''crise'' . Toute l'arnaque se passe au grand jour, sous nos yeux, circulez...;4096;593;362;8364;13415
Alo_is;Aloïs;Ingénie @nextmap_io. Parle souvent des tuyaux de l'internet, des trucs qui passent dedans et d'usines avec plein des ordinateurs.;7555;1823;506;3528;13412
merciermathieu5;Mathieu Mercier;Enseignant au CSS Kamouraska-Rivière-du-Loup / Service national du RÉCIT, domaine de l'univers social. Collaborateur au balado Intention numérique. AQUOPS;2886;955;1143;8428;13412
djibrilballabah;Djibril Balla Bah;"économie politique-géomecanismes
☆Every human being livs like an island, until comes the day he/she cross the burning water. @GB5E8C3F57°2O3RMCRD☆";12750;305;34;321;13410
Interbev_fr;Interbev;"Interprofession #Elevage & #Viande.
La démarche collective responsable de la filière : #PacteSociétal";4802;389;5877;2334;13402
theuncanny255;Faye Ibrah;"Designer Graphic 
Entrepreneur
Propriétaire de la marque de vêtements All is Good Brand (Lépp jàmm Brand)";1711;184;128;11378;13401
alexmenuel;Alexandre Menuel;Si on revient de loin, ce n'est certainement pas pour aller nulle part. #entrepriseamission #egalitedeschances #Bcorp;2854;662;220;9647;13383
Cdefi;CDEFI;Conférence des directeurs des écoles françaises d'#ingénieurs;4097;492;5994;2798;13381
SseaYoyo;yoyo -2.0;đšđź / đ«đ· esprit conscient qui observe / â€ïž // West Ham;11545;496;106;1227;13374
guyp23;guyp23;Guyspeedy23;4174;517;213;8469;13373
GMothron;Georges Mothron;Maire de la ville d'Argenteuil;8161;382;2770;2057;13370
khaldi_chawki;chaouki khaldi 🇩🇿;;7047;279;117;5918;13361
Logan08935581;ZOKOTO Dzromadzi 🇸🇳🇲🇱🇿🇦🇨🇵;Panafricaniste et résolument engagé pour le continent le mieux doté en ressources stratégiques et humaines. Anti impérialiste, nous œuvrons pr l'indépendance !;6486;381;305;6176;13348
pimthe1st;PiM;Acrobate sur pylône, sceptique padawan et procrastinateur professionnel. Et j'aime la SF. Bannière de @MaitreEtTalons;3684;407;25;9231;13347
ArT_mELLE_;ArT-m’Elle;Un jour, pourtant, un jour viendra, couleur d'orange … 🌺🌸🌿🐾;5804;65;175;7296;13340
FabienBougle;Fabien Bouglé;Expert en politique énergétique, auteur de Nucléaire les vérités cachées, 2021 et Eoliennes la face noire de la transition écologique, 2022 Editions du Rocher;3465;84;9061;722;13332
Renaissance_d22;Renaissance Côtes d'Armor #AvecVous;ℹ️Compte officiel ▶️m.facebook.com/partirenaissa…;5881;887;1767;4796;13331
DrKarimCoul;⚕Karim_CooL🤓;"⚕ Pharmacist Biologist Medical.Affairs
from West Africa 🌍 🇨🇮🇲🇱🇧🇫🇸🇳
Interests: Society Politics Sciences Arts&Culture Nature Sport.
🧠🕊️☕";5102;315;179;7734;13330
FI_Argentine;Buenos Aires Insoumise;"Groupe d'action des Insoumis•es d'Argentine
#FranceInsoumise #FI #Argentine #ReseauFDG #UnionPopulaire #Melenchon2022";3132;561;856;8780;13329
gabriel_loketo;Gabriel Loketo;Entrepreneur, Administratif, Politologue, Logisticien Polyvalent, Design Thinker, et Chercheur en Développement économique.;1583;4037;3487;4218;13325
ToastTalkInvest;Toast ð¥ª Investissement;NON, je ne suis pas un grill pain. Je parle d'investissements et d'autres choses plus ou moins intÃ©ressantes MAIS TOUJOURS dans la bonne humeur ! ð;4966;280;877;7199;13322
REVPourLeVivant;REV | Révolution Écologique pour le Vivant;"Révolution Ecologique pour le Vivant, parti politique d'écologie radicale et antispéciste fondé par @CaronAymericoff.
🌍Faire un don : bit.ly/2K9dvfQ";4396;395;5235;3294;13320
Beylli_Dk;Hamit;IL n’y aura qu’un seul champion 🇦🇷 #Qatar2022 et sa été le GOAT;7858;157;697;4607;13319
doubsov;DoubsovJ;;4360;87;61;8808;13316
Ainsi_parlait_;Zarathoustra;;4705;259;249;8092;13305
cartoeolfw;Cartographie de l'éolien en France;"Je propose une cartographie de l'éolien en France issue de la fusion des fichiers des 13 DREAL.
CC BY-NC-SA";4307;541;1002;7450;13300
mocgab;Gabrielle Močilnikar 🇸🇮 ♻️;#LAPOSTE #courrier #Marktg #RSE #Métavers Chemine vers #minimalisme #AdepteDuJeûne #RadixSlovène #MENSA #Féministe #girlpower #NousToutes #NKM #FANdART;9124;1347;2727;86;13284
sayou254;Marie Sayou ðï¸ â¨ð¤ðâ¤ï¸;Juste un Ãªtre humain...;4955;203;256;7863;13277
NSarrabezolles;N Sarrabezolles;De gauche de cœur et de raison | Conseillère départementale Finistère | Première vice-présidente COTER ~ Comité européen des Régions | PS🌹🌱|📸 Mathieu Le Gall;3546;792;3018;5920;13276
EnsembleMtl;Ensemble Montréal;"Parti politique municipal formant l'Opposition officielle à l'hôtel de ville de Montréal. 

#polmtl #polmun #Montréal";4982;1156;4705;2430;13273
CatharsisSoul;the soul, mental, heart, inner peace;☯️ tu ne contraint rien, rien ne te contraint, rien ne te contraint, tu ne contraint rien (nature de l’harmonie sauvage de l’élément « eau », earthly paradise);10434;827;176;1834;13271
Goodkat17643948;Baybars;;6042;42;17;7161;13262
departement41;Département de Loir-et-Cher;Toute l’actualité du Loir-et-Cher #ResolumentLoirEtCher Rejoignez-nous aussi sur Facebook : facebook.com/departement41;5430;243;6580;1008;13261
Balsan61;Je suis la révolution des casseroles;;9431;116;56;3657;13260
calgutyo;calgu;"1er degré sur le réchauffement climatique (qui lui est à +1.2°C) , je me réchauffe sur d'autres sujets plus légers.

Futur ingé en électricité.";2478;332;27;10422;13259
francesco801004;FRANCESCO121;Napoletano. Traduttore. Ogni giorno vissuto in più è un magnifico regalo. Un certain penchant pour les miracles. Acteur de la comédie humaine. Adore tricoter...;12217;37;66;938;13258
BonneDroite;Une Bonne Droite đđ»;"Pas bien rĂ©veillĂ©s ? Prenez vous Une Bonne Droite !

đđ» Le mĂ©dia qui vous remet les idĂ©es en place !
âĄïž Articles, vidĂ©os & vĂȘtements";2236;284;4904;5827;13251
qwevino_0;Kevin;"Energy sector. Mostly energy data & graphs.
Energy Engineer from @EPFL.
Tweets my own.
Dive guide when not working.";2599;1034;401;9212;13246
EssahliAndre;André Essahli;"Mes tweets n’engagent que moi. 
""Le propre de l'homme est de ne pas servir le mensonge"". Camus
Chaque ⅒ de °C compte
Né en 321 ppm.Marathonien.";4999;395;79;7767;13240
GChaussemy;Guillaume Chaussemy;Maire rural • Co-président de l'association nationale des @ElusLFICitoyens • Membre du @ParlementNUPES✌️ • Je stoppe des trains avec @garedargenton;4101;683;3818;4626;13228
Reseau_Envt;Réseau Environnement;Catalyseur de l'économie verte au Québec;3614;928;7032;1648;13222
PSo_ActionAid;ActionAid France;đź“˘ Lutter pour les droits, contre les inĂ©galitĂ©s âśŠ RĂ©gulation des multinationales - Droits des femmes - SouverainetĂ© alimentaire - Climat;6378;1270;3414;2156;13218
AdabellIbarra;Adabell Casillas Ibarra;Educación y Respeto deben ser las bases para reconstruir el país, por un México Unido, basta de división.;2904;5275;4796;232;13207
1984_manue;Brette Emmanuelle;"Je pense que partage est la clé de la solidarité, pour aller vers un monde meilleur, plus juste et plus humain ! 
Bcp de spiritualité , bien-être.....";10668;1793;686;50;13197
ChrisKouebou;Kouebou Christiant;Sciencepreneur & Grassfield Scholar;11174;164;160;1695;13193
essecventures;ESSEC Ventures;ESSEC Business School's student startup incubator;3398;852;6821;2122;13193
Tidiane_Diaoune;Tidiane Cherif;LIBRE PENSEUR 🕊;5543;802;1110;5736;13191
hpritrsky;Hervé PRITRSKY;"Militant politique
Militant engagé pour la laïcité";7978;84;215;4909;13186
Quantalys;Quantalys France Harvest Group;Plus de 77000 #fonds et 531 contrats d'#assurancevie. Suivez les 120 meilleurs fonds flexibles du marché. #BigData #Solutions #Consulting. #FinTech since 2007.;7530;225;3157;2258;13170
VilleVillejuif;Ville de Villejuif;ð Compte officiel | Suivez lâactualitÃ© de la Ville de Villejuif et ceux qui la font vivre : loisirs, dÃ©marches, vie locale, projets...;8558;168;3627;815;13168
alpindansnuages;unalpindanslesnuages;"Contre les pass carbone & vaccinal. La vie n'est pas un QR-code.
Je soutiens RT France & Sputniknews contre la censure UE
#Frexit";3177;415;389;9186;13167
THDGrainoble;Grainoble;Originaire de #TremblaylesVillages engagé vers la sobriété et à la recherche de l'efficience @Nouv_Energie #AgroDiverSanté #ÊvolutionBleue #SemenceNatureBio;2236;346;580;10000;13162
ProtecDesOceans;Protection des Océans;"Site internet :
protectiondesoceans.com
620000 hbts, 18 communes ayant reçu le #LabelProctionDesOceans
Marraine : la Navigatrice #AnneBeaugé 
Pdt @Boudystephane";2299;992;940;8924;13155
squirrel75_;Squirrel75;Je n'aime pas la pensée unique;10306;71;40;2733;13150
KerbratVivien;Vivien Kerbrat;"Grandes Écoles et tralala...

Ici je stock des extraits littéraires, des illustrations d'art, des infos socio-politiques... 

Tu peux squatter si tu veux";1350;552;107;11125;13134
clecorfec;Xtophe LE C0RFEC;"#emojibzh đȘđș
Breton de Roazhon.
Cela ne veut pas dire que ceux que je suis saurons ce que je suis.";3205;91;60;9776;13132
JJTHIRSON;Jean-Jacques THOMAS;Maire d'Hirson & Président de la Communauté de communes des 3 rivières. Président de la Fédération Départementale des Élus Socialistes et Républicains;11205;478;853;595;13131
t_dkp;François ♂ F4JQC / 14FRS971 🇪🇸🇫🇷;14FRS971. F4JQC, (PMR446), Debian Fan, Photo, Nikon, Raspberry, Ubuntu, Amateur-Radio,DMR, Aprs, Radioamateur, Ham radio;9174;279;197;3463;13113
GreenFlex;GreenFlex;"Changeons de trajectoire vers une économie régénérative #ChangeonsdeTrajectoire
#énergie #CO2 #RSE #bâtiment #industrie #agroalimentaire #territoires #retail";6255;344;4692;1820;13111
J_Precision;John Plumier ⚙;"Cartésien et pragmatique (mais je me soigne).
Profite de la vie dès que je le peux.";6186;214;122;6583;13105
Constant_art;Constant;;13014;0;82;3;13099
BaptisteVassOff;Baptiste Vasseur;"""Citoyen engagé depuis mes 15 ans"" - Podcast  lafrancecourageuse.fr - Occitanie et Normandie - Actif pour les #animaux - Idéaliste☀️";5993;998;420;5682;13093
AhmedTaghza;Ahmed TAGHZA;Journaliste responsable rubrique Economie @lecho_fr Centre France;6552;2412;1271;2832;13067
chalumo;Christophe P.;;5339;74;41;7604;13058
FFasterbikerFF;Thierry Dubost;ex-IP attorney (chimie, biologie), histoire, généalogie, politique, bibliophilie. climato-réaliste. Européen depuis le 8e siècle;8725;164;61;4102;13052
lopinion_eco;l'Opinion Économie;Bienvenue au service Économie de l'Opinion. Retrouvez sur cette page toutes les analyses micro et macroéconomiques de nos spécialistes.;12099;75;874;3;13051
VincentKlassen;vincent klassen;Développement durable / Sustainable Development ECCC. Ancien diplomate 🇨🇦 en 🇫🇷 et en 🇩🇪. Former 🇨🇦 diplomat in 🇫🇷 and 🇩🇪. Mes opinions / my views;2410;773;1222;8641;13046
bobdefont;⚜️Jacques Robert de Fontenelle⚜️🇫🇷;#Reconquete resp. circo #5908;2525;3188;1844;5484;13041
FabriceLo;Fabrice;Ecologie. Détermination. Droits humains. L’avenir est à réinventer / Ecology. Determination. Human rights. We need to reinvent our future.;3387;176;113;9364;13040
PrinceAbdel160;Prince Abdel 1 Officielقناة أمير للإعلام الجزائري;Chaine Officiel N° 1 du Prince Abdel /Algerie / قناة أمير للإعلام الجزائري تدافع على القضية الوطنية + منصة جزائرية للأخبار الوطنية والدولية;3391;3941;1186;4515;13033
vanrhijn_syb;Sybille van Rhijn;… living in a highly contested order (spelling and grammar mistakes not unusual);6657;139;15;6213;13024
ThomasGobertier;Thomas Gobertier;"#Entrepreneur passionné !
Speaker @SML_Zhaw & Partner @sothebysrealty - Tweet about #villededemain #realestate #sustainability #bureau #smartcity #Immobilier";12220;1;799;0;13020
caillaudphilip4;caillaud philippe;"Paysan-bio depuis 2000
donc #décroissance heureuse depuis 25 ans
à St marc sur mer
la ferme des Pouls Hauts
Conseillé municipal opposition  #SaintNazaire";2662;254;911;9191;13018
helkohl;Hélène Kohl;"Journaliste / Podcast Host
Le Podkast 🎧⬇️
smartlink.ausha.co/le-podkas…
Pour suivre en français l'actualité de l'Allemagne";5138;394;5893;1584;13009
nbSpencer;Spencer;Développeur fullstack dans l'énergie, je développe des bots/outils dans les cryptos.;4139;1311;186;7364;13000
Anonyme01020304;۞ Anonyme 🦁 Parody ۞;"Parody - Ma kayn ghir maghrib wli 3andou mouchkil yamchi yat7awa malakhar 

🇲🇦🇨🇦

De retour 😈😈";5054;307;216;7422;12999
sondervorst;Chloé Sondervorst;Journaliste et réalisatrice. CBC/Radio-Canada. Gazouillis médias 🎧 TikTok: chloesondervorst;5802;1634;3277;2283;12996
TRAOREB42661479;TRAORE Balla;"Directeur du Cabinet d'études  Eureka Mali- lien : 
fb.me/ceurekamali 
 Ecrivain ( 09  publ- 03 anglais )";7169;33;2118;3673;12993
ChristianMavam1;Christian Mavambu;God first / đ #Ăconomie / #U_Reporter;6321;357;388;5924;12990
DelphineJULIE;Relations-Presse.Net;Conseil en #RP #Édition #Science #Société. Ado, déjà sur mon vélo, je n’ai pas trop changé... #velotaf #mescoursesavelo #alasalledesportavelo #MichelSerres;6708;1133;460;4689;12990
edastarac;Emmanuel Dastarac;Chef d'agence régionale maîtrise d'ouvrage réseau électrique d'@enedis_bretagne;1481;292;396;10818;12987
neilmakaroff;Neil Makaroff;"Directeur de Strategic Perspectives @StrategicEU
Militant pour une Europe du climat ☀️ 

Membre du Board de @transenv. Views are my own.";3337;1436;2891;5313;12977
nicolas_samsoen;Nicolas SAMSOEN;Maire de Massy - Conseiller Départemental de Massy et Chilly-Mazarin              « Life is a tale Told by an idiot, full of sound and fury Signifying nothing »;3657;935;2611;5772;12975
crous_tibat;anti-rance & islamowokisme;;4087;637;345;7905;12974
cplassard;Christophe PLASSARD - Député - Charente Maritime;Député Charente Maritime | @AN_Finances | Rapporteur Budget Défense Nat. | @AN_AfEur | Cons. Muni. Royan | #IHEE SA13 | 🇫🇷🇪🇺 @HorizonsLeParti | Compte perso;2902;1411;1535;7107;12955
BergerieNat;Bergerie nationale;"Établissement public national de l'#EnseignementAgricole sous la tutelle de @Agri_Gouv.
Centre d'enseignement zootechnique #développementdurable #agroécologie.";3332;634;1167;7806;12939
Thupaca_qatr;THUPACA;J'étais européen (mais j'ai voté non en 2005), démocrate républicain. Membre d'aucun parti politique et je  suis épuisé. Macron et sa secte m'ont tué;8349;1405;537;2647;12938
MGILBERT_Maddy;M.GILBERT;Secrétaire Nationale Confédérale CFE-CGC @CFECGC Conseillère @CESERAURA #DéveloppementDurable #TransitionEcologique #RSE #ODD #Environnement #ESG;965;4999;1315;5654;12933
AdLesann;Alain le Sann;;12544;37;264;76;12921
IanBoucard;Ian Boucard đ«đ·;DĂ©putĂ© du Territoire de Belfort / Conseiller DĂ©partemental de Belfort / @lesRepublicains;2387;920;7062;2548;12917
MtcTanja;Tanja ð¦¸ð¼ââï¸ - La Veille de Ma RÃ©ussite;Consultante veille & #reseauxsociaux. Investisseuse immo ayant quittÃ© le salariat, je veille dÃ©sormais sur ton Ã©ducation financiÃ¨re. Newsletter gratos ðð»;4257;771;3199;4689;12916
AerospaceValley;Aerospace Valley;Premier pôle de compétitivité européen en régions @NvelleAquitaine et @Occitanie dans les domaines : #aeronautique, #espace, #drones et #systemesembarques;4701;794;5931;1486;12912
EnergieMatin;Energie Matin;De 07h00 à 12h00, Energie Matin partage les dernières actus sur l’#énergie pour anticiper les impacts de la #TransitionEnergétique sur le consommateur.;9767;1183;1952;8;12910
quandletigrelit;Le Tigre;Félincompris;5617;108;258;6925;12908
FelixLecorre;Felix;Canadien à Londres / Chemicals Banker / Oncle de 15 / Grand-frère de 5 / Papa de 2 / Amoureux d'1 seule et unique / Gourmand assumé / #FelixLeChat 🇨🇦🇫🇷🇬🇧;3791;414;116;8583;12904
SamyNakache;Samy Nakache ð¢;#SocialMedia Manager - CrÃ©dit Agricole Alpes Provence - Je tweete #Marketing #Digital #SocialSelling #Innovation #Content #Influence #IA #RSE #Marseille;7220;1623;935;3118;12896
bbizalion_media;bbizalioncorte;simplement passionnée des médias et de leur économie. Mi bretonne, mi italienne...;1193;518;194;10989;12894
Melhildor;Vinz Robert;"""Quand le gouvernement viole les Droits du peuple, l'insurrection est pour le peuple le plus sacré des Droits et le plus indispensable des devoirs"" (DDHC 1793)";3077;356;95;9357;12885
DeKaricy;Duc de Karicy;"La relation est basée sur la confiance; la confiance est basée sur la relation. Guider au lieu de diriger !  Consultant et entrepreneur; CEO @Atlantickaricy";3813;2325;214;6517;12869
Kroline2405;Caroline LEONZI;Ce compte est PERSONNEL_Responsable Com’ interne @EngieSolutions  _ #voyage #médias #chocolat #mode #EnR #com _ #exCM @ENGIEgroup;4005;1901;578;6379;12863
Gasskari;Guillaume Asskari;Journaliste | Producteur de contenus ð¸ ð±SpÃ©cialiste #LatAm #AmeriqueLatine;3564;3912;3265;2119;12860
53Jeanpaul;Jeanpaul 53;Ex poils à gratter  @jpdmrt1953;11364;86;177;1209;12836
MichaelGuillon;Guillon Michaël;"PhD, écologue, naturaliste #Herpetologist, #Ecophysiology, Cold adapted #Ectotherms & #ClimateChange
#Vacciné #Dys 338ppm 🇺🇦
@MichaelGuillon@ecoevo.social";5054;814;514;6446;12828
HenryM_63;Henry Marc;Aujourd'hui retraité, mais toujours passionné par les sciences, la connaissance de l'univers, les mathématiques, la physique, et la paléontologie.;6933;63;65;5751;12812
CBPE69;Bohly caroline;POLE-EMPLOI #Indemnisation;1858;747;360;9839;12804
U_M_Africa;Universal M Africa;Universal Music Africa is a part of Universal Music Group.;3763;38;7646;1355;12802
PLemenager;Philippe Leménager;Ingénieur d'études en informatique, modérateur sur les forums de Developpez.com et auto-entrepreneur;2634;224;239;9703;12800
domi_1703;Thierry Grugnon - Égérie FHF 2023;"Executive Director des acteurs du territoire🙏

Mascotte officielle de la French Care🦃🇨🇵

Ex-Ministre de la Santé et du Funk

Territoire du Meurmieunois";5560;22;2013;5199;12794
andre_moraux;André Moraux;"Qui vit sans folie n'est pas si sage qu'il croit. 
You can fool all the people some time and some people all the time but not all the people all the time.";1043;290;225;11232;12790
ndonnard29;nonobzh;ð»ðð­â¨ï¸ð¬âï¸ð§¬;2654;200;43;9890;12787
SOGCorg;SOGC;4,300 doctors, nurses, and midwives: The voice of women's health in Canada / 4 300 médecins, infirmières et sages-femmes : Tous voués à la santé des femmes.;5236;419;5753;1372;12780
quebeccongres;CentreCongresQuebec;"Situé au centre-ville de Québec, destination congrès canadienne prisée.
Located in downtown Québec City, Canada prime meeting destination. #QuebecCongres";5205;2073;3951;1549;12778
ENSEIRBMATMECA;ENSEIRB-MATMECA;Ecole d'ingénieur en Informatique, Electronique, Télécommunications, Mathématique et Mécanique de Bordeaux;6361;445;2416;3545;12767
ToutcramerV2;Toutcramer ð³;;7619;262;1278;3599;12758
T_Cazenave;Thomas Cazenave;Député de la 1re circonscription de la #Gironde - Président de la délégation aux #CollTerr - Conseiller municipal et métropolitain de la ville de #Bordeaux;2796;872;6293;2788;12749
EcoAct_FR;EcoAct France;EcoAct accompagne les entreprises et les territoires dans l’atteinte de l’objectif zéro émission nette 🌍;7594;1259;2212;1684;12749
XhiphiasG;XhiphiasGladius;Est une espèce de poisson pélagiques des mers tropicales et tempérées, famille des Xiphiidés, peut dépasser les 2m et 100kg. #Horizons 🇨🇵🇪🇺🇺🇦🇹🇼;6147;406;91;6103;12747
Mourad_DxB;Mourad 🇷🇺;"Si tu lis certains de mes tweets et que t'as l'impression que j'suis un connard alors tu as eu la bonne impression 🤣
-
Consultant (droit routier)";8298;532;403;3514;12747
LoloEscbr;Lolo #ToutCramer Escobar;J’observais juste mais il y a eu un 49.3 de trop et maintenant je milite.;2844;436;357;9098;12735
Rubson28247850;2geZa WiKen;Ph.D Researcher (Central South-University). CEO of SKCON INVESTMENTS GROUP./Exploration Geologist. Extensive experiences with Gold and Rare metals deposits...;2697;1171;248;8592;12708
kreklaoui;REKLAOUI KAMAL;🎓 Directeur d'une école d'ingénieurs | 💡 Innovateur passionné | 🇲🇦 Fier d'être Marocain |  Former les esprits brillants de demain pour un Maroc prospère.;2264;1814;834;7796;12708
Guillau43143811;Guillaume;"Né en 347 ppm de #CO2.
De l'importance d'un #DPE fiable, authentique et opposable.";1304;3807;219;7377;12707
Gloria_Iesum;God eating, God fearing lil' guy;Je suis déifié, parfois. Rarement à vrai dire.;5528;636;243;6296;12703
Arnold_Kle;Arnyð¨ð²ð«ð·;Les vÃ©ritÃ©s sont des illusions dont on a oubliÃ© quâelles le sont. Et ne je rÃ©ponds aux imbÃ©ciles que par du silence. Donc ð¤­. Tu mâinsultes, je te bloque etcâ¦;7049;158;46;5449;12702
Rhea24s;Rhea đłïžâđ;"Expert PMU de la NBA pour #FiveByFive / Bulls Fan / Scalabrine die hard fan / đłâđ

Trolle les cons / les cuistres / les jean-foutre et les hypocrites.";6176;242;52;6230;12700
LILLIADlci;LILLIAD;Lieu pour la culture de l'innovation, ouvert depuis le 7 septembre 2016  @univ_lille #Ulille;6879;437;2776;2581;12673
AdriendeVlt;Adrien Vlt;Journaliste à @LCP, chargé de développement numérique. Newsletter, podcasts. Ancien programmateur. Énergie, économie, Ovalie 🏉;3543;3625;815;4686;12669
DRUART_F;DRUART Frédéric;"Adjoint au Maire au Logement, Politique de l'habitat
Adjoint de quartier Choisy Nord";1297;53;100;11213;12663
LeBourricot;Le Bourricot;"L'âne catalan, rien ne lui échappe !
Tout de suite dans vos favoris !";8585;1729;2346;0;12660
KervranV;kervran valérie;;6545;83;71;5960;12659
EricKopi;๐๐ซ๐ข๐ ๐๐๐๐ ๐๐จ๐ฉ๐ข๐ฆ๐๐ง๐ญ๐ฬ;Entrepreneur |รcrivain| Passionnรฉ de la Physique quantique;2774;2823;3034;4021;12652
Kylian_Meuniier;Kylian Meunier;;3231;369;517;8522;12639
EngageFor;ENGAGE;Mobiliser les citoyens et les organisations dans les grands défis environnementaux et sociaux. #connaissance #action #transformation #impact;5357;1637;2110;3530;12634
ville_chaville;Ville de Chaville;Compte officiel de la Ville de #Chaville;8686;265;1073;2609;12633
LeLiveToussaint;Le Live Toussaint;Bruce Toussaint est aux commandes du Live Toussaint de 9h à midi sur @BFMTV.;9218;7;3400;3;12628
Doms_Group;FANHO KOFI SAMUEL MAWUTO;Juriste .Sciences Politiques , Juridiques et de l’administration. Sciences Juridiques DROIT PRIVÉ. Athlète à FTC . 𝗣𝗨𝗧 𝗚𝗢𝗗 𝗙𝗜𝗥𝗦𝗧 █║▌│█│█║▌█║▌██║▌│█│;2849;2780;3041;3957;12627
jmgottermaster;Ju M-G đŸđ§đ±Ï;Julien, vegan/atheist/musicophile/photographe et papa-loutre x 3 âCe qui vient au monde pour ne rien troubler ne mĂ©rite ni Ă©gards ni patienceâ RenĂ© Char;2970;1616;758;7280;12624
Echos_Parisien;Les Echos-Le Parisien Communication;Toute l'actualité du Groupe : @LesEchos, @le_Parisien, @InvestirFr, @boursier_com, @CapitalFinance, @radioclassique, @mezzo_tv, @medicitv, @euroarts, @cdesarts;4424;1595;4263;2342;12624
UMCS_Umoncton;UMoncton - Shippagan;L'Université de Moncton, campus de Shippagan , est le pôle régional de l’Université de Moncton dans le nord-est du Nouveau-Brunswick.;9491;1174;1908;44;12617
Thierry_Caillon;Thierry Caillon;"#NoFakeScience,  #Energies #bascarbone, #nucléaire, #hydroélectricité, #MobiliteElectrique. 
Mes tweets n'engagent que moi.";6409;173;1603;4419;12604
AitMaad18;Aⵣt Mâad ⴷⵣⴰⵢⵔ 🇩🇿 الجزائر 🌍ⵣ🇵🇸🇨🇵;"La connais­sance donne le pou­voir mais la force de ca­rac­tère en­traîne le res­pect  
Le savoir et la volonté ne suffisent pas, il faut savoir agir
BruceLEE";6516;195;102;5778;12591
LeChristEst_Roi;Le Christ Roi de l'Univers;Soyez bons les uns envers les autres, compatissants, vous pardonnant réciproquement, comme Dieu vous a pardonné en Christ. (Ephésiens 4, 32);5874;1943;455;4318;12590
coffeequitweet;COFFEE Officiel;"Yo! Je suis le geek derrière la célèbre chaine YouTube COFFEE. Ici vous trouverez toutes les actus concernant #GTAOnline.
#ZLAN2023";1218;27;10914;421;12580
De_lege_feranda;Walid Chaiehloudj;Professeur agrégé des Facultés de droit à l’@upvd1  Coresponsable du @CDEDYS - Membre du Collège de l’@ADLC_ au titre de personnalité qualifiée et de l’@ACNC988;1981;1688;1454;7447;12570
Bourbier_Parigo;Ivan Grozny IV 🇨🇲;Garçon sans importance collective, tout juste un individu. Tweets dans un franco-serbe approximatif. Стрејт аута Балкан бреее  🇷🇸🇲🇰;4447;444;158;7514;12563
KarineWenger;Wenger Karine;Journaliste Economie à Nice-Matin;3920;2696;1551;4389;12556
AQOCI;AQOCI;L'AQOCI regroupe plus de 70 organismes québécois de solidarité internationale qui œuvrent, à l’étranger et localement, pour un développement durable et humain.;3472;678;5133;3270;12553
ARuisseaux;Alain Des Ruisseaux;Wine, math and nursing not necessarily in that order...;6372;218;28;5933;12551
AEFsocial_RH;AEFsocial_RH;Compte officiel de la rédaction social RH de l'agence de presse spécialisée AEF info  #emploi #formation #RH #fonctionpublique #protectionsociale;4538;1953;5666;392;12549
AudreyFLavoie;Audrey-Fred Lavoie (she/her);Enjeux urbains et environnementaux à coeur • Hon. BA Political Science & Commerce @mcgillu 🇨🇦 • MPA Urban Innovation @UCLSTEaPP ('23) 🇬🇧 📍from Montréal;1038;3405;934;7164;12541
MarcoMonigaAtos;marco moniga;@Unify Expert on: Unified Communication 4.0 - Social Enterprise Communications - Single Sign On.;11702;145;143;544;12534
NicolasDeux2;démocratie en berne;compte perso : très inquiet pour la planète. en attente d’une prise de conscience de l’urgence climatique. #formateur #numerique mes propos n’engagent que moi;4520;167;177;7658;12522
TiboClaude;Thibault Claude, OUT les Adorateurs de Big PHARMA.;J'ai osé m'opposer à la PLANdémie et aux VAXXS EXPÉRIMENTAUX de MARDE et ça m'a valu de perdre 5 mois dans le sud au CHAUD gracieuseté de Fidel TRUDEAU de MARDE;6730;518;137;5126;12511
WeAreZeRobots;Roland;Liberté Égalité Fraternité, c'est quand même pas compliqué à comprendre bordel !;5130;349;83;6948;12510
Jss_Journal;JSS Journal Spécial des Sociétés;Journal #numérique d'#actualités #juridiques et #judiciaires, habilité à publier en ligne vos #annonces #légales, et prenant en charge vos #formalités #légales;6114;2555;1319;2520;12508
air2rien;Air2rien 🇫🇷 🇩🇲 🏴󠁧󠁢󠁳󠁣󠁴󠁿;"Sauvage !
Pas en phase avec la Roisidence actuelle.

Fucking pangolin !!";4486;757;141;7122;12506
Gunduz__29;𝓖𝓾̈𝓷𝓭𝓾̈𝔃;@❤️💛;1243;102;100;11057;12502
Mailland16;ValMailland;"artiste ecolo 
contre toute forme de domination, d injustice et de médiocrité";4306;333;52;7793;12484
ohhouin;félix;horticulteur-paysartiste;2606;200;241;9423;12470
facts0007;Catherine MORINđșđŠ;Facts Knowledge sharing for humanity progress;5623;107;340;6393;12463
observatoiregeo;Géostratégic indo-pacific;Internationaliste de formation (Droit international et Géopolitique), je tweete sur les problématiques  relatives à l'évolution géostratégique en indo-pacifique;7891;3109;507;944;12451
ollybret;Olivier Bret;curiosité & serendipity #entrepreneur passionate swimmer #transitionbascarbone #transitionécologique #redirectionecologique;6367;608;562;4910;12447
Zzdz12671201Dz;ZZ DZ;;6189;46;40;6172;12447
stefanybuisson;StephanieBuisson;Impossible n’est pas français  🇫🇷 Préparateur mental - Psychologie du sport;2318;1118;608;8397;12441
adriendelacroix;Adrien Delacroix;Maire adjoint #SaintDenis urba-aménagement | Conseiller territorial  #PlaineCommune habitat et foncier | Conseiller régional. #Gauche #Écologie #logement #Hlm;3726;2638;2449;3626;12439
DIMOTRANSGroup;DIMOTRANS Group;Depuis 1980, DIMOTRANS Group s'inscrit comme l'une des #ETI françaises les plus dynamiques du secteur de la #logistique et du #transport #international;8625;381;1124;2305;12435
HautbourgC;hautbourg christophe;Conseiller municipal @villedeputeaux #Puteaux Président du groupe #MajoritéPrésidentielle @EnsemblePuteaux Conseiller territorial @EPT_POLD @92_renaissance;3820;2700;1629;4279;12428
ville_carrieres;Ville de Carrières-sous-Poissy;Compte officiel • Pour suivre l’actualité de la Ville de Carrières-sous-Poissy et du conseil municipal • Maire : @ait_eddie, vice-président @cugpseo;5454;927;2140;3904;12425
TheCityInGames;Tweetcydide;Stratège et historien athénien, né vers 1985 après J.C. Auteur de La Guerre de la Twittosphère;9279;710;108;2328;12425
LaPiraterieBack;Théorème relation entre continuité-dérivabilité 📉;;1636;167;10;10610;12423
UFOLEP;UFOLEP;Union Française des Oeuvres Laïques d'Education Physique (UFOLEP) - 1ère fédération multisports et affinitaire de France - Fédération Sportive de @weblaligue;4822;2555;2633;2408;12418
MUJICASAV;Ali;;5638;554;263;5923;12378
Pressenza_fr;Pressenza francophone;PRESSENZA – Agence internationale de presse:  Humanisme, Nonviolence, Droits humains, Désarmement, Non-discrimination;10359;679;901;434;12373
SMA_Outremer;Le SMA;Le SMA est un dispositif militaire d'insertion socioprofessionnelle au profit des jeunes des Outre-mer.;6479;421;1398;4067;12365
AlainMignault;Alain Mignault;Chercheur indépendant en psychologie et environnement. Éditeur d'Ensemble Accélérons la Transition Énergétique. Co-fondateur de la @choraledupeuple;6087;965;408;4901;12361
IngridNappi;Ingrid NAPPI;Professeur HDR @Ecoledesponts Économiste spécialiste de la #ville #immobilier #logement #architecture #workplace #sustainability #bascarbone #monbureaudedemain;5906;666;3610;2174;12356
Avril;Avril;Acteur industriel et financier des filières des #huiles et #protéines (Lesieur Puget Saipol Oleo100 Oleon Sanders Expur) 🌻👩‍🌾🍃 EN : @Avril_Group;4426;1443;5580;906;12355
inezgusa01;Gustave Ineza (The Mangrove);PhD Student @ St. Mike's College University of Toronto. MTh Oxford. Christian-Muslim Dialogue, Decolonial & subaltern studies (Othered minorities). Rwandan.;7701;618;508;3523;12350
SandraImperiale;Sandra Impériale;Maire de #Bouguenais (44) #NantesMétropole Auditrice IHEDN #AvecMorancais Vice-Présidente Conseil Régional #PaysdelaLoire;4397;1527;1717;4709;12350
FrancElectrique;France Electrique;Passionné de nouvelle Techno... de domotique... des réseaux mobiles... sans oublier Apple, Tesla ! piped.video/c/FranceElectriq…;6183;923;1905;3337;12348
UNFPAHaiti;UNFPA Haïti;Créer un monde où chaque grossesse est souhaitée, chaque accouchement est sans danger et le potentiel de chaque jeune est accompli.;2222;1792;7568;761;12343
grandparis_;Association Grand Paris;Association Grand Paris : pour une gouvernance démocratique du #GrandParis ! Crée en 2007. président @antonioduarteo;5216;4719;867;1537;12339
bordes_monique;Bordes Monique;Compte personnel - Conseillère Départementale de l'#Ariège (#cd09) en #Occitanie (canton de #Pamiers 2) - #ariegeledpt;877;247;250;10965;12339
MDB_BB;Mobi BoulBi MDB ð²;Antenne locale de lâasso MDB Ã  Boulogne-B. Pour une ville apaisÃ©e et cyclable oÃ¹ enfants et aÃ®nÃ©s peuvent se dÃ©placer en sÃ©curitÃ©. AnimÃ© par Fred Kroff;4838;434;1637;5429;12338
CGollier;Christian Gollier;Executive director of @TSEinfo. I support a rational global strategy to fight climate change.;2879;268;7002;2188;12337
Moulinex_44;Moulinex;Viva la revolucion;10461;11;39;1810;12321
denisberge;Denis Bergé;Gouvernance Direction Générale CCIAMP / Délégué Général Africalink / Délégué Général Afric’Agora;9222;894;889;1288;12293
JeanWesley1999;Jean Wesley Pierre;"Journalist
Photographer 
Consultant en Communication

piped.video/@jeanwesley1999
instagram.com/jean_wesley99?…";370;273;117;11533;12293
Citoyens2Anneau;Citoyens de l’Anneau #ODD - @c2a@piaille.fr;"Citoyens engagés pour les #17ODD de l’#Agenda2030.
Concept et contenus sous licence libre CC-BY-SA 4.0";4218;1181;1396;5495;12290
pagiero;Pagiero;Le génie des pétroliers : Lier le C02 au climat puis faire battre la monnaie €O2 par le GIEC pour nous faire payer l'empreinte du carbone... qu'ils produisent.;11595;131;458;84;12268
LaineRodolphe;Laine Rodolphe;exilé tropical, sous citoyen génétiquement non modifié, emmerde affectueusement manu et son dilatateur jean mimi, administrateur nouvel ordre mondial chat bite;7790;626;469;3370;12255
IAELille;IAE Lille;"University School of Management
#LookBeyond
@Univ_Lille | Membre du réseau @IAEFrance et ambassadeur de l'#EspritIAE !";5695;625;4130;1803;12253
ParlementTogo;Assemblée Nationale Togolaise;"Compte Twitter officiel de l'Assemblée Nationale de la République Togolaise
@ParlementTogo";770;373;9845;1263;12251
NEM613;NEM&6;;3439;179;73;8560;12251
lachape_one;Rémi;Techno enthousiaste. Telco. Data. Agile. Humaniste mi progressiste mi conservateur. Mes tweets n’engagent que moi 🇺🇦🇪🇺🇫🇷🇲🇬🇻🇦🏳️‍🌈;4716;382;462;6683;12243
leraypat;Patricia Leray;Accompagnement identitaire.Coaching personnalité.Aligner son identité#unicité #PCC #humain #sens #valeurs #culture #developpementdurable #SNC #JobMyGlasses;8502;967;626;2147;12242
Martine7lnwb;Martine ASSAR LEINENWEBER;En charge de l'Observatoire des métiers et des questions liées à l'industrie du futur au sein de la  la Direction générale de l'INSTITUT MINES TELECOM;7658;692;311;3575;12236
EyquemLeonard;Leonard_Eyquem;Géologue / Curiosité sens critique lucidité mise en perspective / Il importe peu de descendre du singe , l'essentiel est de ne pas y remonter.;3185;455;167;8421;12228
FisherDiaz;Véronique Smée;"Collaboratrice parlementaire et heureuse de l'être ;-)";3917;1462;397;6451;12227
yaelle_melki;ğ«ğ·ğªğº YaÃ«lle Melkiğ¬ğâï¸ğ;"AgrÃ©gÃ©e #SVT ConseillÃ¨re DAAC @acrennes #Culturescientifique 2016-20 #EAC #cst
Coordinatrice âï¸ @appeldespoles @cerclepolaire
ğGRS @TaraOcean_ ğ¿RÃ©fÃ©rente #EDD";1879;573;302;9472;12226
morthiam09;Bbine Crypto;;955;663;68;10527;12213
BelPaco94;pAcò;écrase mon ego;4498;160;160;7390;12208
cheikhsbeer;cheikhsbeer م;"أَشْهَدُ أَنْ لَا إِلَٰهَ إِلَّا ٱللَّٰهُ وَأَشْهَدُ أَنَّ مُحَمَّدًا رَسُولُ ٱللَّٰهِ
Les chemins qui mènent à l’enfer sont pavés de bonnes
intentions.";6440;35;33;5698;12206
FadigaOussama;Black Man;"Africa first in every plans.
we trust no one but in الله
with the Lord no Man or evil shall stand my way. 
Love to the family 👪.
thankful to the Honnest people";3709;604;269;7607;12189
arnaudom;Dominique;Pessimiste par expérience, optimiste par nécessité;8202;628;199;3159;12188
BaloIpang;Ipang Balo;Nucleairophobe, optimiste;4003;382;51;7746;12182
CE_iledefrance;Caisse d'Epargne IDF;"Découvrez l'actualité de la Caisse d'Epargne Ile-de-France à travers ses multiples engagements.
Pour la relation clientèle : @CaissEpargneSAV #CEIDF";3857;90;4167;4062;12176
RERBGrandParis;RER B GRAND PARIS;#RERB #TeamRERB #UrgenceRERB #BrassardsJaunes @RERB #NonCDGExpress #MasquesPourTous #TestsPourTous;8298;2110;807;954;12169
PexeFrance;Réseau Pexe - Eco-entreprises de France;Le Pexe fédère les réseaux d’éco-entreprises afin de développer les filières environnement / maîtrise de l'énergie.;3895;756;1852;5661;12164
E2C_Guyane;E2C Guyane;Centre de formation innovant dans sa démarche jeunesse. Info-Whatsaap : 0694 90 30 00;1131;176;341;10490;12138
mc_cavecchi;Marie-Christine Cavecchi;Présidente du Département du @valdoise. Première adjointe au Maire de Franconville déléguée à la Culture et la Communication.;5932;525;1962;3707;12126
EtienneDemur;Etienne DEMUR;#VelotafDesChamps Camargue Gardoise - Admin @FUB_fr - President de @AiguesV - @VeloOccitanie - Délégué @AF3V_officiel  34 - #IronManTri 🏊‍♂️🚴‍♂️🏃;3646;1865;1306;5302;12119
LereporterMa;Le Reporter.ma;lereporter.ma. Actualité marocaine. Informations en politique, économie, finances, société, culture, monde...;10820;36;1194;69;12119
Letroublebadour;frederic françois;Je suis pas un leader, mais j'attends le signal!💥;6724;368;199;4813;12104
PurolatorInc;Purolator;Offering you insights into the world of shipping, and beyond. / Pour découvrir le monde de l'expédition et encore plus.;5229;784;4823;1267;12103
LPNews_AURA;La Poste Groupe AURA;"Pour tout savoir de l'actu du groupe #LaPoste en #AuvergneRhôneAlpes #Proximité #EngagéePourVous
Service clients : @LisaLaPoste";5485;748;2732;3135;12100
BenzMosimann;Benz Mosimann;J’aime à penser par moi-même. J’ai réussi à conserver mon libre arbitre.;1981;375;191;9553;12100
BessouDaw;Bessou Daw;"Bank traductrice relations Internationales 
La Liberté est comme l'air !
on se rend compte de sa valeur quand elle commence à manquer !";7240;110;175;4559;12084
HDelevin;Hortense Delevingne;;6859;82;25;5115;12081
paysmontbeliard;Pays de Montbéliard;72 communes. 140 000 habitants. L'Agglomération de #Montbéliard en live : actus, événements, services, économie, culture, sport...;5022;762;3911;2383;12078
blessedjeremie;N.Mukombe Jeremie;Chrétien|Conflictologue |Entrepreneur|Activiste | Passionné par la RDC  & l’Afrique.;141;464;297;11171;12073
1mystereJ;mHystérie;le mieux est le mortel ennemi du bien ou le principe de Pareto expliqué;5906;215;24;5915;12060
jibhey;Jibhey;développeur front-end ( VueJS certified ) #vuejs #javascript #typescript #nodejs, beatmaker amateur, éco-socialiste/souverainiste, produit en Normandie.;6900;334;78;4735;12047
ObjectifZero;ObjectifZeroCarbone;"L'objectif est clair. neutralité ⵛ

#Bricolage
#recyclage
#Energétique
#cyclotourisme
#zerodéchet
#TransitionRurale";4724;338;2259;4722;12043
CECILEROUYER1;DiploDOCus;"Doc passionnée et engagée
Membre du Collectif Sante en Danger
Curieuse de tout, amoureuse des mots et de la musique, sportive et dingue de montagne et d'ocean";5351;563;228;5890;12032
EELVDeuxSevres;EELV Deux-Sèvres;;10107;776;857;286;12026
CryptoDamos;MaxiDamos21M;Bitcoin citizen - BTC Maxi - Tax Expert;4726;58;226;7012;12022
CanadaColombie;Canada en Colombie;Ambassade du Canada en Colombie - English @CanadaColombia - Español @CanadayColombia - bit.ly/1L6aMj6;7093;600;3962;364;12019
MattBoudet;Matthieu Boudet;"→#SalesOps #BusinessStrategy #SolutionDesign #ESG #Bid
→ #India #SocEnt #Asia #Innovation #FutureOfWork #ClimateChange #Sustainability #Ocean #NoPalmOil
🇪🇺";4971;380;1116;5546;12013
BordeauxINP;Bordeaux INP;9 écoles d'#ingénieurs publiques en Nouvelle-Aquitaine - 1 classe prépa intégrée : La Prépa des INP - 1 incubateur : Sit'Innov - 11 laboratoires de recherche;5452;934;2908;2712;12006
JeanDup73866723;Jean Dupond;Retweet ne signifie pas approbation;3724;411;60;7791;11986
PatrickB_EF;pat_rick;"je suis responsable de ce que j'écris, pas de ce que vous comprenez...
#nofakemed";8007;285;93;3600;11985
MediacitesLille;Mediacités Lille;"Les enquêtes sur la métropole de #Lille que vous ne lirez pas ailleurs. #Média #indépendant et sans publicité.
📩 Notre newsletter : mediacites.fr/newsletter/";4059;1242;4297;2378;11976
VabChristian;Vabé Christian;Journaliste, directeur de la Publication d'IvoireBusiness.net;11359;128;479;6;11972
CHenryDelapomme;CharlesHenry Delapomme ð«ð·Zð¿ð;"Trappeur de Surmulots 
VÃ©tÃ©ran 
Forces SpÃ©ciales FranÃ§aises";5978;542;682;4770;11972
andreaxlubeck;Andrea Lubeck;Journaliste et cheffe de la section Urgence climat @24heuresca ✉️ andrea.lubeck@quebecormedia.com she/her/elle;4403;3311;997;3260;11971
Guerin_Serge;Serge Guérin;Pr @inseec_ge Dir scientif Pôle #Santé-RH @INSEEC_MScMBA #Consultant #Speaker #Auteur +40📚 Pdt @AgenceDesMCA #Sociologie #Senior #Care #Aidant #Camus #Chocolat;2213;5;4475;5269;11962
NandyCharlie;Nandy Charlie;"MASTER 2 Droit International Public
/ #ModelPhoto #FitnessAddict #NandysAngels 💋";4302;410;813;6437;11962
TwiggyNeverLeft;Twiggy;"Je est une autre 
There's no way out but fight
Instead of looking for hope, look for action
And then and only then, hope will come";6710;1200;590;3459;11959
Eugene__Ballard;Eugène;;4096;113;46;7703;11958
BARLANicolas1;Nicolas Barla;"Défenseur du Climat et des générations actuelles et futures
Conseiller Métropole de Lyon
Ingénieur réseaux électriques
Fan du GIEC et RTE
tinyurl.com/2p8rpwd5";2427;529;892;8105;11953
EmmanFernandes;Emmanuel Fernandes;đź”´DĂ©putĂ© FI-NUPES de la deuxiĂ¨me circonscription du Bas-Rhin (Strasbourg-sud et Illkirch-Graffenstaden). đź‘‰ Mes propres tweets sont signĂ©s.;1417;1012;6859;2663;11951
gruffat_claude;Claude Gruffat;Eurodéputé @euroecolos @GreensEFA | Comité ECON, AGRI, IMCO 🇪🇺| Commerce équitable, TaxJustice, Bio, ESS🌱| Ex-Président @Biocoop | Plus belle moustache du PE;4255;1794;3885;2017;11951
bscamara;babacar sarr camara;EX #MUFCð´ð´ð´ || hakuna matata;7821;429;104;3590;11944
AlexisJanicot;Alexis Janicot;Entrepreneur engagé dans l’écosystème d’innovation #ODD. Ancien directeur French Tech, #Toulouse #digital #greentech #fablab;3047;1303;1328;6251;11929
verilhacaubin;Aubin VERILHAC;Citoyen engagé | Social-démocrate | Suppléant CN PS | Secrétaire fédéral PS26 | Co-référent Drôme - La Convention | Candidat Départementales 2021;2489;4441;3612;1378;11920
KURUisKURU;kuru;De la ville et de la campagne ,  du droit et de la muscu , progressiste et réac, rugby et peinture italienne , sex addict et cérébral , gay mais pas queer;5452;1684;153;4626;11915
Lenor56221778;Lenor;Professeur d’histoire géographie. J’aime la photographie, les jeux vidéo et les chats.;1451;833;851;8777;11912
gbatinazif;Gbati MENSA;Focal Point UN1FY TOGO/Member of JCI universitaire Lomé/ YOUNGO member/ alumni IYDC / Global Peace Ambassador/ Theirworld Ambassador / country Director HNP;352;572;289;10691;11904
HESAM_Univ;HESAM Université;Découvrez toute l’actualité d'HESAM Université #formation #recherche #innovation #enseignementsup;6521;591;2355;2431;11898
stephanejagu1;JAGU Stéphane;"Ingénieur Agri Qualité IAA
Auditeur certifié QSE Energie";3096;188;97;8512;11893
groupeRN_off;Groupe Rassemblement National;Compte officiel du Groupe Rassemblement National à l'Assemblée nationale, présidé par @MLP_officiel.;2018;165;7127;2581;11891
provensau;C’est la magie de Marseille;🇫🇷🇫🇮🇵🇪🇧🇴🇨🇷🇵🇹🇪🇸🇦🇷🇧🇷🇧🇪🇮🇹🇪🇺🇮🇳🇵🇦🇷🇪🇦🇶 🐀 IG: louislimacocha;1879;403;25;9577;11884
Brezemce;Eugénio 🇫🇷🇺🇦🇪🇺;Soutien aux Ukrainiens. Mon rêve : une France réconciliée et apaisée. Mon hymne: Imagine. Mes zéros : LFI, extrémisme, racisme et complotisme.;5591;504;326;5454;11875
ForumdesAS1;Forum des AS;''Forum des As'' compte parmi les pionniers des journaux de la presse privée de la République démocratique du Congo, au lendemain du discours du 24 avril 1990.;6535;990;2101;2249;11875
Flow2911;le libre investisseur;The silver bullet will kill the beast;3219;466;86;8098;11869
Olivier40121476;Relais Infos;;9696;66;318;1776;11856
PNUD_BFA;Le PNUD au Burkina Faso ð§ð«;Le Programme des Nations unies pour le dÃ©veloppement au Burkina Faso travaille pour un avenir durable et inclusif pour toutes et tous.  #PNUD_BFA;1812;735;7684;1618;11849
AndreMARTIN126;André MARTIN;"Vice-président Conseil Régional #PaysdelaLoire en charge de #jeunesse #emploi #formations #apprentissage #lycées #orientation #insertion 
Maire de #Oreed'Anjou";2975;1432;2629;4810;11846
MicheleRamis;Michèle Ramis;Directrice des Amériques et des Caraïbes 🌎@francediplo 🇫🇷. Haute fonctionnaire à l’Egalité. Ex-Ambassadrice en Colombie🇨🇴 Roumanie🇹🇩 Guatemala🇬🇹.;1541;386;6822;3085;11834
Donalditnon;Donaldino;"IT Senior BA;";5664;1122;891;4155;11832
Strasser_500;Olivier Guérin;;2929;1626;258;7018;11831
lila_pnrd;déesse du michelson;bobo écolo gaucho vg de merde + fan de arctic monkeys et de brooklyn 99 /prépa PC;4145;116;228;7339;11828
lebuffet;Cédric 🍩;// Eager to learn // #marketing // #inbound // #nocode 📍 Nantes;752;189;375;10509;11825
ipofil;ipofil;There is no cloud it is just someone else computer ...;8751;1324;56;1666;11797
VMontandon;Valérie Montandon;Conseillère de Paris et @GrandParisMGP • Conseillère régionale @iledefrance • VP @GpeChangerParis #Paris12 @Nouv_Energie #Entrepreneuse • Etudiante #Sorbonne;3320;421;5906;2143;11790
Mhoreau22;Henri Moreau;;3508;178;41;8060;11787
Obside_Yam;Anozer_;;305;181;6;11295;11787
ADESAA3;ADESAA;ASSOCIATION DE DEFENSE DE L'ENVIRONNEMENT DE SAINT-AIGNAN ET DE SES ALENTOURS : venez nous rejoindre pour préserver l'environnement de cette région de la Sarthe;7684;324;531;3247;11786
ENJEUquebec;ENvironnement JEUnesse (ENJEU);#ENvironnement JEUnesse (ENJEU) conscientise les #jeunes aux enjeux environnementaux, les outille à travers ses projets éducatifs et les incite à agir!;4025;1325;4055;2365;11770
LaurentMayer007;Laurent Mayer;I'm lucky to have a wonderful family, a passion for real estate, blockchain, & entrepreneurship! CEO @KryptoStone_io #blockchain #RealEstate #web3;1679;291;557;9243;11770
EMLVparis;EMLVparis;Ecole de Commerce à Paris • Programme Grande École • Grade de Master • AACSB • EFMD Master • AMBA  @ConcoursSESAME @PoledeVinci @ConferenceDesGE #BusinessSchool;6210;465;2375;2715;11765
JacquesQuester;Jacques quester-séméon;;4025;117;61;7555;11758
soniaborrini;Sonia for Climate Action;"Comms & KM @AfDB_Group #ClimateChange. Based in #Africa. #TBSurvivor. Mom.Vegetarian. 
#BeatPlasticPollution. Views=my own. RT≠endorsement.";5107;1714;1659;3276;11756
romanoperrier;Romain Perrier;;10260;369;342;784;11755
OTBB92;OTBB;"Office de Tourisme de Boulogne-Billancourt
Tourist Office - Oficina de Turismo - 観光協会 - 旅游局
📷 IG : OTBB92 
#BoulogneBillancourt
facebook.com/OTBB92";7090;141;1401;3119;11751
rodanR7;Rodrigues Daniel;;4599;48;34;7068;11749
PascalVerveur;Pascal Verveur;A little bit of #mobile, #Internet of things, #Cloud, and #Digital economy.;9236;411;285;1792;11724
FlexDetente;Flex/Détente;;9496;80;70;2077;11723
GilletCorinne2;Gillet Corinne;études littéraires chauffeur et gérante société de taxi;1874;284;190;9368;11716
PLCCowboy;Larry P Lewis Jr;HAPPILY MARRIED technical sales engineer raised in Katy Texas. Profile is for business only. NO CRYPTO OR ADULT content please.;4709;2619;2514;1871;11713
KadriTastan;Kadri Tastan;EU Government Affairs Manager at @CFEurope2050 (@Thirdwayenergy)| Non-Resident Senior Fellow at @gmfus Brussels | Climate, Energy, EU, Turkey, Geopolitics;2044;2593;1459;5616;11712
RenewablesAssoc;Canadian Renewable Energy Association (CanREA);We are the voice for wind, solar and energy storage solutions. đšâïžđ Nous sommes la voix des solutions dâĂ©nergies Ă©olienne et solaire et de stockage dâĂ©nergie.;5217;1055;2923;2513;11708
djewzer;World News by Djewzer;World news;5987;286;370;5060;11703
neva2muchs;BNBoromirš·š“š»;;9445;112;145;1998;11700
TshimangaJonat4;TSHIMANGA Jonathan;Ingénieur , acteur politique, secrétaire national et exécutif en charge de la jeunesse de la plateforme politique et électorale Horizon 2023.;3912;1249;1007;5519;11687
aqtech;AQT;Association québécoise des technologies (AQT) / Quebec Technology Association ***** La force du nombre fait la différence;5765;1398;3434;1087;11684
SunnyDeGRDF;SunDeGRDF #GrdfPower;#Ingenierie #DT #Paris Faites vos projets en silence la rÃ©ussite se chargera du bruitðªðð #BiomÃ©thane #MÃ©thanisation #DTIDF #FaireDuGaz #EnergieAvenir;2395;3133;623;5530;11681
Henockntang;Henock Ntanga;"Entrepreneur #africain passionné de la technologie et de la bonne gouvernance
#FreeAfrica";1436;933;706;8604;11679
ChemistryCanada;CIAC;The Chemistry Industry Association of Canada is the voice of the chemistry sector and steward of Responsible Care - the industry's commitment to sustainability.;4393;913;2521;3849;11676
honneur123;que dieu protège mes enfants;Qu'elles reviennent un jour à la raison... Je vous aime ! Je vous pardonne.;7192;1395;507;2574;11668
BENOTMUKENDIBO1;BOB BENOÎT MUKENDI;JOURNALISTE ET PATRON DE LIVE-INFOS.CD;516;1968;1060;8124;11668
MarieCasan;casan;;5739;70;36;5819;11664
LeBriagoun;Exomniaque;#LInsurrectionquiTarde. Fâché avec tout ce qui panse.;6190;596;588;4290;11664
MKasongo;Mweze Kasongo;Je suis Pasteur et predicateur de la parole de Dieu. Un défenseur des droits et libertés! Un Panafricain et un citoyen du Monde.;10367;132;377;781;11657
SE_LGD;L.Damien;"PassionnÃ©ment #Africainð #Schumpeterian Economist. 
Innovation by creative destruction:the way for #SD of Free Africa  
#Economie #Politique ð§ð« #R4Dâ»ï¸";6020;736;919;3982;11657
IsraelinSenegal;Ambassade d'Israël;"Compte officiel de l'Ambassade d’Israël  I Sénégal 🇸🇳 I Cap-Vert 🇨🇻 I Guinée 🇬🇳 I Gambie 🇬🇲 I Guinée-Bissau 🇬🇼 I Tchad 🇹🇩 

Ambassadeur: @BenBourgel";2958;900;6872;926;11656
DufraisseCcile1;Cécile DUFRAISSE;Maire de quartier - Adjointe au Maire de #Toulouse auprès de @jlmoudenc 🇫🇷 Adhérente @lesrepublicains et @Nouv_Energie avec @davidlisnard 👌 #collterr;1973;891;2117;6673;11654
belilo09;J;"amateur soccer/hockey.
mon opinion n'engage que moi uniquement.";9214;919;444;1070;11647
fatima02867498;LIBRE;Je pense qu'à m'amuser et provoquer;10319;352;373;602;11646
francis_larrea;LARREA Francis maraicher bio et au CA de B.L.E.;Maraîcher arbo #bio: Ferme Haitz ondoa,#Mendionde #Espelette . Président @BLE_CIVAMBio #bioLocal #solidaire #militant  mes tweets n'engagent que moi !;4694;3348;1654;1945;11641
BBellanger76;Bertrand Bellanger;Président du Département de la @seinemaritime | Élu du canton de Mont-Saint-Aignan - Déville-lès-Rouen | Président culture de l'@ADepartementsF;2690;1161;2849;4937;11637
Pour_Gagner_35;Gagner ! en Ille-et-Vilaine;"Pour suivre l'actualité d'Olivier Faure et des signataires du texte d'orientation Gagner ! #CongrèsPS #PourGagner
@Pour_Gagner @FaureOlivier";5247;597;408;5375;11627
becht_olivier;Olivier Becht;Ministre délégué chargé du commerce extérieur, de l’attractivité et des Français de l’étranger;1215;149;10173;89;11626
K_2LOU;Ktoulou;Restaurateur Breton. Pluralité des idées. Pour une France souveraine. Cause aussi JV/Média/Ciné de temps en temps;3098;324;59;8145;11626
pptools;Pierre PERRIN;"Le credo de l'hommo-economicus :
Avec moi le délire,
Après moi le DÉLUGE !

Procureur depuis peu !";6524;609;118;4368;11619
FabaVivilight;Faba;"FREE LANCE 
 Je déclare le Nouvel Ordre Mondial :  PAIX AMOUR FRATERNITE  PROSPERITE Ouvert .Posons nous les bonnes questions pour avoir les vraies solutions";3077;298;140;8104;11619
PropreSenegal;l'homme plastique;Écologistes;895;4995;3401;2320;11611
Fourmis327;Fourmis327;"Suiveur ou éclaireur? Telle est la question... 
TWITTER, pour le pire et le meilleur...des bergers et des moutons.";2620;82;47;8857;11606
vaillantHOBZ;NewVaillant;➰;3697;975;219;6714;11605
Karm5624;Karm;🎶;3283;440;87;7786;11596
stelsanne;Stelsanne Dell;"“If you can't give me poetry, can't you give me ""poetical science"" Ada Lovelace - stelsanne@gmail.com";2726;335;35;8494;11590
olivierpaysan;Olivier Dauger;Agriculteur, administrateur FNSEA, référent climat énergie, vice pdt AGPB, Co pdt France Gaz Renouvelable.;6324;794;1405;3066;11589
jk_mudiamupanga;KALALA mudiamupanga Joseph;"▪Pédagogue;
▪Doctorant AIU Sces Economiques;
▪Ingénieur Génie Mécanique (avec une formation Technique de l'Ecole Technique de Mutoshi, l'ex-pepinière de la GCM)";6033;4116;1408;29;11586
Objectif_info;Objectif-Infos.cd;L'ambition d'informer;11319;49;87;126;11581
InstitutAgroRA;L'Institut Agro Rennes-Angers;"Grande école publique d'ingénieurs en agronomie, agroalimentaire, horticulture et paysage
#agriculture #alimentation #environnement #transition";3318;624;6352;1286;11580
JulienBinouze;Ultimate Julien ⚪Ⓜ️⭐;"Vendeur de Jeux Vidéo depuis avant ta naissance. Le Jeu Vidéo c'était pas mieux avant.  
Dessinateur de BD

#TeamOM #GoPackGo #CaptainTsubasa #DragonBall";6162;513;107;4796;11578
dubruly;dubruly;Pour la transition écologique et sociale j'ai la solution : dubruly.free.fr;10344;215;192;825;11576
anotherflop;Another Flo ;"❔💬
🐼
Cogito ergo sum
#NUPES
fr/en |
Auteur @trendologue |
Co-auteur @adpripfr";4125;2025;1248;4166;11564
Loic_Ferrieu;Loïc Ferrieu;Conseiller municipal à #Ramonville • #CollCab à @Bruguieres31150 • Adhérent @HorizonsLeParti • #Aveyron  • Européen convaincu 🇪🇺;7811;1633;2034;81;11559
Firecorrupt;Dum Dum 🇫🇷🇵🇱🇪🇺🌎;;7064;111;20;4362;11557
AvigaelDagues;Dagues Avigael;Transformation for value proposition #evolutionsocietale #gouvernancedevaleurs #enjoybuildingthefuture;10944;352;97;160;11553
MarhyluBabyrra;Babyrra-Marhylu BOKOLA;On ne peut parler politique dans une société si le développement de celle-ci n'est pas prioritaire. Parlons Développement durable et transition écologique.🌿🍀;1281;276;656;9331;11544
LozanoCorinne84;Mustang84#macroniste de 1ère heure;Macroniste de la première heure et fière de l'être;6043;525;517;4458;11543
Rosalia1Rosalia;Rossi Rosalia;;5831;106;249;5345;11531
CjoSpyce;Jourdain Christophe;Je suis un anti-conspirationniste et adepte de la parole et des faits scientifiques. Je n'hésiterais pas à débunker quand cela me paraîtra opportun.;7906;65;88;3471;11530
Haute43;Chaud'n Roll;Maraîcher - Du producteur aux consommateurs - pour le dogme de la vérité;5377;287;189;5674;11527
GenerationsLeze;Génération•s - Comité de la Lèze;"Comité du Mouvement #Générations de la Lèze à Saint-Sulpice-sur-Lèze dans la #HauteGaronne Facebook ; fb.com/Generation.sDeLaLeze";9133;1211;830;346;11520
GalanteMuriel;Muriel Galante Guilleminot;Architecte - Responsable culturelle @APHP - Maire-adjointe @Fontenay92 #culture #communication esthétique urbaine #patrimoine;4527;191;249;6550;11517
GardeLebreton;Th.G-L ⚡ en transition ⚡;"Ici d'abord pour la transition énergétique, et autres si affinités ...
Pro #nucléaire pas anti #ENR. Salarié de l'#énergie je parle en mon nom.";6834;702;276;3696;11508
bam_thomas;Bruno Thomas;"Software craftsman at @ICIJorg, music nerd, mutual aid enthusiast,  feminist apprentice. CTO iroco.cođź‡«đź‡·đź‡¬đź‡§
@bthomas@mastodon.social";4158;344;321;6669;11492
ClaireCBourgeoi;Claire Bourgeois;Directrice de l'ESAIP Campus Méditerranée à Aix-en-Provence @groupeesaip @ConferenceDesGE;3071;1013;1106;6302;11492
flashgamma;flashgamma;A la fin on va tous mourir;9066;95;123;2207;11491
LucRosier4;Luc Rosier ❤🏳️‍🌈❤🇨🇵;"CFO 
Multinationals and hedge funds rule the world, get with the program!";6537;207;23;4719;11486
l_frajerman;Laurent Frajerman;"Enseignant & chercheur / Spécialiste mouvements sociaux et politiques éducatives / Observatoire vie fédérale FSU
 ↪  Sᴏᴄɪᴏ-ʜɪsᴛᴏɪʀᴇ, ᴇɴɢᴀɢᴇᴍᴇɴᴛ, ᴇ́ᴄʟᴇᴄᴛɪsᴍᴇ";5774;499;2392;2818;11483
BELLATFoot;BELLAT Jean Michel;79 ans, avocat retraité, joueur/dirigeant Stade RennaisFC,international universitaire (10 sélections), président LBF 2004/2008, doyen actuel du foot amateur Fr;6510;296;231;4444;11481
RN_BFC;Groupe RN BFC;Actualité des 18 élus du groupe @RN_BFC, présidé par @JulienOdoul au Conseil régional de Bourgogne Franche-Comté.;5358;416;1879;3819;11472
emjee48;Emjee đšđ” đȘđș đźđł;Forestier bleu blanc vert. à€­à€Ÿà€°à€€ à€à€Ÿ à€Šà„à€žà„à€€. Emmerdeur de complotistes.;8796;53;60;2563;11472
kripscol;kripscol;kripskroll - Compte de backup contre la censure.;2247;358;60;8803;11468
EnvDDBC_GouvCg;Min. Environnement, D. Durable & Bassin du Congo;Bienvenue sur le compte officiel du Ministère de l’Environnement, du Développement Durable et du Bassin du Congo - République Congo Brazzaville;1567;125;8753;1016;11461
CatCecat;CéKoicemonde;;5552;78;29;5800;11459
sqqqqqqqqqsqsfs;sqqqqqqqqqsqsfs 🇺🇦 ❤️‍☀️‍💚;"#NAFO fella
Totally not a bot.
Real human with real human fingers. Human fingers are great to type on human keyboards. Feels so great to be a human.
#totally";3506;217;51;7682;11456
coralie_mantion;Coralie Mantion;"Architecte
Vice-présidente à l’Aménagement durable du territoire #Montpellier
#EELV🌻";2722;756;2011;5963;11452
Que_Lenergie;Emeric FINCK;Les défis de la transition énergétique et de la neutralité carbone au cours des trente années à venir, au niveau LOCAL et à l‘échelle SUPRANATIONALE.;9833;15;1499;104;11451
CollecCitoyen06;Collectif Citoyen 06;Informer et mobiliser les citoyen(ne)s niçois(es) et maralpin(e)s sur les enjeux environnementaux, sanitaires et sociaux pour un territoire durable.;5820;670;1421;3536;11447
sycope59;Sycope;;5499;525;40;5365;11429
EmmaVelo12;Emmanuelle;"Habitante #paris12 et #velotafeuse #ecologie Franche Comté Gironde
Esprit associatif";2329;354;201;8542;11426
Lesecologistes1;Les Ecologistes;Les Ecologistes ®️(marque déposée INPI) mouvement citoyen indépendant créé en 2010 pour l'écologie. Président @antonioduarteo;4381;4988;1038;1010;11417
ADERAriverains;ADERA;Défense des riverains de l'aéroport de Beauvais-Tillé // The citizens living in the vicinity of Beauvais-Tillé airport (France);3924;243;388;6857;11412
arcicen;arcicen;Les membres de l'ARCICEN sont des élus des communes et des intercommunalités, sièges des centrales nucléaires ou traitement, stockage de déchets en France;5951;585;514;4359;11409
verywelldigital;Verywell Digital;Agence digitale - Création de sites internet sur mesure, innovants & durables #webdesign #webdevelopper #UX #UI #communication #wordpress #drupal #react;5001;1541;1529;3336;11407
ch_lemercier;Charles Lemercier;Journaliste. Sillonne nos régions pour @infofrance3 🍼 @OuestFrance. Option ruralité et courses hippiques 👨‍🌾🌾;8271;669;929;1533;11402
EchosMediasSarl;Groupe Échosmédias Sarl🇲🇱;"Site web d'Informations en temps réel echosmedias.org et Journal hebdomadaire d'informations générales. 
Administrateur : Bakary Mamadou COULIBALY";5682;1909;3089;709;11389
EcoloParis19;EELV Paris 19e ð»ð³ð;Le compte des Ã©colos de #Paris19. changeons nos villes, changeons Paris, changeons nos vies ð» Rejoignez-nous, DM ouverts âª;3924;1936;2129;3385;11374
JCDessanges;Jean-Christophe Dessanges #AvecVous;#Tech4Good Entrepreneur, #Digital & #BigData, #MedTech, #Media, #International #IT élu municipal #Renaissance #SceauxEnsemble;3650;965;724;6034;11373
AFNEG;AFNEG;"Association Fédérative Nationale des #étudiantEs en #Géographie, Aménagement, Urbanisme et Environnement - Administrateur à @La_FAGE 
👉👉 Linktr.ee/AFNEG 💡";3958;624;2451;4336;11369
lethicia_twitt;Léthicia Rancurel;Partner @SOPRASTERIA NEXT #Territoires, ex-Dir & Fond @Tuba_Lyon et ex-Admin & VP @FrenchTechOneLS 🎓PhD @UnivParisSaclay, @UCSantaBarbara, @IFG_EE & @emlyon;2908;932;1392;6136;11368
Mtr_91;Le M;愛 🇵🇸;1861;50;80;9361;11352
J_Yalcouye;Job YALCOUYÉ;"Juriste,
Libre penseur";3597;780;772;6199;11348
ManiratangaZph1;Maniratanga Zéphyrin;Burundi Permanent Representive🇧🇮to the U.N🇺🇳in New York, Former Chief of State Protocol & Diplomatic office to the President, former diplomat in🇿🇦🇨🇦🇮🇳;1049;370;4402;5509;11330
FrancopresseAPF;Francopresse;Francopresse est un média national voué principalement à l’information franco-canadienne.;6715;913;3403;298;11329
jolan_ls;Jolan;"Engagé pour mon territoire et étudiant en Licence AES 🏛️.
Un projet, une ambition, un combat.
🇨🇵🇪🇺
#Léognan #Bordeaux #Gironde
#Politique #Engagement";802;3932;632;5962;11328
Atalayar_Fr;Atalayar entre deux rives;Pour les dirigeants méditerranéens et atlantiques, nous voulons être le pont de la communication, de l'information et de la compréhension entre les cultures.;10609;109;563;42;11323
GivreeC;Givrée Citrouille;"Membre d'Amnesty International, d'Attac et des Alcooliques Anonymes.
""Ce sont les petits qui portent le Monde.""";272;139;34;10875;11320
stephanouty;Macron 1er dans tous ses états !;Le président de la République comme vous ne l’avez jamais vu. Tant que la caricature n’est pas interdite 🚫 j’en profite… #Macron #Caricature #Gouvernement #IA;1868;3798;2859;2795;11320
Decideo;Decideo;Decideo suit l'actualité de l'informatique décisionnelle, intelligence d'affaires, #data #BusinessIntelligence, #BigData, #analytique... en français;7376;67;2040;1835;11318
m_monties;Marco de Toulouse;;3204;284;47;7780;11315
humanitairegscf;Pompiers - Humanitaires du GSCF;Groupe de Secours Catastrophe Français (GSCF) / Pompiers - Humanitaires du GSCF;7420;1463;1877;535;11295
JLMTV_INFOS;JLMTV-INFOS;Compte anti extrême droite et extrême finance. 🔴 Stop #AbrutissementDeMasse;2576;209;8396;114;11295
_OTRE_;OTRE;Principale organisation patronale des PME et TPE du transport routier marchandises, voyageurs, déménagement, fonds et valeurs, sanitaire et logistique.;6966;241;3119;964;11290
FedDev_Ontario;FedDev Ontario;"Agence fédérale de développement économique pour le Sud de l'Ontario 
Conditions d'utilisation: ow.ly/2gEA50EKXug
Follow us in English: @FedDevOntario";6747;351;1561;2623;11282
JeremyGhio;Jeremy Ghio;Relations publiques @TACT | Ancien conseiller de @DomAnglade @melaniejoly & @dilebouthillier | Aime parler de politique fédérale | 🇨🇦⚜️;3534;1964;1845;3938;11281
pdaures;Patrick Daures;Me, myself and I;6230;371;80;4588;11269
jonathankisa04;Jonathan kisa 🌐;panafricain/étude science de l'information et de la communication/citoyen du monde;748;1386;1249;7882;11265
Jeremyobird;Jeremy;Lorsque le sage montre la lune, l'imbécile poste sur twitter.;3778;1203;95;6188;11264
KrgFrance;KRG - France;Représentation du Gouvernement Régional du Kurdistan en France;2231;535;3945;4546;11257
ForestRcw;Rémy Chambard-Williams;Consultant. Aime faire parler les chiffres, mais sans les faire mentir ! ☢️💦🌬🌊;1560;242;54;9391;11247
francisaayabec;Francis Ouellet;Analyste et j’ai des choses à dire;6702;136;159;4249;11246
matthieugdsm;Matthieu Guyot;Journaliste spécialisé dans les questions de sécurité (gendarmerie, pompiers...) et curieux des questions climatiques. Compte personnel. DM ouverts.;6875;639;1196;2532;11242
syl20_SC;Coiffure 2000;Vous le sachet;5819;402;48;4972;11241
KBilladao;Bill-Adam KILOLO;•juriste ⚖️ • chercheur en Justice Pénale Internationale • passionné de littérature• Vice-président National de la Ligue des Jeunes/ A.Ch;246;396;661;9938;11241
IciWindsor;ICI Windsor;"Compte officiel de Radio-Canada à Windsor, en Ontario. Toutes les nouvelles d'ICI Windsor @iciwindsor
  ·  radio-canada.ca/windsor";8334;821;1859;226;11240
AL24Francais;AL24News Français;قناة الجزائر الدولية;9662;14;1555;0;11231
denhollandert;Tristan Den Hollander;"Psychologue du travail et juriste de droit social đ
Sciences du travail et protection socialeđ";5373;138;59;5647;11217
BureauVeritasFr;Bureau Veritas France;"ðð Tests, inspections et certification. 
Notre rÃ´le ðAccompagner les Ã©volutions de la sociÃ©tÃ©, prÃ©venir les risques et soutenir lâinnovation de nos clients.";5635;1125;3479;977;11216
SimonciniGille1;Simoncini Gilles;Ponts Paris Tech, IAE , #disruptif #énergies #innovations #ville durable #économie circulaire #gaz verts #mobilité #insertion #politique;3575;1600;600;5441;11216
dourah_bah;Dourah Bah;Présentateur D'IMPACT et Membre de l'Alliance Internationale pour les Objectifs du Développement Durable AIODD;907;1230;160;8910;11207
souefmo_elamine;Souef Mohamed El-Amine;Special Representative of the Chairperson of the African Union Commission (SRCC) for Somalia and Head of the African Union Transition Mission @ATMIS_Somalia 🕊;2069;96;5479;3550;11194
Claire_G1970;Claire G.;Femme avec un certain nombre de convictions opposée à toutes celles qui propagent la culture du viol. Retraitée. Militante associative. Transgenre.;7425;134;76;3556;11191
YvesLandryKOUAM;ð¿Yves-Landry KouamÃ©ð¾;Pour lâÃ©veil dâune conscience Ã©cologique collective â;1119;672;1399;7987;11177
Franois10858870;François;;5564;111;76;5415;11166
LaDepecheVeto;Dépêche Vétérinaire;"Hebdomadaire La Dépêche Vétérinaire : toute l'actualité professionnelle, technique, accessible et fiable !
#veterinaire #actuveto";6315;125;4618;107;11165
fluideve;VB@fluideve;"Libérale, humaniste, gourmande, Que vive le débat! 
Soutien indéfectible à l'Ukraine jusqu'à sa TOTALE libération !";5753;250;18;5143;11164
FrancisUNDP;Francis James;"UNDP Resident Representative in Gabon.
Previously in Haïti, Sénégal, Burundi, NY, Washington, Cambodia, Thailand, China.";3427;362;1527;5846;11162
FDjelama;farid djelama;;6575;51;22;4510;11158
CVA_ACFP;CVA / ACFP;"The CVA/ACFP promotes and fosters vocational and associated fields of education. 
Our free newsletter cva-acfp.org/publications/ne…";9633;264;484;772;11153
PierreCazeneuve;Pierre Cazeneuve;@DeputesRE des Hauts-de-Seine #Rueil #Garches #SaintCloud ð²ð«ðªðº EngagÃ© pour le climat Ã  la commission du dÃ©veloppement durable ð;1024;1103;6371;2645;11143
SalimSauvadet;Chevalier Sylvain Oisel Salîm Trisq'ailes Sauvadet;"- Ligue indigo -
Ὥagician🦋浪人Poète∫³num⁴Scrum⁵ink of the ninth Dragon
Une Ὥote d'innovaⓣiⓄn à nature surréaliste, matérialise le réalisme -";1773;4645;3490;1234;11142
BabinetCharles;Babinet Charles;"Responsable #Reconquete #circo4904 ;
Candidat #Legislatives2022 ;
Adjoint de la Déléguée Départementale 49 ;
Membre du Conseil National R! #CNReconquête
ن";7807;128;315;2885;11135
SebMayoux;Sebastien Mayoux;Auteur sérieux de polars (#AlBaasLeLivre, #BienParaitre & #LaFinDeLeurMonde) et parodie de journaliste @LeConnard_Off;8499;557;736;1343;11135
MaximePzt;Maxime Pzt;"#Energie #ENR #bascarbone #sobriété #efficacité Travaille dans le domaine de l'énergie et des ENR.
Engagé pour le climat.";2791;869;278;7196;11134
DebaesS;Debaes Sophie;;4258;176;47;6648;11129
GuyomTouseul;Guyom Touseul ð§¹ð¢âï¸;Chansons impliquÃ©es et pas compliquÃ©es;2748;1999;1624;4757;11128
jeremycamus;Jérémy Camus;Vice-Président à la Métropole de Lyon délégué à l'agriculture, à l'alimentation et à la résilience du territoire;2471;2493;1945;4215;11124
matheomanon;Stef;;1903;43;20;9152;11118
ALSantucci;Anne-Laure Santucci;#Cunsigliera à l’Assemblea di Corsica #Merre di Luri #Pdte Conseil des Rivages de Corse 🌊Pdt de la Commission permanente du Conseil maritime de façade Med;2411;45;1117;7539;11112
eloitp33;Eloi Tardy-Planechaud;Chef de cabinet @Gironde // Ex-Collaborateur de Régis @Juanico et @AlainDavid_AN // Pêcheur en rivière et devant l’éternel // ex-@UNEF ✊ // @nyknicks 🏀;3356;1922;2349;3482;11109
GallLaurent;Laurent Gall;Coordinateur formation Wallonie - Bruxelles au sein de Alimento - IFP asbl. Président de l’asbl Epicuris, centre de compétences des métiers de bouche.;5007;559;339;5196;11101
pcx_wave;Pcx Wave;;3172;315;37;7573;11097
SOL_association;SOL;«Alternatives #agroécologiques & solidaires» Depuis 1980, SOL agit en faveur des #paysans, et la protection de la #biodiversité #alimentation #semences #bio;4170;1507;2442;2977;11096
ECCCSciTech;ECCC SciTech;"ECCC Science et technologie, @EnvironnementCa / 
ECCC Science and Technology, @EnvironmentCa 

Terms: ow.ly/i3s430gbkBz / Avis : ow.ly/tOKa30gbkLi";3617;770;1664;5043;11094
ArnaudFleury2;Årnaud FLEURY Independant L@b;"🔥 Je n'ai pas besoin de plaire à qui ne me plaît pas. (Agrippa d'Aubigné)

Autiste infréquentable — quelque part — et par choix. MAGI

Chercheur ""Hors-Statut""";6235;1659;663;2525;11082
EricArchambau18;Libération des esclaves modernes;L'esclavage moderne est fondé sur l'ignorance de la masse demeurant inconsciente de sa servitude.;6481;1036;2095;1468;11080
FabriceRivet;Fabrice de Rivet;Vélotaf + Biodiversité + Prosilva (gestion forestière respectueuse des équlibres) + baisse des émissions de GES + réindustrialisation;7044;249;152;3623;11068
renaissance_fde;Renaissance - Français de l'étranger (FdE);@Renaissance hors des frontières. Pour une Renaissance française et européenne, rejoignez le parti d’Emmanuel Macron sur parti-renaissance.fr;6178;1574;1433;1871;11056
EApampa;Elisabeth APAMPA;Radio - TV - Events Host ð¹ð¬ Entrepreneur - Producer of @eaiyawo_radio_tv @theeashow - Founder / CEO @eadreams_ Forewoman @eaiyawo My fondation #FondationEA;3867;1097;3625;2465;11054
CesarBouvet;César Bouvet;Écologiste à la Mairie de Paris | co-auteur du rapport sur l’aérien et le climat de @bl_evolution ✈️;1441;2022;2179;5404;11046
Montech78;Montech78;;3818;1511;80;5637;11046
Anthony_revo;Anthony A. ☢;;834;456;23;9725;11038
une_pasteque_;☀️;abreuvé de sciences sociales woke (il/lui);1897;274;48;8800;11019
siizdag;sylvie izdag;Centriste;5240;646;187;4945;11018
HFrancort;Henri Francort;"Au repos depuis 9 ans, je me suis présenté aux municipales.
Merde, j'ai été élu 🤣🤣🤣 Au boulot, feignasse !!!
Pour 2022, c'est Macron et personne d'autre !!!";1012;331;174;9500;11017
michelrocard70;michel rocard;ma biographie;411;1012;145;9448;11016
ChoserotC;Choserot;Maire de Maxéville, Vice-Président Métropole du Grand Nancy, Conseiller Régional Grand Est, Président du groupe Centristes et Territoires (Région Grand Est );4066;3735;2704;510;11015
GouletNathalie;Nathalie Goulet;Conseillère de la Ville, district d’#Ahuntsic, arrondissement Ahuntsic-Cartierville;3488;2352;1569;3606;11015
adomjan;Alexis;Sharing science, Creating web things, Powered by the Sun !;3122;308;180;7404;11014
deaconfinney;Deacon Finney π¦«π·π΄ππΊπ¦;;1329;167;34;9480;11010
rigaud_laurent;Laurent Rigaud;Président de la CMA Hauts-de-France | Vice-président de la Région Hauts-de-France. Mais avant tout, homme de terrain;1433;3052;2029;4494;11008
nourdine69;nourdine;;7033;370;109;3493;11005
rosynicious;Pépite Noire 🇨🇮✊🏾;Community Manager et Blogueuse / Quelques expressions qui me font marrer de ouf: Personnes de couleur, ils ont un accent et on se croirait en Afrique... 😆;9800;126;256;822;11004
PLemouzi;Rhââââ LoOovelyyyy;;7644;723;72;2564;11003
CampusMer;Campus mondial de la mer;The first French maritime innovation community open to the world;5383;646;2548;2423;11000
laurent_hamon;Laurent Hamon;Vice-Président de @metropolerennes en charge des déchets et de l'économie circulaire - Conseiller municipal de #Rennes #Ecologiste #EELV 🌻;3163;1337;1817;4682;10999
phaeli02;phaelio2;anarchisme rap et shitpost m1 capes histoire/geo 2 parce que le 1 a sauté (comme jmlp j’espere 🙏) he/him/il/lui;1303;372;65;9242;10982
SITLevents;SITL Events;Connecting the transport & #logistics community. Tweet about our events #transport, #logistique, #manutention, #supplychain, #RFID. In French and English. #SITL;5244;868;3237;1617;10966
_ELMANOLO_;Roberto Pablito Sanchez;Supporter olympien au cœur Grenat #TeamOM ⚪️Ⓜ️♥️🐉🇱🇻#FCMetz;7205;173;49;3535;10962
SebBillard;Sébastien Billard;Journaliste #Ecologie #Climat à @lobs sbillard@nouvelobs.com;3982;2366;2593;2015;10956
erkassk;Erick J. Kassongo;"Avocat près la Cour/RDCONGO, 
Elaw-US, Legal Team,
Centre Durable, CODED, 
CISDL SDGs, Energy Matters Expert.";2526;5004;1243;2179;10952
sani_kada;M. Sani Kada;L'avenir n'est pas écrit, ça dépend de ce que les hommes feront demain;7129;154;637;3031;10951
FranckMorel1207;Franck Morel;Avocat associé Flichy Grangé @FGAvocats, ex Conseiller social du 1er minist. E.Philippe et de X.Bertrand, Fellow @i_montaigne, del. municipal @HorizonsLeParti;2810;2208;2493;3439;10950
FeMVT;Femmes en Mouvement;Les Femmes dans la Mobilité & la Mobilité des Femmes. Notre mailing list : eepurl.com/c9-XL5. #FeMVT # Notre tribune :bit.ly/3RbuhKZ;2903;1008;2100;4935;10946
DinaKoussou;Dina KOUSSOU;ð¬ð¦ðð¾ââï¸Consultant - #Communication - #PublicRelations - #MediaTraining - #SportsLover - #Writer - #Speaker - #NewLeaderCMF;2030;280;2962;5666;10938
SOLIDEO_JOP;SOLIDEO;Notre mission : construire et livrer les ouvrages et infrastructures pour les #JOP de #Paris2024 et leur héritage / We are the Olympic Delivery Authority;2047;2245;4403;2238;10933
GracchusCaius;Caius Gracchus;;9032;107;48;1742;10929
Greenpeace_Lux;GreenpeaceLuxembourg;"Independent global campaigning organisation acting to change attitudes and behaviour, to protect the environment and promote peace. 
Since 1984 in Luxembourg";4895;897;2471;2659;10922
PonceletOlivier;Olivier Poncelet;DG de l'Union des Entreprises de Transport et de Logistique de France (Union TLF) ð«ð·ðâï¸ð¢ð¤ð;2744;2979;1098;4099;10920
GoloDouTouk;Golo DouTouk;;3561;296;104;6958;10919
sebkoubar;Sébastien Koubar;"Je parle d'investissement et de finance personnelle. 
CEO at @moning_co_fr";959;7;9372;574;10912
AndSoWhat92;AndSoWhat đ«đ·;C'est souvent lorsqu'elle est le plus dĂ©sagrĂ©able Ă  entendre qu'une vĂ©ritĂ© est le plus utile Ă  dire.;8777;53;23;2054;10907
mb_baraka;BARAKA MB;Tweets sur mes activités commerciales et #industrielles en #Afrique. Vente, Fourniture, Maintenance et Services SAV des équipements agro-industriels en Afrique.;2102;2696;1553;4555;10906
LoSplash;Colin;différence ≠ opposition / De retour ici pour m'informer et apprendre des trucs;4886;184;32;5803;10905
houmi_a;Houmi Ahamed-Mikidache;Director. More than 10 years in investigative journalism, Climate Change, Sustainable Development;6422;3197;938;343;10900
NdebaSumaili;SUMAILI N Bienvenuđź’ˇ;"IngĂ©nieur en Ă‰nergie. Je soutiens l'interdisciplinaritĂ©, Ă  condition d'y mettre de la rigueur scientifique. 
Amoureux du đź‡¨đź‡© et du đź‡˛đź‡¦.";3593;263;240;6803;10899
grandin_laurent;Grandin Laurent;Engagé dans l'action collective depuis plus de 30 ans au sein de la filière #fruits et #légumes. Actuellement président d'Interfel;3427;444;901;6124;10896
FIPADOC;FIPADOC;"◤ International Documentary Festival
#Biarritz 20-28 January 2023
The festival of true stories";4338;1220;3297;2036;10891
_Athanos;FKrinner;;3689;475;21;6693;10878
homocommuniste;Pablo 🦕;"Bureaucrate à @SolidairesEtu
                                   
Anciennement @syndinosaure";2096;158;221;8397;10872
Lysiane_Metayer;Lysiane Métayer;Ing. Rech / Députée #Morbihan #565C Commissaire @AN_Defense / Commissaire @AN_AfEur /Présidente GE Industrie Défense / Vice-Présidente GA 🇫🇷🇨🇮 & 🇫🇷🇨🇩;2546;736;1645;5944;10871
Banaste12;Banaste;;6476;49;23;4310;10858
21agenda2030;Agenda 2030 ☦️ 🇫🇷 🇷🇴 🇬🇷;"#OrdoAbChao = #agenda2030=Chaos + #NewAge=Ordo
Odysee : bit.ly/3Jc8qQn
PB:ancien syst.-propagande destruction
Réaction:Chaos,rébellion
Solution:NewAge=Gr.Réveil";1374;3740;2849;2883;10846
AmazoniaCamilo;Camilo T Sanchez;Amazonologo y Ecologo Politico. Biologo Universidad Nacional 1995, Maestria en planeacion del desarrollo UFPA/Brasil , Doctor en desarrollo sustentable UFRRJ.;9761;813;202;68;10844
skymeagle;Asky;;8753;105;111;1872;10841
coquelle_r;Julien Coquelle-Roëhm;Journaliste. Présentateur @RFI Matin le week-end. Passé par @Europe1, @KBIA, @mujschool, @sciencespoEDJ. RT ou liker n'est pas approuver.;3041;773;826;6195;10835
SteveTekaya;TEKAYA SERENE Steve;;5265;68;24;5451;10808
etdoncalors;Etdonc;;10483;49;34;242;10808
RaphDube92;🏴‍☠️Napster🏴‍☠️;Entrepreneur dans le transport,  adore le débat politique.     #polqc;2457;894;2155;5294;10800
Curju;Julie Curien;☆il est dring heure twit twit☆ #librarian #bibliothécaire ressources & publics... 1001 médiations;4653;579;597;4954;10783
lhebdotwitte;L'Hebd'O Orléans;L'Hebdo d'information d'Orléans et de l'Agglo;4574;434;5636;128;10772
vuecartesienne;Lionel;En 2023, les jeunes se prennent pour les révolutionnaires de 68. vivement dans 5 ans, on va retrouver les hippies!;8638;26;127;1970;10761
chachauffedur;ChaudDevant;"Conscient que l'humanité est bien partie pour s'autodétruire.
Sans idéologie ni religion.
S'efforçant juste d'être lucide , factuel et logique.";6963;374;110;3313;10760
AlainHaidon;Alain Haidon;;4635;193;98;5829;10755
PaTaToR78;Da hmed voleur en plastique;"Oui Macron est un ennemi de la France. Le Z est un mytho. 
RIEU est une escroquerie intellectuelle.
Et les wokes pfff quittez la terre svp.";7933;215;53;2546;10747
AntoineTardif;Antoine Tardif;Maire de @VilledeVicto | VP de @FQMenligne | Ancien gardien dans la @LHJMQ | Gradué de @McGillu et @ENAP_Universite;3013;1782;3805;2141;10741
LaurentGuibNice;Laurent Guibert;Conseiller en développement économique, ancien conseiller politique, défenseur du fabriqué en France. Citoyen indépendant, non engagé dans un parti.;2908;3360;2750;1723;10741
EricTshimanga;Erick Tshimanga;"Lawyer (DR. Congo),

Expert in Mining and Business Law; Entrepreneur";2751;3155;1385;3436;10727
BenjaminTeoule;Benjamin Téoule;;4882;1363;1892;2589;10726
CFDT_FGTE;CFDT Transports-Env;Compte Officiel de la CFDT Transports & Environnement.;3416;2404;1769;3134;10723
rererere73;reg26 ð¢;homo sapiens;2174;2673;769;5090;10706
QuebecFier;Québec FIER;Québec Fier est un collectif de citoyens engagés, pour un Québec FIER, FORT et LIBRE. (Photo : la Place Royale et l'Église Notre-Dame-des-Victoires de Québec);6341;349;2303;1712;10705
EchoduMardi;L'Echo du Mardi;Le seul média économique 100% Vaucluse/Provence habilité à publier les #annonceslégales #publicationslégales #appelsdoffres #ventesauxenchères !;7845;2129;706;18;10698
JohnBikeLane;@JohnBikeLane@piaille.fr;"ACAB : All Cyclists Are Beatiful
Bike Hard";6848;94;431;3324;10697
ResistorFR;Resistor;"Victor Hugo: «Vous dites: Où vas-tu? Je l’ignore ; et j’y vais» (cet alexandrin vient d’un livre des Contemplations intitulé… «En marche»!)";4952;1009;259;4473;10693
MTheurier;Matthieu Theurier;Ecologiste @Eelv_Rennes ð» Vice-prÃ©sident de Rennes MÃ©tropole aux MobilitÃ©s et aux Transports @ElusEcoloRennes ð² #Rennes;2315;1527;3461;3381;10684
PApprend;Patrick Learn;J'observe la démocratie 🧐 Quelques infos sont à vérifier ou à suivre, c'est un aide mémoire.;8056;241;161;2224;10682
veille_urba;veille_urbanisme;Suivre les évolutions du fait #urbain #Veille du club info-doc, experts des agences d’#urbanisme du réseau @fnau_urba #planification #carto #data #plui #scot;5953;122;3558;1049;10682
PharmaciendeF;Le Pharmacien de France;;4974;8;5147;550;10679
LDinclaux;Laurent Dinclaux;"Développeur web et webApps , administrateur serveurs et réseaux. Spécialiste PHP, Javascript et Linux.
🐘 @lox@gaiac.io";5175;317;170;5016;10678
FredBesnard;Frederic Besnard;« La société construite sur l'argent détruit les bêtes, détruit les hommes, détruit la joie » - Jean Giono;1174;348;67;9079;10668
ChatCheshire42;Cheshire Cat ð¸ð;Â« Oh mais il n'y a rien Ã  faire... Parce que tout le monde est fou ici. Â» ð¼Prof Ã  lâoccasion (histoire, cinÃ©ma, musique, littÃ©rature, artsâ¦);2041;1467;92;7067;10667
DianeMokaba1;Diane Mokaba;mère de trois beaux garçons;1392;687;554;8032;10665
ReneBourcier;René Bourcier 🇫🇷 🇪🇺 🇺🇦 🇸🇪 🇵🇸;"« … La liberté est le droit de faire tout ce que les lois permettent… »
(Montesquieu, 'De l’Esprit des lois', 1748)";7249;369;74;2968;10660
alauneht;A la Une;actualités;1968;347;6192;2149;10656
Lafarge_Canada;Lafarge Canada Inc;Official page of Lafarge Canada Inc. #BuildingProgress for people and the planet. Lafarge Canada is a member of @Holcim Group.;2716;1293;4434;2207;10650
Avel_sterenn;Marie;2 Chats, 1 Tambour ð¥, 1 Grenouille  ð¸.;2667;456;238;7282;10643
prodiss;PRODISS;#PRODISS - Premier syndicat patronal du spectacle vivant privé en France - 400 adhérents #SpectacleVivant #Culture #Producteurs #Diffuseurs #Salles #Festivals;2936;1149;4573;1984;10642
MickaelGillot;Coukaratcha / クカラッチャ;"Dev Web/Mobile & Solutions Cloud #freelance | Je fais de la broderie 🪡 et du speedrun 🎮 | Pronoms : il/lui |
Mastodon : pouet.mickaelgillot.xyz/@Cou…";2153;204;84;8196;10637
xpressx;Pascal;Photographe passionné aimant les défis. Un projet Photo sur PARIS et Région parisienne 🇫🇷 me contacter.;8931;513;313;877;10634
FredAst10942086;FredAstaire;;932;164;29;9509;10634
cv427;clo;;4201;450;41;5941;10633
ChristineRk83;Christine RK;;5923;89;87;4532;10631
EmilioLado;Lado Emilio đź’™đź’›;Rances - 2 terreurs Ă  la maison đź‘¨â€Ťđź‘©â€Ťđź‘¦â€Ťđź‘¦đźŹ  PrĂ©sident @lecentrevaud - Directeur PME - Membre du #kiwanis - Ancien prĂ©sident @Fcrances - PassionnĂ© dâ€™Histoire;5786;816;510;3513;10625
disappointndude;tloz brainrot;sozi tech junge;5695;78;73;4766;10612
architectes_idf;Ordre Architectes IDF;Compte officiel de l'Ordre des architectes d’Île-de-France • #ReparerLaVille;2949;2039;3855;1763;10606
LeseulG;Gérard Leseul;"• Député de la 5e circonscription de la Seine Maritime @socialistesAN
• Militant des coopératives pour une économie sociale et solidaire #ESS #Environnement";1759;913;2522;5411;10605
ProStp;Steph Pro;Proprio d’un vieux 10 roues,d’un bowling et Black Metal songwriter.🤘🏻👹;3522;174;127;6781;10604
nesrineparis;Nesrine;Master Droit privé Assas. Présidente Co-fondatrice Association #Talents15 #ESS#entrepreneuriat.      Co-Fondatrice start-up Resaam #santé🚑 #StationF#innovation;631;1138;393;8435;10597
tomlaigle;Thomas Laigle;"Ingénieur pédagogique à @EnsaTlse. 
#Innovation, #Pedagogie, #Formation... et depuis peu #Architecture !
Trésorier du prix Écrire la ville.";4920;547;1813;3314;10594
HachetteEduc;Hachette Education;Éditeur spécialisé dans la publication de manuels scolaires, d’ouvrages de révisions et d'outils numériques pédagogiques. #édition #éducation #numérique;4917;356;4010;1308;10591
katedhiggins;Kate Higgins;CEO • directrice-générale.  Fière de travailler @Cooperation_Ca. Working with others for a fairer, safer and more sustainable world.;2596;1341;2322;4321;10580
sylvain_roche;Sylvain Roche;PhD @univbordeaux - Project manager #ChaireTRENT @ScPoBx - Associate Teacher & Research Fellow @CEDurkheim @BordeauxINP @AcclimaTerra #EnergyTransition ð¡ðð;2649;510;604;6816;10579
saracetamolll;🧚‍♂️;-19-;6127;138;135;4172;10572
GouvNC;GouvernementNC;Bienvenue sur le compte officiel du Gouvernement de la Nouvelle-Calédonie. Livetweets à suivre sur #DirectGouvNC.;3429;90;7045;8;10572
TAAFofficiel;Terres australes et antarctiques françaises (TAAF);Compte des Terres australes et antarctiques françaises #TAAF #Antarctique #OutreMer -  #Eparses #Amsterdam #Crozet #Kerguelen #TerreAdelie - #MarionDufresne;1884;245;8014;421;10564
MonLhuillier;Monique L'Huillier;;9171;296;42;1053;10562
intermatparis;INTERMAT Paris;"The sustainable construction solutions and technology exhibition. 
ðï¸ 24-27 April 2024";3357;1739;3652;1804;10552
frededlens;Frédéric LAURENT;@eConsultingRH & #recrutementstartup - Agent de #Talents ! - Fan irrationnel du #RCLens Compte personnel 😉;5866;574;649;3461;10550
VentDebout59;Vent DEBOUT;Le collectif Vent Debout se dresse CONTRE le projet Eolien en Mer de Dunkerque. Nous voulons DECIDER nous même de l'avenir de notre plage par un référendum !;3031;686;688;6133;10538
Anthony__Cortes;Anthony Cortes;Journaliste. Auteur de « L’affrontement qui vient. De l’éco-résistance à l’éco-terrorisme ? » et du « Réveil de la France oubliée » (ed. Rocher, 2023 et 2021).;3747;1766;2207;2805;10525
delsert_claude;Claude Delsert;;6929;293;50;3242;10514
innocentagakhan;Innocent Agakhan kul;"- Candidat à la députation nationale Nord-Kivu 2023
-Jeune leader de l'Est , 
-Directeur Provincial Technique CIC-Nord Kivu
-Dir de Marketing Kivu Fashion Week.";1469;4930;1129;2982;10510
FelixFaure6;Felix Faure;J'ai une incapacité à percevoir l'existence de ceux qui cherchent à se faire remarquer.;3154;65;37;7245;10501
ThierryBOURDIL1;Thierry BOURDILLON;Chargé d'Affaires Entreprises Innovantes;8828;189;254;1229;10500
Fahadalrwaily;Fahad Alruwaily;سفير خادم الحرمين الشريفين لدى جمهورية فرنسا Ambassadeur du Royaume d’Arabie Saoudite en France;2405;287;6611;1196;10499
EcoloGaucho;Déodorant31;"Je vais bosser à vélo, donc je transpire des aisselles...

Ecolo bobo islamo gaucho assumé... Merci du compliment...

Humaniste sensible à mes heures perdues";9028;124;76;1270;10498
JeannotMbaya;Jeannot Mbaya ð¨ð© MD;"Congolais debout/ Docteur en mÃ©decine humaine.
Patriote engagÃ© pour un Congo nouveau. Membre effectif 
de la Copop/ ÃvangÃ©liste NCD ð¨ð©";6149;508;248;3586;10491
LEPETITSteph;stephane LEPETIT;Adjoint au Maire de Lille,  chargé du Quartier de #VaubanEsquermes.;4380;650;826;4620;10476
Hceres_;Hcéres;Haut Conseil de l'évaluation de la recherche et de l'enseignement supérieur;1592;188;8468;221;10469
EcoSavMontBlanc;EcoSavoieMontBlanc;;8235;446;1687;93;10461
litkrz;๐๐๐๐๐ด๐น๐ด;;2662;690;372;6737;10461
AminBrimou;Amin Brimou;Adjoint au Maire en charge de l'Éducation, de la Jeunesse, de l’Engagement & de la Démocratie de Proximité - Mairie de Saint Pierre Des Corps;8290;1178;410;576;10454
BabesiaCanisHR;đ;;3331;151;47;6921;10450
kamsdello;Ibasyller;;5198;738;83;4431;10450
HmmCactuss;Cactus |;;3816;84;66;6484;10450
la1erelive;Outre-mer La 1ère Live actu;Le live permanent d’Outre-mer la 1ère;10316;14;98;0;10428
john_mac_steel;Camarade John Mac Steel;Auvergnat et membre du FLA. Marxiste et Universaliste. Psychonaut à mes heures perdues.;3151;282;54;6937;10424
CelsaAlumni;CelsaAlumniNetwork;Helping you stay connected with your University and other Celsians, wherever you are in the world! #celsa #celsaalumni;2419;846;2292;4865;10422
Theresebababibi;Thérèse;Politologue;1213;3559;2265;3384;10421
France_OACI;La France à l'OACI 🇫🇷‏;Représentation permanente de la France au Conseil de l'Organisation de l'Aviation Civile Internationale @OACI. French permanent mission to @ICAO #Aviation;3552;252;2666;3949;10419
MediapartBenin;MÉDIAPART BÉNIN🇧🇯;"Magazine numérique d'informations, d'analyses, d'investigations et de publicité
Tél: +229 90 25 08 55 E-mail: mediapartbenin@gmail.com / info@mediapartbenin.com";8763;237;1387;29;10416
jopopo25380069;leny-bar;t'es un bon toi ! oui toi !non je rigole t'es a chier 🤣;7004;172;12;3226;10414
Gilletviolaine;Gillet Violaine;#ps71  BN SN élue #Gergy;4013;629;671;5094;10407
pageimpaire;Rafaelle Raffaele;"livres, poésie, édition, focus #Liredesfemmes et #Liredesindés avec
#Queermaginaires #PastillePoétesse #PageImpaire et d'autres
(pp @ravenquarts)";3712;227;168;6299;10406
franceinfogen;Franceinfogen ðŸ‡«ðŸ‡·;Toute l'actualitÃ© en France - nouvelles, Ã©conomie, politique, culture.;3312;413;4267;2413;10405
Voirvert;Voir Vert;Le portail du bâtiment durable au Québec;5868;677;3621;237;10403
Observ_ER;Observ'ER;Observatoire des énergies renouvelables. Baromètre européen des EnR. Publications : Journal des #EnR, Journal du #Photovoltaïque et Journal de l’#Éolien.;4069;1452;4369;509;10399
JM78394748372;ML;đȘđșđ«đ·;3887;3080;52;3378;10397
mice8664;Mice ð¨ðµð¥x5 ð¡ï¸37,5Â°;Aime la Politique, mais ni de Gauche, ni de Droite ! Juste pour le bon sens, et pour le peuple vivant en France. Compte qui dit des dingues;3182;266;55;6876;10379
InVivo_Silos;InVivo Logistique & stockage ð½ð¾ â´ð;#InVivo Logistique&Stockage assure la gestion de 1,5M de tonnes de capacitÃ© rÃ©parties sur 12 #silos en France ð«ð· ðð»#logistique #grains @BiolineByInVivo #3VA;3961;1093;1500;3817;10371
ONUCotedIvoire;Nations Unies Côte d'Ivoire;Compte du Système des Nations Unies pour le Développement en Côte d'Ivoire. Réunissant les entités @UN pour contribuer à l'atteinte des #SDGs;1416;376;3647;4929;10368
AJCHistoire;AJCH;L'Association des Jeunes Chercheurs en #Histoire assure une veille des postes, bourses, prix et appels - Fils - Compte tenu par Ivan Burel.;2699;1156;5252;1261;10368
GeoffreyCaillon;Geoffrey Caillon;Coordinateur CFDT TotalEnergies                     Délégué Fédéral FCE CFDT #EnergieCollective #cfdt #syndicat #TotalEnergies #syndicat #transition #énergies;4951;1154;784;3477;10366
LaVoixacadienne;La Voix acadienne;Journal de langue française de l'Île-du-Prince-Édouard;9020;115;1220;8;10363
Eshyit;Justin 🍃🍄;Empereur du caca lol, baron du zizi cul;6830;553;182;2796;10361
ville_albi;Ville d'Albi;"Compte officiel de la Ville d'#Albi.
đ°Retrouvez ici toute l'actualitĂ© albigeoise !";4129;227;3214;2789;10359
One1Shoter;simon Phoenix;aux pro-vax, je répond avec les articles 16-1 à 16-3 du code civil.;4731;1032;729;3867;10359
davekashala13;David;MBA in Entrepreneurship, BTech in Project Management, National Diploma in Marketing, Researcher, Consultant, Writer, Thinking Head, Patriot, Helper;2386;1008;1376;5588;10358
aestiv;Les Jardins d’Aestiv - Benoît;Ingénieurs agriculteurs @isaralyon, #élevage #aubrac HBA, #céréales 🌾, #oléagineux 🌻, #protéagineux 🌱, #bio, #agroécologie, #intercropping ☘️ #ventedirecte;4285;913;1323;3837;10358
Groupe_ESEO;ESEO;Grande Ecole d'Ingénieurs généralistes Angers - Paris-Vélizy - Dijon. Objets et systèmes intelligents d'aujourd'hui et de demain ! #innovationMakesSense;5138;434;2851;1918;10341
FreireIker1;Iker Freire;đź’™đź¤Ť đź‡«đź‡·đź‡Şđź‡ş;8587;128;25;1601;10341
Oxydemor;Richard Lepovre;;10031;21;76;207;10335
LectureJeunesse;Lecture Jeunesse;Agir avec vous pour développer la lecture et l’écriture des adolescents;4565;691;4241;834;10331
pastisdonatello;Don arrabiato;Célèbre sculpteur de la Renaissance, ninja, expert en maniement du bō;2477;1115;117;6613;10322
mrsaittout;Mr Nouvelle;;4613;1219;132;4355;10319
MAGALIXTOUPE;Magali ALIX-TOUPE;"Facilithacktrice PassionnĂ©e #dive #innovation #Techforgood #cleantech #mobility đ; CEO #leMansTech #lafrenchtech #lemans";6485;1045;653;2127;10310
FranceHydrogene;France Hydrogène;"Association française pour l'#hydrogène et les piles à combustible (ex @Afhypac) 
#Transition #Climat #Energie";2804;242;4340;2920;10306
Bdn_91;BDN ✌🏾👨🏾‍🎤;;1518;27;16;8730;10291
PNUD_Comores;PNUD Comores;Le PNUD travaille avec ses partenaires aux Comores pour un développement durable, inclusif, résilient face aux crises et aux effets du changement climatique.;1217;3048;4619;1406;10290
ENERPLAN;ENERPLAN;Compte officiel d'Enerplan, syndicat français des professionnels de l'énergie solaire PV et thermique depuis 1983;3380;238;4712;1945;10275
INRAE_Corse;INRAE-Cirad Corse;ðð²ð»ðð¿ð² ðð¡ð¥ðð ð±ð² ðð¼ð¿ðð²  - Insta Inrae-Cirad Corse. Eccu ! ghjÃ¨ u mo travagliu, sÃ² a u serviziu di a ricerca in Corsica una passione.;2018;1078;1166;6010;10272
latimer_danny;Daniel Tremblay ⚜️;Pas woke mais surtout pas complotiste.. Détestant les extrémistes de gauche et de droite. Supporteur de l’Ukraine libre.;4510;1675;379;3707;10271
InterTV5;Internationales;Le grand entretien sur l’actualité du monde présenté par @francoisejoly et @antoinegenton sur @TV5MONDE en partenariat avec @lemondefr #Internationales;2882;1674;5372;340;10268
GermainBuck;Germain Bukasa, MD;"Physician,
interessed by Cardiology and  Nephrology. Researcher  in machine learning , epidemiology and clinical statistics.";8630;585;140;913;10268
Africangels;Africangels;Business Angels Entrepreneurial;5378;544;2588;1752;10262
antoine_tissier;Antoine Tissier;Vis simplement pour que d'autres puissent simplement vivre;2189;1329;557;6186;10261
bernardvachon1;Bernard Vachon;Géographe. Ph.D. Professeur honoraire Université du Québec à Montréal. Spécialités : amén. du terr., dév. local et rég. et Québec rural. Auteur et conférencier.;7573;331;706;1648;10258
ntsbmxlive;hu_lens;PHAROS est mon ami. White hat hacker à temps plein…;2564;786;26;6880;10256
Institut_EGA;Institut EGA - IEGA;Institut d’études de géopolitique appliquée | Débat public • Recherche scientifique • Formation | secretariat@institut-ega.org;6205;194;3018;837;10254
GouvernementHK;Gouvernement du Haut-Katanga;"Bienvenue sur le compte officiel du Gouvernement provincial du Haut-Katanga.
République Démocratique du Congo";2075;58;7264;851;10248
Maireinfo2;Maire info;Maire info, newsletter quotidienne d'information à destination des élus et des collectivités. Éditée par l'#AMF. #collterr #maires #communes;5211;864;4154;13;10242
undeuxtro1scat;Undeuxtroiscat | Suiswap IDO 06/03 🐐🛸;Chasseur d'airdrop 💫 Investisseur crypto/Bourse/Token immo 🔥Technicien Node 🎖️Defi 💰Stacking 💸;3141;436;25;6637;10239
LaurentESQUENET;Laurent ESQUENET - GOXES;đ«đ· DĂ©putĂ© du #Lauragais | @DeputesDem Ă  lâ@assembleeNat | Grpes âïž đ°ïž &đšâđCommission @AN_AfCult #Cultuređ #Education | DĂ©lĂ©guĂ© @MoDem 31 | #circo3110;3771;1015;1367;4072;10225
Ceoff88;vivlafrance;đȘđșđ«đ·;6791;125;76;3226;10218
KAWINIMUNDO;CHANTAL BERGEZ ⭐️ Le bonheur dans la créativité;"Autrice de 
L’ERE DE LA CRÉATIVITÉ et de KAWINI MUNDO
On a les outils pour concilier économie et écologie avec intelligence.";2918;456;226;6617;10217
sappiotti;Sébastien Appiotti;Maître de conférences en communication au @CELSA_Officiel - Sorbonne Université • Photo • Publicité • Numérique • Musées • Médias;4358;728;1509;3619;10214
LNDM1;Les NOUVELLES des MUREAUX Seine&Vexin;Site d'actualités sur les Mureaux et Seine&Vexin depuis 2009 #actus #sports #cultures #asso #infos #lesmureaux #gpseo #LNDM #webtele2r @CUGPSEO @les_mureaux;8167;578;571;897;10213
gdcurieux;hosek;Adepte de la reinformation;9050;40;30;1087;10207
MrSerlito;Serlito;đŒđŒhackeur compulsif, rayonnant (au delĂ  de 5keV),  nĂ© ingĂ©nieur, physicien spĂ©cialisĂ© dans les rayonnements. Travaillant Ă  temps partiel pour le lobby âąïž.;8325;205;39;1629;10198
JJBatardiere;JeanJosephBatardière;Délégué général @CPMEPDL Défense #TPE #PME @CPMEnationale mes propos n'engagent que moi 🤔✊🙏;2977;689;817;5713;10196
jenmerdekan;Idriss Jenmerdekan;;3172;52;17;6955;10196
veloradiofr;Vélo Radio;"La radio francophone dédiée au vélo et aux nouvelles mobilités
Internet, applis, podcast
#velo #mobilité #vélotaf #velopourtous #VAE #radio #bicyclette #cycles";9064;644;368;111;10187
brunobensasson;Bruno Bensasson;Fil de Bruno Bensasson, Directeur Exécutif Groupe @EDFofficiel, en charge du Pôle #EnergiesRenouvelables et PDG @EDF_RE #EnR #climat #triathlon #kite #économie;2379;542;1977;5285;10183
enedis_rhod;Enedis en Sillon Rhodanien;@Enedis - Départements 01 (#Ain), 69 (#Rhône), 42 (#Loire), 26 (#Drôme), 07 (#Ardèche) #ServicePublic #TransitionEcologique;3591;2126;2783;1682;10182
thecresus11;CRESUS;Gestion de Patrimoine - Immobilier, Finance, Fiscalité 🏦 J’aide les pauvres à devenir moins pauvres, et les riches à devenir plus riches 😁;2998;267;6056;859;10180
Essai65130488;Un quidam;;1598;109;16;8457;10180
OptionConso;Option consommateurs;Organisme à but non lucratif qui aide les consommateurs et défend leurs droits depuis 40 ans. 👩🏻‍⚖️ 📕;2807;1632;5343;396;10178
ZiyadAlmaghribi;۞ Al Mansour ۞🇲🇦🏁;۞ 🇲🇦المغرب اولا ولا غالب الا الله ۞ 🇲🇦۞ Moorish Nationalist Right-Wing ۞;5615;126;2593;1839;10173
EonetJean;EONET Jean-Yves;;6204;22;57;3889;10172
Min_Interieur;Ministère de l'Intérieur du Sénégal;"Compte officiel du Ministère de l’Intérieur du #Sénégal 🇸🇳
#kebetu";598;18;9543;4;10163
Ogrego7;Ogrego;"Le manque de savoir détruit la vie. Antivax complotistes, extrémistes et pro-poutine passez votre chemin.
@ogrego@mastodon.top";2789;239;36;7097;10161
Hyvolution;Hyvolution;Les acteurs de l’hydrogène en France et en Europe se retrouvent du 30 janvier au 1er février  2024, à Paris, Porte de Versailles ! #salon #hydrogène #énergie;5184;342;2033;2600;10159
FaklerEben;Eben Yaakof Fakler;Pas de ce monde...;5074;239;65;4778;10156
OlivierFJB;Olivier Blond;Délégué spécial santé environnementale @iledefrance / Président @Bruitparif / @InstitutBrunoy / @UnivCathoParis / #EcologieDesSolutions #Air #Bruit;2373;1225;2240;4315;10153
Ds33850248;Ds;"Le bruit ne fait pas de bien, le bien ne fait pas de bruit

Pense en dehors de la boîte";5958;248;35;3911;10152
lemaym91;Mathieu Lemay;Freelance Political Analyst | Specialize in Canadian & American politics | Retweet ≠ endorsement;6283;602;484;2781;10150
ici_just;La Fils2Puterie;"Mes messages n'engagent que la #fils2puterie qui rĂšgne sur la đ«đ·  le  Capitalisme.
De lâĂ©ducation populaire Ă  la domestication par la culture-novlangue *
#BZH";3295;285;133;6428;10141
MarianneBoust;Marianne Boust;#Renouvelables #Stockage #Digital #WomeninEnergy #Marseille #Velotaf mum of 3;3892;763;897;4583;10135
bepositiveevent;Salon BePOSITIVE;"#BePOSITIVE : Le salon national de la transition énergétique
📌  du 25 au 27 mars 2025.
📌 Eurexpo Lyon";4523;1260;2109;2241;10133
Gypsyman_Qc;Pierre Vaillancourt;;3887;704;247;5294;10132
Maikistars;Михаил Теплюков;"🇷🇺 🇷🇺russe d origine, tout pour ma patrie.
chacun pense ce qu'il veut, mais qu'il ne me casse pas les burnes. 🇷🇺🇷🇺
Sinon game over. anti-occident.";4498;1062;1068;3503;10131
TRM24fr;TRM24;Site d'actualité Transport Routier;8328;135;1576;83;10122
MauzeGreg;Gregory Mauzé;"Politologue et journaliste.

Attac Bruxelles % & Association belgo-palestinienne🇵🇸.

Co-président de la CNAPD.

Palestine/Politique/Anti-imperialisme.";2449;595;639;6437;10120
FougeresThomas;Thomas Fougères;Love history, international relations, foreign languages, birds, trains, rugby and a lot of other things. Try to be funny from time to time.;8156;1060;114;785;10115
UnivCathoOuest;UCO;Université catholique de l’Ouest | Angers, Guingamp, Laval, Nantes, Vannes, Papeete, La Réunion, Niort;3203;271;3865;2776;10115
BellettreG;Gérarementplusbeau;Et pourtant elle tourne! globe-trotter toujours prêt à repartir. Gérant. ECP;5069;3001;800;1240;10110
natsilbert;Nathalie Silbert;"Journaliste @LesEchos
Economie Conjoncture France
ex Enquêtrice";6187;567;1222;2133;10109
LH3G_;LH3G ☀️🏈🛻;Curieux de nature, je trouve toujours l’arnaque. Cherche la clé de la loterie EB-1. Follow me, I follow back;5473;288;96;4248;10105
UDESnationale;UDES;L'Union des #employeurs de l'#ESS est l'organisation patronale multiprofessionnelle de l'économie sociale | #DialogueSocial #EmploiESS #ProtectionSociale #QVT;4328;195;4745;829;10097
Yanon68;Yanon68;1% dirige le monde, 3% sont les marionnettes, 91% dorment, 5% connaissent la vérité... Les 1% utilisent les 3% pour empêcher les 5% de réveiller les 91%.;4034;2236;2900;925;10095
Olivierbeining;"Olivier ""Ares Revenu Passif"" 💵";⚔️Je brise des chaînes | Consultant Blockchain et C.I.F. Certifié - AMF en cours | Business - Investissements - Minage Crypto;6600;197;1721;1559;10077
AlfredMacLeod;Alfred Mac Leod;Nous devons respecter notre hôte LA TERRE!;1396;1260;235;7181;10072
mistysmog;JP🇨🇦;Mountains and rivers... places where time doesn't exist. No known allergies other than to stupidity and idiots...for which there’s no cure...or vaccine;9111;243;90;620;10064
juuulo_;〰 πxel;;1799;429;48;7786;10062
Uzanavant;jacqueline-élise uzan#Insoumis #AEC #6eR anti fafs;ILS SONT DEBOUT PARCE QUE NOUS SOMMES A GENOUX;4538;1355;1392;2776;10061
unsa_cese;Groupe UNSA au CESE;Compte officiel du groupe #UNSA au Conseil Économique Social et Environnemental #CESE #syndicat #dialoguesocial #DirectCESE #actualité #news #newsletter;4441;1321;1012;3282;10056
LaRBQ;RBQ;Notre organisation est reconnue pour son engagement et sa contribution dans le domaine du bâtiment et des installations. ow.ly/a6CK50EnL03;4544;1326;3655;529;10054
FabriceTTG;ALSIC;;4028;3747;199;2072;10046
FaberFeliciani;Fabrizio Feliciani;UNOPS Regional Director for Latin America & the Caribbean | #FairPublicManagement to achieve the #2030Agenda | Personal Account;2893;1050;1158;4943;10044
Calo_invest;Calo | L'investisseur libre;"Apprenons et partageons ensemble sur l'investissement, l'entrepreneuriat et les finances ð°ðª

Entrepreneur et investisseur de 28 ans ð§ðª";2538;270;1594;5640;10042
MessirrK;KM;Mes tweets n'engagent que moi. Je suis pour l'égalité femme homme, pour que chacun s'épanouisse, contre les généralités, le racisme, le harcèlement.;2676;67;6;7292;10041
valentinheckets;Valentin Hecketsweiler;Mi-geek mi-bobo et avocat en droit de l'environnement ð / Je passe mon temps Ã  parler droit administratif et Ã  jouer Ã  LOL;5511;1223;619;2685;10038
ChristelCournil;Cournil Christel;Professeure en droit public - Sciences Po Toulouse - Tweets sur les droits de l'Homme & l'environnement...#justiceclimatique #laffairedusiecle;1870;3426;1481;3248;10025
Pety1021;Mandiaye Pety Badji;self-made-man;3996;1030;910;4074;10010
EveilH;Eveil Homme;Magazine d'informations nouvelles fréquences : Extraterrestres Galactiques Spiritualité Divulgation;8302;29;1341;329;10001
enshort_tamer;tamer enshort;Chasseurs de trolls, débusqueur de comptes lepenistes maquillés en faux comptes communistes ou faux - LGBT ..  quete et enquete de VERITE;6499;360;42;3090;9991
gracewasolua;Grass Wasolua;Entrepreneur ,Consultant     CEO Hand Tech Sarl énergies renouvelables ODD. Lys Services consulting Jesus⭐️;2939;1211;379;5461;9990
MidiLibreLunel;Midi Libre Lunel;L'actu de Lunel sur Twitter !;7292;346;2318;24;9980
Le_Bot_des_CP;Le Bot des communiqués de presse ministériels;"Je tweete chaque communiqué de presse ministériel. 🇫🇷
Développé par @5up3rs0n1c
Actif de 5:00 à 23:00 🤖
ko-fi.com/le_bot_des_cp ☕";8718;1;1255;6;9980
MySweetimmo;MySweet'Immo;"đź¦‹ MĂ©dia dâ€™actualitĂ© avec vue Ă  360Â° sur lâ€™immobilier.
đź—ť Interviews, news, conseils, podcasts, dossiers...
đź‘‰ by @ArianeArtinian";6251;557;2920;247;9975
l_margueritte;Louis Margueritte;"Député Renaissance de la 5ème circonscription de Saône-et-Loire 🏛🇨🇵🇪🇺

                                           Président de Renaissance 71
#AvecVous";2691;2239;2798;2239;9967
mariernsn;Marie Rnsn;;3795;194;63;5914;9966
gjfrichard;g.jf.richard;"Développeur Web. Partageur de bonnes pratiques.
Très curieux de nature, j'adore les news insolites";7076;1270;1015;595;9956
FranceaDjeddah;La France à Djeddah 🇫🇷 🇸🇦;"Consulat général de France à Djeddah 🇫🇷 🇸🇦
Consulate General of France in Jeddah 
 القنصلية العامة الفرنسية بجدة";2478;174;3453;3850;9955
ImperiumMarche;Pieśń;"Soigneur, Jeune Fauconnier, Chasseur et Effaroucheur.
Futur piégeur.

Rôliste invétéré, adepte du factuel. 

Un 🇮🇪🇨🇵 🇩🇪   matelot 🇷🇺🇺🇦

🏳️‍🌈 
♿ 
Dys";8880;209;237;627;9953
CVK2023;Charles VILA KALALA;Président de la Fondation Les Ami.e.s de la République @lesamiesdelarep;1988;1;900;7060;9949
HociZen;Hoci zen;;2825;29;67;7025;9946
sophie_sarraute;Sarraute Sophie;IA-DAASEN des Bouches-du-Rhône;594;756;981;7613;9944
HKS_hubahup;M8 Huba;19 đ«đ· | prĂ©pa hec | Haig handball đ€Ÿđ»ââïž footix professionnel;3189;139;53;6557;9938
DocteurNon;Docteur Non;Un tweet matin et soir, ne pas dépasser la dose prescrite sans avis médical.;1218;163;19;8538;9938
eric_duhayon;Eric Duhayon;"Passionate about technology, philosophy, and programming. ""The present moment has one advantage over every other: it is our own.""";4231;516;52;5131;9930
MaxArmiaKrajowa;Max ⭐️⭐️;économie, écologie, Chine - Taiwan, PSG . né à 358ppm, retraite à 67 ans, taux d’imposition réel à 60%, titi donc tutoie;4767;519;461;4177;9924
ecololyonnais;Écolo du 69 🇨🇵🌍;"Écolo à vélo, pétrole hater et Lyon enjoyer.
Master de physique - Ingénieur.
Municipaliste libertaire 🏴";596;367;431;8529;9923
CPromodul_INEF4;Cercle Promodul / INEF4;Fonds de Dotation œuvrant à la réussite des #transitionsEnergétique #environnementale #numérique du #bâtiment pr l'#InteretGeneral #confort et #santé occupants;6303;1551;1532;532;9918
tribune_l;LA TRIBUNE DE L'HOTELLERIE;Portail actualité de  l'hôtellerie internationale pour les cadres dirigeants | Hospitality News for Executives;9750;46;110;6;9912
fdescrozaille;Frédéric Descrozaille;🏛️ Député #Renaissance du Val-de-Marne #circo9401;1798;1349;5926;839;9912
MazikeenSmith70;Maze 🚺♈️🇮🇪🇨🇦🇨🇭🐾❤️🗽✈️📚✍️🌾 try to🧘‍♀️;~ COVID pandemic was a lie ~ Lobby woke : stop ~ Out NWO, WEF, WTO, WHO, NATO, NAFTA, etc. ~ Ultimate goal : individual sovereignty 4 all🗝🕊~ Green lobby : NO;1228;1622;546;6512;9908
NicoStallivieri;Nico Stallivieri đ«đ·đ©đȘ;#HH #Hambourg #Allemagne đȘđșđłïžâđ đâ€ïž #Social-#Ăcologie âą #TechForGood âą FranĂ§ais du Monde;3398;2001;1375;3128;9902
AudreyHenocque;Audrey Hénocque;1ère Adjointe au Maire de Lyon @gregorydoucet, en charge des finances, de la commande publique et des grands évènements - Ecologiste;2049;469;3818;3562;9898
AMRAE_officiel;AMRAE;Association pour le Management des Risques et des Assurances de l'Entreprise | 1500 membres | + de 750 organisations;5547;482;2674;1193;9896
francoisnormand;François Normand;Journaliste économique, analyste géopolitique, MBA, CCVM, historien de formation.;5895;1525;2138;337;9895
TKerlirzin;Thibault Kerlirzin;Fais ce que dois, advienne que pourra.;3290;166;1090;5342;9888
WorkWallis;WorkWallis / WorkValais;Follow #WorkWallis or #WorkValais for #jobs in the #Valais #Wallis. - WorkWallis ist das Walliser Jobportal. WorkValais est la bourse d'emploi valaisanne.;6795;247;140;2705;9887
RobyAgathe;Agathe Roby;Conseillère municipale #LFI #Toulouse /Coprésidente @GroupeAMC / #NUPES #circo3103 Pour l'Histoire c'est là @AgatheRoby;2310;1025;2948;3600;9883
Ch_Pires;Christine Pires;Professeur d’espagnol en CPGE ECG et ECT;2639;395;406;6442;9882
MMichemail;Miche Michemail;;4558;57;45;5210;9870
susie_dutch;Susie Dutch;À un détail près;3734;0;0;6129;9863
jmvalantin1;Jean-Michel Valantin;Jean-Michel Valantin, (PhD Paris) leads the Environment and Security Department of The Red (Team) Analysis Society.;7472;1457;775;159;9863
AcGuadeloupe;Académie de la Guadeloupe;Compte officiel de l'Académie de la Guadeloupe;1820;454;4517;3069;9860
PolentaJ;Polenta Jones;"""On va tous mourir, alors pourquoi être méchant ?"" Cheick Diabaté";5097;239;109;4414;9859
SteMetropole;Saint-Étienne Métropole;Le twitter de Saint-Étienne Métropole.;2910;846;4844;1253;9853
AmonJoh38893274;Amono appiah;tireur d’élite , punchlineur, Afro réaliste , amoureux de la vie, entrepreneur. 🇨🇮 Le culture Akan coule dans mes veines .;3025;192;152;6480;9849
CometByExtia;Communautés Métiers by Extia;Conférences, Meetup® Events, talks, sur : #Dev #Agilité #FeelGood #Makers #Java #IT #Indus #BIM et plus ! 🚀 En visio & gratuits 👉 Les Comet' by @extia_conseil;1348;3119;4367;1013;9847
hamster59735580;hamster;la liberté pour mes enfants ,61 piges résistant jusqu'au bout;6480;288;64;3012;9844
contantchris;Christophe Contant;;3349;138;19;6336;9842
jnitengale;boulanger;infirmier retraité,  intérêt pour  politique, justice sociale et sanitaire;8358;880;192;402;9832
Ethan9975;איתן;"🌈✡️✌️🌎

22yo";1811;212;92;7716;9831
MawandzaJ;MAWANDZA Max Jerry;libre et de bonnes moeurs;1271;1391;177;6986;9825
J_MulumbaRDC;Jonathan MULUMBA;Ambassadeur universel de la paix pour la côte Afrique-RDC |  Universal Ambassador of peace for the africa-DRC coast | #JW;3758;1151;723;4184;9816
Banque_TD;TD (Canada);Gardez le contact avec des gens réels chez TD, 7 jours par semaine, de 6 h à 23 h HE. Notre avis juridique : go.td.com/1s6ZfHT;2737;354;5370;1355;9816
UNESCO_Maghreb;UNESCO Maghreb;Organisation des Nations Unies pour l'éducation, la science et la culture. Bureau pour le Maghreb;2478;654;5483;1199;9814
NicolasGomart;Nicolas Gomart;Directeur Général Groupe @Matmut Vice-Président SGAM @Matmut Vice-Président @Matmut SAM Vice-President FNMF @mutualite_fr #Prévention #Solidarité;2165;318;4437;2889;9809
LeBoursicoteure;L’investisseur long terme;🇫🇷 25 ans 😍 Passionné d'investissement (bourse, crowdfunding, immobilier physique..) ! ✍️ Je réalise un thread chaque semaine axé finance/investissement.;1685;29;5640;2455;9809
DoZgeek;DOZgeek ð²ð«;"Comic Artist / Director / Artwork supervisor - AElementworks /
TV42";4950;247;74;4536;9807
ADUMONTIER60700;DUMONTIER Arnaud;"Maire de Pont-Sainte-Maxence
Président de la CCPOH
Conseiller départemental de l'Oise, canton de Pont-Sainte-Maxence
Ne lis jamais les commentaires";7049;226;2526;3;9804
eelvNPdC;EELV Nord-Pas de Calais;Europe Ecologie Les Verts en Nord-Pas de Calais ð»  #EELV #NPDC;4575;1002;3217;1010;9804
dialogueCHN_FRA;Dialogue Chine-France;Compte de la revue Dialogue Chine-France,  un pont reliant les peuples sino-français pour contribuer aux échanges et coopérations entre ces deux pays.;6920;907;1363;611;9801
MarianneGM_Seck;Marianne Seck;"Conseillère Régionale @InsoumisHDF
#HautsDeFrance #Oise 
Animatrice du GA des Bellovaques Insoumis #Beauvais";1293;469;1154;6885;9801
Robin_Salecroix;Robin Salecroix;ð¦ Vice-PrÃ©sident de @NantesMetropole en charge de l'eau et de l'assainissement / Ãlu @villeNantes - SecrÃ©taire DÃ©partemental du @PCF et membre du C.N -;2534;1092;1412;4760;9798
_Anthalgique;Anthalgique (❄️, ❄️);(❄️, ❄️);4841;398;38;4517;9794
Cryptonaute_btc;Cryptonaute;Cryptonaute.fr : Média français spécialisé dans les cryptos. 🇫🇷  Toute l'actualité sur les #cryptomonnaies, les #NFT, le #Web3 et bien plus. ✨;5332;111;2678;1669;9790
sterdyniak;Sterdyniak Henri;économiste citoyen, co-fondateur des Economistes Atterres. Mes tweets ne reflètent que mon point de vue;3124;455;5406;803;9788
Pauline_ANEPF;Pauline Lavenant;ðªðº Vice PrÃ©sidente en charge des Affaires EuropÃ©ennes @Pharma_ANEPF | ð¨ðµ Ãtudiante en 5Ã¨me annÃ©e de pharmacie Ã  Toulouse;1307;1339;968;6165;9779
LilianeLucchesi;Liliane Lucchesi;Conseillère régionale de Bourgogne-Franche-Comté déléguée à la solidarité internationale,à la mobilité des jeunes et aux ODD, Présidente de BFC International;4353;466;617;4335;9771
Emichoute;Ems;;6617;740;123;2290;9770
ConsultingTsa;tsaconsulting;◾️Cabinet de conseil financier opérationnel 📈📊 ▪️DAF externalisé • Performance & pilotage financier restructuration & stratégie financière ◽️;6911;1889;669;300;9769
cg1_bin;cgi-bin/;"anonymity loves company | pastenym.ch |
nostr pub key: #npub1nftkhktqglvcsj5n4wetkpzxpy4e5x78wwj9y9p70ar9u5u8wh6qsxmzqs";1720;910;447;6692;9769
damien_casse;Damien Cassé 🔻🐢;Militant #LFI Noisiel ( #NUPES #Circo7710) ✊ - Amateur de rap et de reggae - Antifasciste - Conseiller Municipal de #Noisiel 77;1478;1851;1713;4726;9768
Xavier_BEZIO;Xavier BEZIO;Managing Director chez Morgan Philips #managementdetransition #morganphilips #interimmanagement;6971;2246;538;11;9766
EDFENR_Officiel;EDF ENR;Filiale du groupe @EDFofficiel leader du #solaire #photovoltaïque et de l'#autoconsommation pour les #particuliers, les #professionnels et les #collectivités;1742;535;3226;4259;9762
ThierryTT1661;Thierry TT 🇨🇵 💤 #Reconquete 🌿#TeamPatriote🇨🇵;🇨🇵 Amoureux de la France, du Sud-Ouest, de l'Océan, du Rugby et de la bonne cuisine. Je vomis la gauchiasse et le wokisme. 🌿🐕  🏉#JambonBeurre #Zemmour #FB;3477;2354;2133;1797;9761
MhattDon;Don Presley Mhatt;Le premier des droits de l'homme, c'est la liberté individuelle, la liberté de propriété, la liberté de la penseé et la liberté du travail (Jean Jaurès).;3294;1225;444;4796;9759
toomss34;Toomss34;« Une mauvaise herbe est une plante qui a maîtrisé toutes les compétences de survie sauf celle d’apprendre à grandir dans le rang, SOYEZ UNE MAUVAISE HERBE. »;3160;1534;847;4214;9755
MarIannePROST;Marianne PROST;;2667;2091;310;4684;9752
AlexandreLohma1;Alexandre Lohmann;"Economiste Top 1 des prévisionnistes d´inflation 2023 / Bacen
No Fake eco et debunker sur twittter à mes heures perdues.";4175;390;2156;3031;9752
Scarch52;Cyril Scarcelli;PerDir 2021, promotion Simone de Beauvoir | Principal adjoint, collège Paul Claudel | Wassy, Haute-Marne | #teamHG #teamPerDir #bébéPerDir #Cardie;5009;505;593;3641;9748
WeSavoirFaire;WeSavoirFaire;Explorez, découvrez, visitez les savoir-faire français et achetez les produits #MadeInFrance. Le tourisme de savoir-faire : devenez consom'acteur !;7875;364;1313;192;9744
OlivierM2019;Olivier Marchand;Doctorant École polytechnique | Ingé | Engagé #climat 🌿 Membre @ArsIndustrialis @Fridays4future 👉 petitions.assemblee-national…;3594;977;741;4420;9732
Zephyyr_fr;Corentin Legoupil;"Engineer in computer science.
Into esport, video games, cinema, animes, series.
French and have lived in Canada for 3 years";3635;244;18;5832;9729
Bobo00705279;Bobo 🇨🇩;;9715;9;4;0;9728
payplug;Payplug;Une nouvelle définition de la performance pour vos paiements, simplement.;2742;2090;3430;1459;9721
sergelapierre8;serge lapierre;Payeur d'impôts.;1107;391;58;8164;9720
ClubTechniCites;Club Techni.Cités;L'actualité de l'ingénierie dans les collectivités : eau, déchets, énergie, bâtiment, urbanisme, espaces verts, voirie, transports, réseaux... ©shotsstudio;6935;768;1484;532;9719
economie_sn;Ministère Economie, Plan, Coopération 🇸🇳;Le MEPC est chargé de préparer et d'appliquer la politique arrêtée par le Chef de l'Etat en matière économique, financière et de planification du développement.;1228;276;7649;563;9716
QCpourTrump;QCpourTrump;;5302;395;162;3847;9706
Simcenter_;Simcenter;"Where engineering meets tomorrow
Simcenter is part of @siemenssoftware";4117;421;4743;423;9704
XavierMalakoff;MALAKOFF Xavier;"Infos fiables, sourcées et datées.
Bon. Et aussi des trucs rigolos, tant qu'on a  encore le droit de rire...";3296;1152;917;4334;9699
V_Auriac;Vincent Auriac;Pdt d'@Axylia_ Intervenant @BFMBourse @Paris_Dauphine AgroParisTech Quel CO2 dans vos OPC, ETF, PEA, CTO ? ð scorecarbone.fr Prix Innovation AGEFI. #ISR #ESG;5614;498;1560;2023;9695
CryptLawFrance;Rodolphe Perrier;Les crypto-technologies 💻🔗⚙️📈 vues par un avocat ⚖️📕 Membre de l'Adan;332;162;138;9061;9693
JL30808769;J L đ„đ„©đ”đĄ;;5138;259;126;4167;9690
Dobyteuh;Dobyte;manager đ;4492;183;75;4938;9688
BazaarCompagnie;Bazaar & Compagnie;Le site de l'info brainstream qui retourne le cerveau, au gré de nos envies et de nos découvertes !;9534;100;46;0;9680
Sismologue;Reynald Du Berger;;7815;14;1685;159;9673
DecayeuxAnthony;decayeux anthony MLP;waouh waouh waouh;9091;366;198;14;9669
Joel_Guerriau;Joël Guerriau - Sénateur;Sénateur @Indep_Senat de Loire-Atlantique • Secrétaire du @Senat • VP de la Commission des Aff. Étrangères, de la Défense et des Forces Armées🇫🇷;3516;932;4570;644;9662
rouxad27;rouxad;"Construit des trucs qui se voient pas.đ·ââïž
Parle aussi climat, un peu
#electrifyeverything âĄ";4951;624;771;3316;9662
AggloLTC;Agglo_LannionTregor;"Compte Twitter officiel de la communauté d'agglomération Lannion-Trégor Communauté
Un tiriad beg hag unvan / Un territoire vivant et solidaire";3491;518;2958;2692;9659
FabioPerruchet;Fabio Perruchet;Médiateur scientifique - Coordinateur NEDC à @Oceanopolis_ 🐟/ Passé par @umontpellier et @Le_Museum 🐘/ Diplômé Master #ISME 🎓 #médiation #biodiversite #CSTI;377;767;372;8142;9658
lailatov;Maryse Donarier;Je ne veux pas changer la règle du jeu, je veux changer de jeu;1576;725;259;7088;9648
OSUG_fr;Observatoire des Sciences de l'Univers de Grenoble;"Recherche, observation et diffusion des savoirs
#ENVIRONNEMENT #UNIVERS #TERRE 
Fédère une communauté scientifique de 1300 collaborateurs";3569;695;2424;2957;9645
InnovAvenir;InnovAvenir;Innov'Avenir est un programme d’inclusion numérique dont l’ambition est de donner à chaque jeune les moyens de réussir son insertion sociale et professionnelle.;6006;1064;1129;1444;9643
antoine_armand;Antoine Armand;Député de Haute-Savoie. Commission Affaires économiques. Rapporteur de la Commission d’enquête sur l’indépendance énergétique. Burex @Renaissance. Pastoralisme.;564;1096;6026;1947;9633
Danythe99886660;Dany the dog;la vida est une chienne alors autant en profiter. je m’excuse pour mon orthographe dsl.;3143;739;207;5530;9619
ESS2024;ESS 2024;Plateforme d’information et d'accompagnement des acteurs #ESS pour des Jeux #Paris2024 #inclusifs & #solidaires @Les_Canaux @Paris2024 @SOLIDEO_JOP;3211;1973;3425;1007;9616
ZameTension;adamo;Parabellum;7094;2008;243;271;9616
Bouygues_ES;Bouygues Energies & Services;"Partenaire de votre #TransformationEnergétique #numérique
Partner of your #EnergyTransition #DigitalTransformation";3222;996;2633;2765;9616
thierpech;Thierry Pech;Directeur général de @_Terra_Nova @_LaConversation;1568;1152;6255;637;9612
RadiopirateCo;RadioPirate & Co;;542;225;8425;420;9612
DBlaiseau;Dior Blaiseau;Spécialiste Communication @ Bureau de Coordination du Système des Nations Unies au Gabon. From : 🇬🇦🇫🇷🇸🇳🇨🇻;6032;649;1354;1576;9611
benoitleteneur;Benoît Leteneur;"TV technologist.
Jazzophile & Ableton-addict. 
Membre de Paris Video Tech. 
Ch'ti.";3744;1458;662;3729;9593
cecilebeliot;Cécile Beliot-Zind;"Chief Executive Officer @belcorporate
#agro #foodrevolution #leadership #women";2281;366;1767;5172;9586
InsoumisProNuc;NUPES pro-nucléaire 💚☢️❤️;Nucléaire : Union des Partisans Écosocialistes. #Nuclear4Climate. Aidez-nous à faire bouger les lignes à gauche !;3141;565;488;5382;9576
Levyetuli;Levy Daniel;It Manager-entrepreneur-Designer;2319;493;124;6639;9575
ValandilHxC;Valandil HxC🤘 🇫🇷🇮🇹;;5956;283;97;3239;9575
ReconqueteGIR;RECONQUÊTE ! Gironde;Fédération @Reconquete_off en Gironde  - Le grand mouvement populaire d'Éric Zemmour Adhérez ici: parti-reconquete.fr/adhesion…;1990;370;2468;4743;9571
radioalbayane;Radio Al Bayane;Radio Nationale Islamique de Côte d'Ivoire;6354;317;2821;76;9568
bt_raphael;Mwalimu ✍️☮️;"Approche appréciative,
et constructive 🏗️.

#Public Health & Nutr, HIV-AIDS.
Consulting and global management.";3312;166;154;5934;9566
kr4k0deal;Kr4k0deal;The dark side is a pathway to many abilities some consider to be unnatural.;635;502;28;8399;9564
pelais8;pelais;;4777;378;24;4384;9563
AtmoSud;AtmoSud;Votre observatoire de la qualité de l’air en Région Sud Provence-Alpes-Côte d'Azur.;5031;393;2252;1879;9555
Denis_Bapt;Baptiste Denis;Co-auteur de Jean Jouzel - Élu local @lagarenne en charge de la transition écologique;3471;566;550;4955;9542
CEDurkheim;Centre Émile Durkheim;Le Centre Émile Durkheim est une Unité mixte de recherche en #sciencessociales #sciencepolitique #sociologie du @CNRS et de @ScPoBx et @univbordeaux;3346;603;2946;2641;9536
cedricmeyoua;Cedric M.MOUSSOUNDA;When there is a will, there's a way.;3663;178;169;5496;9506
DobsonCentre;McGill Dobson Centre;Building innovative companies with a purpose. The McGill Dobson Centre for Entrepreneurship is the hub for entrepreneurial activity @mcgillu.;2267;1393;2380;3461;9501
rechercheUQAM;Recherche et création UQAM;C’est dans la force de leur impact et dans leur caractère intersectoriel que la recherche et la création de l’UQAM trouvent leur véritable finalité.;4236;1072;1671;2518;9497
jean_pailler;Jean Pailler;J'ai appris, j'ai servi, j'ai écrit, j'ai vécu, mon lévrier s'appelle Juju;3610;95;67;5711;9483
HRImag;HRImag;Depuis 1996, HRImag est un magazine francophone indépendant, qui offre de l'information de pointe sur le milieu des HRI (Hôtels, Restaurants, Institutions).;5993;983;2004;503;9483
Baco83272090;Baco;;5779;2;347;3354;9482
dubois_le_quai;Popeye;Je suis un oiseau migrateur qui ne connaît pas la frontière naturelle.;7429;718;97;1238;9482
YvonKoudam;Yvon KOUDAM;Co-Founder @Kondjigbale | Délégué National @innovtg  | Forbes Afrique 30 Under 30 | IT engineer #MB100 #SDG3 #healthtech #innovation #digital #youthEmpowerment;2326;692;673;5788;9479
asteurla;Asteur en Louisiane;Le fil d'information #francophone de #Louisiane relate les faits marquants de l'actualité louisianaise sous forme synthétique.;3427;299;755;4995;9476
pascal_essof;Pascal st pierre ✈️🏳️‍🌈;;1051;251;81;8092;9475
joubert_bzh;Berjou;La solitude est un miroir : rien, c’est déjà trop;6345;105;20;3000;9470
Dominiq64478696;Meemow;Un masculiniste, c'est comme un enfant gâté de 4 ans : ça hurle à l'injustice dès qu'on lui demande de prêter ses jouets ou quand on ne s'intéresse pas à lui, e;2913;32;19;6499;9463
andrelamontagn2;André Lamontagne;Député de Johnson. Ministre de l’Agriculture, des Pêcheries et de l’Alimentation et ministre responsable du Centre-du-Québec.;2172;221;5135;1934;9462
LeMulot77176;Le Mulot;;2431;72;28;6928;9459
fgmontreal;Fondation du Grand Montréal;La Fondation du Grand Montréal oeuvre au mieux-être de la communauté du Grand Montréal. Site web : fgmtl.org #Philanthropie #FGMtl;3876;1470;1894;2211;9451
malipatak1972;Jovanovic Philippeğ·ğ¸ğ·ğºğ²ğ«;;1430;87;67;7845;9429
MoroccoInSEN;Le Maroc au Sénégal;الحساب الرسمي لسفارة المملكة المغربية بالسنغال والرأس الأخضر Compte officiel de l'Ambassade du Royaume du Maroc au Sénégal et au Cabo Verde;1700;3297;4192;238;9427
Sankay42395366;Sankay;Ma personnalité;6682;384;202;2155;9423
JosueKadima_;JK B.;;4111;1816;134;3358;9419
virginie_laval;Virginie LAVAL;Professeure en psychologie.  Présidente de l’université de Poitiers. @UnivPoitiers;1334;1286;1817;4981;9418
moutonnob;Mouton 🇫🇷 - ⚛️;Random bullshit;8384;189;53;786;9412
AnaisChery;Anaïs Chery-Leroux;Responsable du service Science et société à @univpoitiers et chargée de médiation scientifique @univpoitiers • Ex @CultureUGA @UGrenobleAlpes;3101;1025;1005;4276;9407
Ricet101;Eric;;760;112;68;8459;9399
EMC_MEC;ElectricMobilityCAN;"Electric Mobility Canada -Accelerating Transportation Electrification #ZEV #EV 
Mobilité Électrique Canada -Accélérer l'électrification des transports #VZÉ #VÉ";2976;901;3083;2432;9392
moulagauffres;Tonnerre de Brest;Le véritable voyage de découverte ne consiste pas à chercher de nouveaux paysages, mais à avoir de nouveaux yeux. 🌏🌳🏔🔭🎶;1466;189;29;7707;9391
JMaStarforever;JMaStar;;2159;659;48;6524;9390
jeunesmacron44;Jeunes avec Macron 44;Compte officiel des @JeunesMacron en Loire-Atlantique đ«đ· | Le mouvement de jeunesse qui sâĂ©mancipe et qui sâengage. Pour nous rejoindre, câest ici â€”ïž;2439;899;2210;3835;9383
lepretre_seb;Sébastien Leprêtre;Maire de La Madeleine - Vice-Président de la MEL - Conseiller départemental du Nord - Gaulliste;4632;92;3183;1468;9375
Prompt_Innov;Prompt;Accroître l’avantage concurrentiel des entreprises québécoises du secteur #TIC par des partenariats de R-D avec le milieu institutionnel de recherche.;4773;748;1347;2506;9374
aebi4714;.;AvDi ivka;3027;168;73;6106;9374
maxnevralgiques;Max des Névralgiques;"Twitch Partner Barbu dans Les Névralgiques -
Inquiries: lesnevralgiques@gmail.com";2166;210;888;6109;9373
ReneRaimondi;René RAIMONDI;Adjoint au Maire de Fos-sur-Mer, Conseiller Départemental;637;1145;823;6760;9365
EchoPerso;🎀ソレン🎀;Cringe;4480;65;38;4780;9363
ladepeche09;La Dépêche Ariège;"Bienvenue sur le compte officiel de la rédaction de l'#Ariege de @ladepechedumidi. 
Contact en DM ou par mail sur redaction09@ladepeche.fr";6647;104;2339;272;9362
techysfrenchys;Techist;High-tech aficionado. here for the giveaways and the news;4923;765;80;3591;9359
Angel_Capui;Angel Alberto Capui;"❤️💙
🎗️🏔️
🌳🔻

Terroriste à mes heures perdues.";6748;617;53;1940;9358
Kaiizer237;Kaiizer;Légion Patria Nostra;4366;237;418;4336;9357
vgermemurat;VGM;Proviseure Lycée des métiers services à la personne et à l'entreprise Virginia Henderson, Arnouville. Formatrice académique hybride #Perdir #Gestioncrise;2775;304;497;5773;9349
AlgAujourdhui;l'Algérie aujourdhui;Média généraliste algérien, fondé par des journalistes professionnels. Nos valeurs sont l'intégrité, le professionnalisme et le patriotisme.;8285;39;1014;10;9348
TillyBertet;ⓘ Cet utilisateur;;4337;188;185;4634;9344
LePotentiel_rdc;Le Potentiel ð¨ð©;"Quotidien d'actualitÃ©s/informations gÃ©nÃ©rales en RDC.
ð +243 81 47 66 156
ð§ contact@lepotentiel.cd
ð lepotentiel.cd";3196;427;4874;840;9337
RolandLEVY8;Roland LEVY;Medecin de l'humain;5617;61;99;3556;9333
FBayre;Frederique Bayre;Directrice Relations presse @CarrefourGroup. Ex dircom @FCDfrance ExDircom du #CSA et Conseillère en charge la presse #elysee #Chirac;1616;1300;1747;4664;9327
SylvianeDorval1;Sylviane Dorval;;2994;33;101;6199;9327
avrille49;Avrillé Ville-Parc;Twitter officiel de la Ville d'#Avrillé, en #Anjou #PaysdelaLoire.;5865;417;1605;1437;9324
jfrMTL;Jean-François René;Professeur en travail social. Cycliste et amateur de plein air (ski de fond, rando....). Compte perso.;5471;513;390;2942;9316
SocEcoOntario;Société Économique de l'Ontario;Développement économique et employabilité en Ontario : économie, tourisme, entrepreneurs, jeunes, immigration, missions économiques, agroalimentaire, mentorat;4860;936;2353;1159;9308
TotofDes;Totof Karukera;;1532;317;91;7368;9308
7Marc7Antonius7;Marc Antoine;DEUS ðâï¸ Patriot ðª Bolsonaro ð§ð· Salvini/Meloni ð®ð¹ Putin ð·ðº Trump ðºð¸ ShinzÅ Abe ð¯ðµ Patriotes ð«ð· OrbÃ¡n ð­ðº Duterte ðµð­ Netanyahou ð®ð± Bachar ð¸ð¾;3223;1052;113;4918;9306
Dlh_alexandre97;dlh_alex;25 ans, papa, auto entrepreneur et ingénieur hydrologue.;6068;260;27;2950;9305
inspektrgadgets;Inspecteur Gadget;Ben l’Inspecteur Gadget. Climato-realist, there is no Climate Emergency. Suspicious Observer;5698;241;93;3256;9288
PaulineVettier;Pauline Vettier;Spécialiste Marketing B2B et Relations Presse pour les entreprises énergie et climatetech ⚡🌍 Top 10 Communication LinkedIn France ✍️ Freelance 👩🏻‍💻;5533;1285;1381;1085;9284
Pierre74830508;Pierre;;4611;19;24;4629;9283
EELVAlsace;EELV Alsace;"▪ compte Twitter officiel d'Europe Écologie - Les Verts Alsace 🌻 
▪ retrouvez-nous également sur facebook.com/EELValsace/
📰 – #EELV • #EELVA";3902;372;1767;3236;9277
BobCavalier;Cavalier Bob;;4066;431;53;4720;9270
PierreEyben;Pierre Eyben;Militant écosocialiste. Co-porte-parole du Mouvement Demain (fusion du mouvement VEGA et du Mouvement de Gauche). Conseiller communal Vert Ardent à Liège.;3715;1946;1624;1984;9269
UrielMsh;Dre Msh;Étudiant en DCG expertise comptable et en finance mais aussi un bousillé de géopolitique, de football et de boxe 🇧🇯🇳🇬🇲🇫;1867;269;101;7032;9269
LaurenceBoetti;Laurence Boetti-Forestier;Conseillère Régionale @MaRegionSud Provence-Alpes-Côte d'Azur (@MoDem), Vice-présidente du groupe @UPR_SUD;2849;361;862;5193;9265
Kissingababy1;Kissingababy;Politique rdc;3750;1264;642;3608;9264
GavrocheMedia;Gavroche Thaïlande;L'#actualité de référence sur la #Thaïlande pour les francophones par la rédaction de Gavroche | Retrouvez-nous sur FB et sur gavroche-thailande.com;6902;411;1638;311;9262
DalaiLisaGiulia;LisaGiulia;;5125;46;36;4054;9261
MairiedeSaumur;Ville de Saumur;"Bienvenue sur le compte Twitter officiel de la Ville de #Saumur. Abonnez-vous pour rester informés de nos dernières actualités !
#MaineetLoire #Anjou";4908;58;1762;2528;9256
LouisLaury88;Louis Laury 3e du nom;"Gallia memor !
Carthago delenda est.

Une place de prison coûte plus cher que la vie d'un Français. Les premières sont trop rares, les secondes trop nombreuses.";4905;226;91;4033;9255
Froeschfresser;Jack Frog;;6457;37;13;2740;9247
xibaarsn;Xibaar;Xibaar.net est votre portail d’informations qui regroupe toute l’actualité du Sénégal en direct;9080;68;70;22;9240
Bakanjaliberte;I'❤ RDC/RSA 🇨🇩 🇿🇦;Ukuhamba behlolela iinkosi zabo ezibahlawulayo umhlaba. Bahamba nalo ilizwi ukuba lihamba liba yingcambane yokulawula izikhumbani nesizwe, yathi imfuno yayinto;5706;873;199;2461;9239
un_salafi;Salim Charaf Ibn Charfadine🇸🇦🇹🇩;Juriste de formation et Inspecteur des impôts. سلف العقيدة والمنهج. Sur les pas des pieux-prédécesseurs. A la recherche des sciences. Chadian;4318;635;368;3917;9238
VincentDrezet;Vincent Drezet;Porte-parole d'@Attac_fr, fiscaliste, contributeur @justice_fiscale, co-auteur d'Impôts : idées fausses et vraies injustices (2021). Ex-SG @SolidairesFiP.;1148;359;1534;6182;9223
toulouse_up;UPToulouse;;9054;68;91;9;9222
fodevaux;François-Oli Devaux;"Transition enthusiastic from Brussels
'Let's create the world we want to live in' 
Energizing climact.com";2745;968;412;5097;9222
tunisialphanews;Ifriqiya🇹🇳;Partage l’actualité Tunisienne 🇹🇳 sport, politique, culture, économie, société, technologie;5278;0;3819;124;9221
la_gaillette;laGaillette;;1598;162;91;7361;9212
RH1969RH;RH 1969;;5615;42;18;3536;9211
selimurbanTonic;Selimcrypto;Gérant et coach sportif d'Urban Tonic: la salle de sport, place des jacobins, spécialisée dans le coaching sportif, mental et diététique.;1413;475;74;7234;9196
Daddy_Swainpai;Club des adorateurs de Taliyah;"(he/him) Canon Taliyah Believer/ TSA/ 22 yo / pansexual ð³ï¸âð
Utopiste libertaire rÃªvant d'un monde sans dieu ni maÃ®tre oÃ¹ l'humanitÃ© vivrait unis. ð´â«";7683;106;34;1368;9191
CAIlleEtVilaine;Crédit Agricole d'Ille-et-Vilaine;Banque départementale et coopérative qui fonctionne sur les principes du circuit court, avec 488 administrateurs, 1521 collaborateurs et 118 points de vente.;3580;448;1729;3433;9190
Draanek_tv;Draanek;"Ingénieur nucléaire en Radioprotection, curieux streamer un peu fou. twitch.tv/draanek_tv
Très fan de #Danganronpa #FE #Persona.
Passionné d'animes et de";3239;214;331;5406;9190
Pedro65G;La pie qui déchante;Ecolo-anarcho-bobo à tendance pédosataniquetamère;3144;60;16;5968;9188
AgenceFlag;Agence Flag;Agence #RelationsPresse avec une expertise multisectorielle. Nous savons faire parler de vous ! Veille #responsable #madeinfrance #mobilité #RP #eRP #CM;4540;1496;850;2300;9186
herve_patrick;Herve Patrick NGAO;Résistant Africain xxi e Siecle/Anti-imperialiste /Panafricaniste/Opposant radical à toute sorte d'oligarchie.;3519;1985;1026;2650;9180
Departement_971;Departement_971;Conseil Départemental de la #Guadeloupe #cd971 / Président : M. Guy LOSBAR;956;246;7662;315;9179
SowAlphamai;SOW alpha;journaliste pour : guineesignal.com - Guinear;8417;667;81;14;9179
AnlEnigmatik;MTAKATIFU, Esq.;"Toujours à l'#EcoleDeLaVie. Sciences de l'expérience et de la connaissance cosmique. 
Mes codes : Amour-Intégrité-Travail";4288;117;71;4693;9169
AirBoita;Boita aiR;Gee, Brain, what do you want to do tonight?;7340;270;162;1389;9161
renaissance3116;Rachel;;8965;56;35;102;9158
RafaSorianoO;rafael soriano ortiz;Viajero en el camino de la vida. Ahora Embajador de 🇪🇦 en 🇨🇮 y 🇱🇷. Ambassadeur d'Espagne en Côte d'Ivoire. Ambassador of Spain to Liberia. Cuenta personal;3578;172;1240;4167;9157
noegrossiord;noegrossiord;"Besançon/Lille 
@EELV_FComte
@JE_Lille
@ScPoLille";816;1043;337;6960;9156
DesjardinsCecil;Cécile Desjardins;Journaliste. Rédactrice en chef adjointe en charge des cahiers thématiques & conférences à @lopinion_fr;3026;863;1730;3536;9155
Mahamou45404817;Mahamoud Ali;dix a meditter le coran en langue et arabe;2949;920;121;5163;9153
exordi9m;‍ ‍‍ ‍ ‍‍ ‍ ‍ ‍‍ ‍ ‍‍ ‍ ‍ slow‍‍ ‍ ‍‍ ‍ ‍‍♱⁶⁶⁶;ᅠ⠀ ⠀ ⠀ ⠀ ⠀⠀ ⠀⠀⠀ ‍ 𝐍𝐄𝐕𝐄𝐑 𝐓𝐔𝐑𝐍 𝐘𝐎𝐔𝐑 ⠀ ⠀⠀⠀⠀⠀⠀ ⠀⠀⠀⠀⠀⠀ ⠀⠀⠀⠀𝐁𝐀𝐂𝐊 𝐎𝐍 𝐓𝐇𝐀𝐓ᅠ⠀ ⠀⠀⠀⠀⠀⠀⠀⠀⠀⠀⠀⠀⠀𝔯𝔲𝔰𝔰𝔦𝔞𝔫 𝔞𝔰𝔰𝔥𝔬𝔩𝔢. ⠀⠀⠀ ⠀⠀⠀ ⠀⠀⠀ ⠀⠀⠀ ⠀⠀⠀ ⠀⠀⠀;5919;234;230;2765;9148
ReferendumVole;1995 Référendum volé;NE PARLONS PLUS JAMAIS DU RÉFÉRENDUM DE 1995 SANS LE NOMMER «VOLde95». Ne pas le faire, c'est être complice. #Volde95;6465;840;720;1118;9143
FlorianKRF;Florian Koulimaya đź‡¨đź‡¬;Conseiller Ă  la jeunesse du MJSECFQE | Toastmaster | Mentor | Analyste social | Philanthrope |;2721;1455;1455;3511;9142
Louisnaug;Louis Naugès;;6815;67;2241;11;9134
CecileGallien;Cécile Gallien;Maire de Vorey-sur-Arzon (43). Vice-Présidente de l’Association des Maires de France (@l_amf).;2198;619;1418;4899;9134
morpheus971;Wembley Xander;;4455;399;77;4201;9132
jeancanourel;Digus;;617;134;16;8359;9126
JeunesG92;Jeunes Génération.s 92;Comité @lesjeunesg des Hauts-de-Seine ✊ #NUPES @generationsmvt;2328;472;1080;5235;9115
AEBozonVerduraz;A.-E. Bozon-Verduraz;Traducteur-interprĂ¨te, City Organizer pour Pulse of Europe Grenoble (@PoEGrenoble), #FBPE #OurEuropeNow #FPHD #facciamorete đź‡Şđź‡ş;1546;1756;352;5454;9108
DupontFabrice14;Dupont&Dupont;Partenaire de SwissBorg, la banque du futur đ, Membre enchanteur de Emrys, la coopĂ©rative au service de votre pouvoir dâachat đŠ;1073;101;46;7884;9104
Empirechrifien1;ð²ð¦Maroc Defender;Un compte indÃ©pendante dÃ©diÃ©e au Maroc, dont l'objectif est de renouer avec une vision pragmatique de la gÃ©opolitique, lâhistoire, lâÃ©conomie et de lâactualitÃ©;1961;1440;2889;2813;9103
UnionTLF;Union TLF;L'union TLF - Transport et Logistique de France - est l'organisation professionnelle représentative des métiers de la chaîne du #transport et de la #logistique.;3433;927;3672;1057;9089
Tom_SloWeAre;Thomas Ebélé;"Co-fondateur de @SloWeAre
Co-auteur de 𝑳𝒂 𝒇𝒂𝒄𝒆 𝒄𝒂𝒄𝒉𝒆́𝒆 𝒅𝒆𝒔 𝒆́𝒕𝒊𝒒𝒖𝒆𝒕𝒕𝒆𝒔
#SlowFashion #Moderesponsable #Changemaker
 337.54 PPM CO2";6414;331;872;1468;9085
TRUTH_PROJECT_;TRUTH_PROJECT_ ð¸ ð¥ ð½;ð ð piped.video/channel/UCeqfJrZâ¦ & photos.app.goo.gl/LnQxqoTmf3â¦ ð;1836;73;146;7024;9079
HajerGueldich;Hajer Gueldich;Professeure agrégée de Droit international à l'Université de Carthage et membre élue de la Commission de l'Union africaine pour le Droit International (AUCIL);4105;1081;1477;2408;9071
marie_helie;Marie-Josée Hélie;Politiques énergétiques/environnementales. Entrepreneure. Maman de 4.;983;289;6137;1657;9066
anthony_SIMISI;Anthony SIMISI;Il faut façonner l'argile pendant qu'elle est molle;2765;81;390;5822;9058
Yahya91050324;Yahya;;2879;84;16;6077;9056
HumaBio;Humanité et Biodiversité;"Ensemble, construisons un monde pour vivre en harmonie avec la nature ! 🌱 Adhérez et créez votre #OasisNature
✨ Président d'honneur : #HubertReeves";4228;409;4289;116;9042
infoL4T;Association Lab4tech;Entreprise de formation;8860;25;138;12;9035
RenaissancePB;Renaissance Pays Basque;Compte officiel de Renaissance Pays Basque, Présidente @etxemaria;3531;959;1461;3077;9028
amigerba;SĂ©natrice Amina GERBA, M.B.A., C.Q.đź‡¨đź‡¦;"SĂ©natrice IndĂ©pendante du Canada (QuĂ©bec) /Independent Senator / Entrepreneur /
CoprĂ©sidente / Co-chair Canada-Africa Parliamentary Association #CAAF #CAPA";2681;405;5213;728;9027
AndraAlex16;Andri Alex;;7158;5;89;1769;9021
EguiMoon;Egui | Tirages ouverts;"bienvenue sur mon compte. j'apprends encore beaucoup sur la cartomancie ✨
paypal.me/Mgucquero";6161;193;508;2159;9021
campingcarpark;Camping-Car Park;"1er réseau européen d'aires d'étape et d'aires de services pour camping-cars | 365jr/an | 24h/24
#CAMPINGCARPARK #CampingCar #France #Europe";4056;959;2530;1475;9020
Asanfo_ohin;Asanfo;fruit of the womb,fruit of the Lomb.the one the blind man saw walking like trees;5034;95;147;3743;9019
RLV_agglo;Riom Limagne et Volcans Agglomération;👉 31 communes, 69 000 habitants, 2ème agglo du @Departement63, territoire dynamique entre #Riom 🏘 la plaine de la #Limagne 🌿 et les #Volcans d'@Auvergne ⛰;2422;514;1420;4654;9010
Najib_Boubker;NAJIB 🇲🇦🥑🇲🇦;proud Moroccan, passionate with new technology, sustainability & renewables, there is no planet B, my dream is to make the energy goes green every where;2519;577;104;5804;9004
julielppn;Julie;Football et gaming. Twitch : Julziye;1566;228;51;7158;9003
b_belhaddad;Belkhir Belhaddad;Député de la 1ère circonscription de la #Moselle - #Metz 1 🇫🇷 🇪🇺 #circo5701 #Renaissance #TdP;1499;1768;4941;792;9000
fabienneLissak;Fabienne Lissak;#News #Altice #numerique #IA #IoT #space #aéronautique   Journaliste, animatrice, consultante - Ecole du numerique CNES - GIFAS- Eurotunnel  - Bloomberg TV;1800;4988;1595;617;9000
Eliakim_Art;Eliakim Art;ingénieur en Réseaux Telecom ,Entrepreneur. CEO de @balvin_services et Artiste Peintre dessinateur;1419;1440;3531;2608;8998
GIllesjoviado;Gilles Joviado;Maire de Buzet sur Tarn, VP Val Aïgo Développement territorial et économique, Conseiller Syndical SMIX Les Portes du Tarn, VP SMICTOM de Lavaur;3285;703;471;4531;8990
EDF_HDF;EDF Hauts De France;Compte officiel #EDF en #HautsDeFrance #Innovation #TransitionEnergetique #Commerce #Smartgrids, production #BasCarbone #EDFPulse;3543;565;1722;3153;8983
micablo_casu;Micablo;"Streamer sur twitch.tv/micablotv
Compte perso de @micablo1 , vous retrouverez ici toutes mes inepties et mes RT nuls mais pas mes annonces de stream.";5480;151;46;3304;8981
AbOued95;oued;chef d'entreprise;5977;295;89;2613;8974
Sitechosmedias;MALI-CONSCIENTðŸ‡²ðŸ‡±;"Ã‰ditÃ© par Groupe Ã‰chosMÃ©dias SARL, journal et Site Information en temps rÃ©el
wwww.echosmedias.org
wwww.echosmedias.com
wwww.echosmedias.ml";5182;1563;1020;1208;8973
LaurenceM20B;Laurence;;2492;413;94;5969;8968
axantmat;ax ant matđź‡¨đź‡µđź‡Şđź‡şđź‡µđź‡ą;"â€śOn ne fera pas un monde diffĂ©rent avec des gens indiffĂ©rentsÂ Â»Arundhati Roy

â€śLes extrĂŞmes des partis politiques peuvent mener aux pires extrĂ©mitĂ©sÂ» Pierre Dac";5762;221;45;2939;8967
intelekto_media;Intelekto;"Média spécialisé en intelligence économique, cybersécurité, RSE et leadership.
Pour s'inscrire à la newsletter 👉 intelekto.fr/newsletter/";6194;427;1440;901;8962
GroupeLuminess;Luminess;Spécialiste du traitement des données et de leurs usages digitaux #IA #data #digital #transfonum #UX #UI #tech #BPO #cybersecurité #esanté #hcsmeufr;5405;1096;1407;1052;8960
Matthieu_Mrts;Matthieu;Penseur;4617;157;186;3983;8943
MickaelBouloux;Mickaël Bouloux;Député socialiste de la 8ème circonscription d’Ille-et-Vilaine 🇫🇷🏛 #circo3508 #nupes #bzh;2524;967;2460;2989;8940
ReseauAndes;ANDES;Créée en 1997, l'Association Nationale Des Élus en charge du Sport est le Réseau Sport des Collectivités locales qui regroupe 8000 villes et intercommunalités.;2571;346;3832;2190;8939
noury758;Dan Nounou;;6300;134;67;2438;8939
christyolivier2;Olivier Christy;;8558;103;35;237;8933
ReseauRelais;Relais d'Entreprises;Réseau de #tierslieux d'activité pour #entrepreneurs et salariés en #télétravail -  ☎️05 32 77 00 07 #qualitédevie #territoires #mobilité #ruralité;5019;1308;1218;1384;8929
Bindner7;Bindner;;1425;238;59;7206;8928
ThomasMktAonzo;Thomas Aonzo;"PrÃ©sident @UIndependants
Conseiller @lecese @cfdt ðï¸ð 
Freelance ð¨âð» la tÃªte dans les Ã©toiles";572;1595;1044;5709;8920
ConnectbyCNES;Connect by CNES;"Les technologies et innovations spatiales au service de la société!
#Maritime #Agriculture #Forêt #Énergie #Santé #NewSpace - @CNES";2499;892;3547;1973;8911
davidschk;David Schkiwisk;Editeur de site | Consultant en #SEO | #GatherSEO;3293;628;1157;3830;8908
MediaPhusis;Media Phusis;Fil d'actualités culturelles & Articles spécialisés en #philosophie / Partenaire vidéothèque philoinfo.fr / facebook.com/mediaphusis;6885;1323;506;175;8889
numberUan;Lucas;vu qu'ici ça va pas tarder à fermer : eldritch.cafe/@numberUan;3702;296;119;4772;8889
xavcot;Xavier;"Consultant IT

đČđŽđŻđ„â·ïž

NoFakeScience
Transition Ă©nergĂ©tique & Ă©cologique

Contre toute forme d'intolĂ©rance";4122;571;172;4018;8883
aliptic_;ALIPTIC;Association #Limousine des Professionnels des #Technologies de l'#Information et de la #Communication.  Membre de @FranceIT, le réseau des #clusters numériques.;3684;645;1969;2578;8876
MediaConnectMC;MediaConnect;L'outil RP pensé par et pour les journalistes. Filiale du groupe @AFPfr;253;13;8271;327;8864
MaximeRoy2265;Maxime;Pro choix, pro liberté , De droite , anti-woke, anti-cave . p.s si tu croix avoir la vérité absolu, pis t’es arguments sont des insultes decolice! merci!;1429;137;112;7185;8863
megade3;Denis LeBrun;#StandwithUkraine;1519;1004;145;6187;8855
wauquiezteam;Team Wauquiez;Compte de soutien à @laurentwauquiez.;3170;1598;2965;1121;8854
FondsE5T;Fonds E5T;Environnement & Transition Énergétique | Think Tank;3385;2811;1618;1034;8848
amitietomoko;フランス語英語講師tomoko;神戸元町に「アミティエ外国語教室」を2002年に創立。英語とフランス語と日本語の講師、英仏通訳者。仏検1級成績優秀者で一発合格。英検準1級。【アミティエ外国語教室】でYouTubeしてます。オンラインレッスン受付中。2022年仏検1級合格者2名、準1級は10名合格㊗️;2108;2701;3269;769;8847
VinsK10;VinsK;"Politique, mécanique numérique, sociologie, sciences, féminisme, environnement... passer du temps en famille et avec les ami·e·s ! 
(il/lui)";2777;928;544;4598;8847
simonlesperance;Simon Lespérance;ex-staffer ⚜️💙 • études en travail social et droit • amoureux de la diversité (surtout des points de vue rarement exprimés).;2675;2443;1389;2338;8845
FinDev_Canada;FinDev Canada;Promoting sustainable development through the private sector. Soutien du développement durable parmi le secteur privé.;2765;359;2648;3072;8844
SACECI_Group;Ben Driss;African Society for Foreign Trade and International Cooperation;4793;102;90;3844;8829
ElProfeCrypto;El Professor - Finance/Eco/Crypto ðð;ð Equity Fund Manager in traditional finance | ð Blockchain/Crypto Teacher & Speaker | ð§  Board in multiple projects | ð° Writer for @lentreprisefr;2873;342;2979;2631;8825
VisenyaN;Visenya Nyamulagira;"Ancient God of Chaos 
Fulmining and Crawling Chaos
""You must have chaos within you to give birth to a dancing star.""
""In chaos, there is fertility.""";8544;91;30;158;8823
Sylviotte1;Sylviotte, femme de l'être 🙏;"PRIE comme si tout dépendait de Dieu
Agis comme si tout dépendait de TOI. 🙏";2931;263;73;5548;8815
raoulito21;SANCHEZ RAUL;;7512;20;17;1261;8810
Haiemagiqueorg;Haie-magique.org;Plante +7500 arbres/an pour #banlieue #Agricultureurbaine #villedurable #villenourricière #trameverte #Biodiversité @cdessonne @iledefrance  Aussi @PicoReuses;3042;1010;1031;3727;8810
herveleroux;Hervé Leroux;CMO #Digital #Marketing #Communication #LeTalk #RC #CX @Odigo @OdigoFr @OdigoEs Passionate by #SocialSelling;6638;720;902;546;8806
JEROMEDOMINIQU7;JEROME DOMINIQUE;;2428;831;286;5249;8794
RevolutionAvelo;La Révolution à Vélo !;Faisons la révolution, mais à vélo ! Mets en avant la #solutionvélo;3316;310;345;4821;8792
franckcourchamp;Franck Courchamp;CNRS researcher interested in biodiversity dynamics;2177;391;2729;3494;8791
PierreRuet_;Pierre Ruet;"Défenseur du made in France

Au service des angevins avec @jceangers";3186;486;282;4836;8790
KriegPlanque;Alice Krieg-Planque;Enseignante-chercheuse (mcf) en @salle421 @UPECactus @Ceditec_upec Analyse du discours. Sociolinguistique. Linguistique. Sciences du langage;4069;434;1683;2604;8790
matscaf;Matscaf;;4594;258;63;3859;8774
RoussinTatiana;Tatiana Roussin ð¼;"InfirmiÃ¨re, MariÃ©e & Maman de 5 garÃ§ons, 4 en IEF et 1 au CollÃ¨ge â¤ï¸

#enfanceheureuse #ief #Ã©ducation #DonBosco #CharlotteMason #France #Nature #mumof5 #livres";3130;859;277;4501;8767
GoulardS;Sebastien Goulardðªðºðºð¦;"#mer, #ocean, #Europe, #Chine, #litterature
Mes tweets n'engagent que moi.";2396;1189;396;4784;8765
ministere_rural;Ministère du Développement Rural Mali;;1261;89;7205;206;8761
Albioma;Albioma;Engagés dans la #TransitionEnergetique, nous produisons de l'énergie bas carbone à partir de #biomasse végétale, de #solaire et de #géothermie.  #ENR;1652;276;6519;311;8758
Transport_TRM;Transport_routier;Ici je tweete et retweete l'actualité et les infos sur le transport routier en général et plus particulièrement le transport de marchandises #TRM 🤣;6118;591;1868;169;8746
idfnature;Île-de-France Nature;Île-de-France Nature imagine, aménage et protège les espaces naturels et agricoles pour préserver le fragile équilibre entre la ville et la nature.;2686;864;3103;2091;8744
BurundiFF;F.F.B;La Fédération de Football du #Burundi a été créée en 1948. Elle est affiliée à la #FIFA et la #CAF depuis 1972.;2990;135;4852;765;8742
Nouchkavero1;Vero;;1354;248;21;7117;8740
dhajaasnz;Dhajaasnz;;1088;224;17;7411;8740
GillesGALLINA;Gilles GALLINA;"#creditmanager @AldesOfficiel
#ventilation #aeraulique
#progressiverock #hydrogene #h2
@rushtheband #hydrogen #prog @afdcc";2732;180;109;5716;8737
TromlerMiklos;TROMLER Miklós;Ambassadeur de #Hongrie auprès du #Maroc et de la #Mauritanie / Ambassador of #Hungary to #Morocco and to #Mauritania;2745;572;3971;1449;8737
okota_glody;Glody OKOTA;"Simplement congolais

+243818408385";1334;4873;1771;740;8718
RashedJalloh;Ahmad Rashed Al-Moubarack Jalloh;As I know I'm a passenger in this đźŚŤ, I'll always try to assist my surroundings and whatever their color, religion, ethnic, profession, etc.I'm a world citizen.;647;4081;859;3130;8717
LOULOU1963AOUT;Lou;;2593;110;21;5992;8716
Aerdalis1;Aerdalis;"🇨🇵 souverainiste , 
Je ne crains pas le suffrage universel, les gens voteront comme on leur dira. TOCQUEVILLE";6242;179;128;2164;8713
paulD1968;Paul Dessart;"IBM Rational Software Engineer -Jazz specialist
Ex-Borland [Delphi, C++ Builder, Jbuilder]
loving music, books [thrillers] and developing apps";5570;192;72;2878;8712
svillaudiere;Sylvianne Villaudiere;Vice-Présidente de la Société d’encouragement - C3D  #DirDD #RSE #Climat #COP #Femmes #Entrepreneurs #Alliancesdurables #FFGolf;3897;781;1044;2986;8708
citoyendupeuple;Michel Lemonnier;Autodidacte;8642;12;21;32;8707
JohnMitchell4x8;John MITCHELL;"Informaticien retraité. Inventeur RTT, 32hrs en 4 jrs (mouv4x8)+la ""taxe"" sur les Robots(cotisation ROSE). Pour la  6e République tirée au sort+RIC+Décroissance";5894;103;67;2642;8706
FMbinah;Franck Mihindou Mbinah;Avemba - Fils de Dijab - Petit-fils de Badoumbi et D’Avondo.. Sarcasme, Tradition, Coutume et Géopolitique;7173;311;58;1163;8705
titus66431117;titus;;7029;442;29;1201;8701
vollesprit;el hombre;philosophe de quartier et sociologue de trottoir... ha bah oui, c'est facile de s'auto-proclamer ici...;6602;109;26;1964;8701
MINAC237;MinistĂ¨re des Arts et de la Culture đź‡¨đź‡˛;MinistĂ¨re des #Arts & de la #Culture du #Cameroun / Elaboration & mise en Ĺ“uvre de la politique de #promotion & de #dĂ©veloppement #artistique & #culturel;389;802;7200;309;8700
Captainjtejure;Tabbuso;"ようこそ
linktr.ee/tabbuso
twitch.tv/tabbuso";1530;538;99;6527;8694
quick_tw;QuickTurtle;Fan de #Battlefield, j'ai joué au 2, 3, 4, 1 et V. Même s'il m'arrive parfois de rager, je prends quand même beaucoup de plaisir surtout avec la #UNITeamGaming.;485;59;7;8140;8691
gustshims;Daniel Tshimbalanga;;2698;97;102;5793;8690
Nadine_Colin;COLIN Nadine;Professeure de STMS. Administratrice nationale @groupe_mgen #GrandEst Ambassadrice @Groupe_VYV Administratrice @MFGrandEst. Mes tweets n'engagent que moi.;1921;1073;547;5149;8690
la_chataigne;Pascal Coussy;oxymore vivant;7017;339;885;446;8687
ICLEI_Canada;ICLEI_Canada;We provide capacity building, consulting, training, and information services to support local governments in becoming more sustainable.;4755;682;2033;1216;8686
clement_sas;𝕮𝖑𝖊𝖒 🛩;Me gusta Shakira, me gustas tù;532;107;53;7992;8684
BelaidGabriela;Gabriela belaid;#feministe Secrétaire générale Ensemble contre le Sexisme  -Présidente CentraleSupélec au Féminin - Directrice de projet IT - #Esanté - compte perso;1885;3427;833;2529;8674
MisteurPopcorn;Misteusr.popcornð¤¯ð¿ð¿;;6516;75;43;2010;8644
T1Zoki;Да ми го јадиш куров Македонски;;6288;192;25;2139;8644
DiegoCreimer;Diego Creimer;Directeur, Finance et Biodiversité - Société pour la nature et les parcs (SNAP Québec). Mes tweets n'engagent que vous.;4320;988;1068;2258;8634
DeBeaujoire;amis.de.la.beaujoire@gmail.com;"Non à la privatisation de nos espaces publics !!!
Né suite au grand projet urbain imposé Yellopark, on a connu la novlangue métropolitaine.";6107;214;309;2003;8633
GazParTlse;GazPar;;3586;145;37;4860;8628
jfldu15;jfl;;4920;88;56;3562;8626
Jindependant;Le Jeune Indépendant;Quotidien généraliste algérien doyen de la presse privée en #Algérie fondé le 28 mars 1990;6796;0;1796;21;8613
groupeQUALITEL;Groupe Qualitel;Notre mission est de promouvoir la qualité du #logement par la #certification, l'évaluation, la formation des professionnels et l’information du grand public.;4238;330;1773;2271;8612
Montesqieu1949;Bastenier Dominique;;5845;284;71;2411;8611
la_mesange_;la mésange;"photo, vidéo, gaming, nature, astronomie, suisse.
Etudiant en biologie (1ere de master), je touche à tout ce qui m'intéresse.
No more #fakesScience";7478;138;50;944;8610
AMancipoz;▫️André Mancipoz▫️🇫🇷;Élu local #Asnières Boucle Nord de Seine #Dirigeant #Administrateur. Ancien VP @EssecAlumni .Tweets personnels. Anonymes exclus. #Startups #UrbanAG #FoodTech;7436;264;896;1;8597
TLGLePtitGars;LePtitGars;;5482;746;676;1691;8595
arefsalem;Aref Salem;Chef de l'Opposition officielle à l'Hôtel de ville de Montréal et conseiller de la Ville dans @ArrSaintLaurent pour @EnsembleMtl. @MTL_Ville #polmtl;2879;1681;2532;1496;8588
lunatio27;Robin;;5338;418;37;2795;8588
SuzieDep;💥 Angry Bitch 💥;;2705;73;45;5764;8587
Adsl69;adsl;đ”đč;8127;58;21;377;8583
PE_Picard;Pierre Picard;;6120;121;150;2192;8583
ElodieDorfiac;Elodie Dorfiac;Adjointe à la Maire en charge de la transition écologique et des mobilités #Châtillon 92320 #ecolo🌻;1785;399;470;5927;8581
bulapat1900;đź‡¨đź‡©patriote congolais đź‡¨đź‡©;PersonnalitĂ© publique;6175;1180;677;545;8577
visagesdubenin;OKOYA Francis Z.;"Consultant-Formateur en Stratégies de Com' et Médias.
Spécialiste des questions parlementaires

***Contacts : fran7fr@gmail.com
Tél: 97 77 23 01 et 99 22 21 11";4360;477;3711;29;8577
lesradicaux_;Les Radicaux;Les Radicaux : mouvement citoyen indépendant pour une République laïque et solidaire.  Combat tous les extrêmes.;2784;4704;821;266;8575
Sauvonslepays;Karo;"Sauvons le pays du chaos ð«ð· #antiwoke #antiislamogauchisme
#Teampatriotes #MLaFrance
#jambonbeurre";1026;1247;1087;5214;8574
enedis_lorraine;Enedis en Lorraine;@Enedis - Départements 55 (#Meuse), 54 (#MeurtheEtMoselle), 57 (#Moselle) et 88 (#Vosges) #ServicePublic #TransitionEcologique;4928;447;2194;1004;8573
aeclualaba;Alternance pour l'émergence du Congo/LUALABA;Compe twitter officiel de Alternance pour l'émergence du Congo parti politique cher de l'honorable #Georges #KAZADI , fédération du #LUALABA;471;448;595;7058;8572
CarlosMongala;Carlos Mongala;PANAFRICANIST;1114;293;344;6819;8570
GeorgesLooney;Georges Looney;Wat else?;5247;94;11;3216;8568
desmeules_josee;Josée Desmeules;Militante Mobilisation 6600 Parc-nature MHM. Nous luttons pour protéger les rares milieux naturels restants et contre la réindustrialisation dans ASLP.;2374;236;124;5832;8566
GerardMardine;Gerard Mardine;ex Secrétaire général @CFECGC militant pour une économie respectueuse et au service de l'être humain;3840;1524;1947;1253;8564
SlimeKuro;Jo;girls with horns are perfect;7611;306;51;593;8561
CecileVignesM;CecileVignesMösch;"🌾Pte fondatrice #NosQuartiersDemain☘️🌱🌳 #MarseilleEnTransition
#NouvelleDémocratieLocale Conseillère D'arrondissements #Degrowth";2995;1992;715;2856;8558
GPdePau;Pau Motors Festival;đ„đ RĂ©servez vos week-ends du 12/13/14 mai et 19/20/21 mai 2023 #GPPAU #PauMotorsFestival #ClassicGrandPrix;2953;1357;1775;2469;8554
E_chibinda;Elias Chibinda;ð Health Systems Policy and Management , Student at ULPGL/ Goma, Humanitarian work, Public Health, self development, passionate about books;502;269;119;7656;8546
AudeLuquet77;Aude Luquet;Députée 1ère circonscription de #SeineetMarne | Vice-présidente @DeputesDem | Whip @AN_DevDur |;3065;840;2495;2145;8545
NadineLevratto;Nadine Levratto;"Ăconomiste, directrice de recherche au CNRS 
đ L'Ă©tonnante disparitĂ© des territoire industriels (Pr. Ecole des Mines); Les Ă©cosystĂšmes entrepreneuriaux (ISTE)";1863;884;2983;2814;8544
P_uopuoP;xBelinun;;729;133;41;7639;8542
EricTHIROUIN;Eric THIROUIN;Agriculteur engagé pour porter la voix de l’#agriculture. Pdt @AGPB_cerealiers @UnigrainsGroup @chambagri28, Tréso @FNSEA #Produireplus #Produiremieux;3349;611;2536;2038;8534
chalopinbauge;Philippe Chalopin;Maire @Baugeenanjou, Président @BaugeoisVallee, Vice-Président @maine_et_loire, Président @49numerique @Anjoutourisme @Amf49Maires;2856;332;1315;4026;8529
JeanMichelGorry;GORRY Jean Michel;Agriculteur, de ceux qui nourrissent leurs semblables.;4056;190;123;4148;8517
flying_couscous;Flying Couscous 🧅;Troll des bois;6122;361;64;1964;8511
VirginieGuerin2;Virginie Delugeard-Guerin;CEO Cocottarium - urbaniste et consultante en #TransitionEcologique pour des #TerritoiresDurables @cocottarium @worldcleanupdayfrance;1877;452;398;5782;8509
bidouillou44;caragreg 🇫🇷✝️;je ne suis pas inspiré;4500;1910;587;1512;8509
joinvilleEM;Renaissance Joinville-le-Pont;"Comité local de Renaissance à Joinville-le-Pont
Rejoignez-nous.";3452;78;391;4580;8501
MoukouB;moukou BERNARD;;6911;130;15;1445;8501
MRadnou;MRadnou;#Team974 Codeur passionné🏗️ | #Java #Python #TS #React #NestJS #NextJS #Flutter | Safran🛩️ | Freelance🌐 | Éco-innovation🌳 | (github.com/radnou);1830;1074;79;5499;8482
PMonoxyle;ð«ð·Piroguier Monoxyle;"Je suis un artiste perfectionniste et Ã©pris de justice.
Je ne veux pas que l'on m'emmerde et ne crains personne.
Ã mon Ã¢ge je me fous du jugement des autres.";4871;665;600;2331;8467
SeronineN;Merline NGN;"I am unique.
Data sciencist.  mom .  Investor  . Friend . Sister .  Daughter. I am busy questioning my life. Searching for my own  way";5071;374;153;2864;8462
DamF_tweet;Dam F;fan d’actualités de tous genre - pour réfléchir et anticiper : sciences, culture, tech, sport, (géo)politique…;6999;136;50;1271;8456
_alexisrbn;Alexis 🦅;🧟‍♂️;2262;131;87;5976;8456
MarocCooperativ;Coops Maroc (Vivement_ESS_performant);"COOP IS BEAUTIFUL #Ess #coops #coopératives_Maroc Je retweete souvent autour de ces thèmes.
All our dreams can come true, if we have the courage to pursue them";6599;333;476;1046;8454
totodoco;Lionel T.;cette année,  je choisis d'essayer de rester pragmatique.;2129;53;101;6171;8454
molbol109;Mol Bol φ;"A force de chanter, tu oublieras de pleurer !
La vie, c'est du visible ... et de l'invisible aussi ...
Fachos passez votre chemin maculé de m----";2493;1930;948;3072;8443
CQFDCADRES78;CQFD CADRES78;CQFD Cadres 78, #Réseau Ouest francilien pour l'#emploicadres, est une association de #cadres au service des cadres.... suivre #i4Emploi;6251;173;259;1757;8440
thierryopa;Thierry;;4991;78;34;3334;8437
RomannKer;Romann Kermanac'h đ±;Conseiller RĂ©gional des @paysdelaloire || President des Jeunes UDI de Loire-Atlantique;2211;1252;602;4371;8436
boutentrain75;dlr;L œil était dans la tombe et regardait Cain;5834;216;95;2286;8431
BonneauLine;Line Bonneau;Citoyenne engagée. Protectrice d'aires naturelles.;6044;430;224;1731;8429
NajimAbderrahi7;Najim Abderrahim;régler;2429;84;25;5890;8428
MartinJasmine17;Jasmine Martin;les travaux avancent...ðððð³ð³;3159;803;170;4292;8424
RichardTibus;Richard TIBUS;Produire moins, partager plus, décider ensemble;881;143;22;7371;8417
ANECNiger;ANEC Niger;Bienvenue sur le compte officiel de l’Agence Nationale de l' Economie des Conférences « ANEC».;689;51;7432;242;8414
Mimsmich;Mich;#crypto #cryptomonnaie #cryptocurrency;3287;1182;146;3790;8405
Industrie_Mag;Industrie du Maroc Magazine;Industrie du Maroc est le premier magazine mensuel marocain dédié à l’industrie, l'investissement et l'innovation;3761;997;3205;439;8402
cTmieuxJadis;cTmieuxAvant;"Qui sait si le monde sera meilleur demain.

Merci ReconquĂȘte de rendre possible cet espoir.

Vive la France đšđ”.

Y'a qu'Ă , faut qu'Ă , quand on veut, on peut.";3056;1860;464;3017;8397
Oktiabrionok;Komilfotnost';"Pendant la fin du monde
Il est recommandé
De suivre z'à la lettre les instructions
De la société chargée des modalités";4714;420;76;3186;8396
VilleduPre;Ville du Pré;Twitter officiel de la ville du Pré Saint-Gervais (93), pour suivre l'actu gervaisienne. #villedupré;5181;255;2426;533;8395
louis_germain;Louis Germain;N'a rien appris Ă  Albert Camus | Collaborateur politique dans la Somme | @EELV Team @LaSuite22 đźŚ»đźź˘ | @cfjparis 72, @ScPoLyon, @uni_copenhagen đź‡©đź‡°;2315;1471;514;4089;8389
surffinance;Surf Finance;Média online sur la #finance : #crypto #bourse #economie #assurances #banques #epargne #immobilier;5286;1620;1414;67;8387
Bontempskvt;Bontemps Karine;Dirigeante #entrepreneuse #stratégie projets #Innovation #transformationdigitale #formation intelligence Artificielle #IA #AI #TransfoNum #Lyon #cybersécurité;3330;2153;700;2198;8381
aegir_fr;aegir_fr đ§đ;Vieil informaticien qui a commencĂ© par l'ASM Z80 au lycĂ©e. Depuis 1995 spĂ©cialisĂ© en SGBDr et depuis 1998 sur #PostgreSQL. @aegir_fr@mastodon.social;6832;127;52;1362;8373
TUNISIANFUTURE;Tounes El Khadra ð;La Tunisie de demain. Ãconomie â¢ GÃ©opolitique â¢ Ãnergie â¢ Transports â¢ SantÃ© â¢ Ãcologie ð¹ð³ âªï¸;2120;133;5333;787;8373
BusinessIQ_;business-iq.net;The content platform for business professionals. Education, Case Studies, Whitepaper and more.;5816;33;2524;0;8373
FrancegazAURA;France gaz Auvergne Rhône-Alpes;"France gaz Auvergne-Rhône-Alpes 

#gaznaturel #biométhane #biogaz #gazliquides #hydrogène
#AURA #Lyon #Grenoble #StEtienne #ClermontFerrand";4395;555;738;2671;8359
kuma_jima;Yamahiguma 熊;"Thésard en droit social.

Karaté, rando et Histoire. フランス在住30年の日本人です。";475;369;42;7473;8359
LenergieEQ;L'Energie en Questions;Site d'intérêt général pour informer et répondre aux questions d'actualité des Français concernant l'#energie #EnR #electricité #gaz;4749;967;1845;796;8357
TV5MONDE_pro;TV5MONDE PRO;Bienvenue sur le compte professionnel de l’équipe Communication / Presse / Partenariat de @TV5MONDE, premier réseau télévisuel culturel #francophone mondial;3174;613;3140;1425;8352
foulougolf;Foulougolf;Dr Ing retraité avec encore assez de connaissances pour comprendre les enjeux du climat et de l'énergie, moteur de notre bien être. Ecologue donc pronucléaire.;4594;29;60;3663;8346
IFDD_OIF;IFDD;"Institut de la Francophonie pour le développement durable (IFDD).
Organe subsidiaire de @OIFrancophonie. 
#DéveloppementDurable #Energie #Environnement #ODD";2159;701;4940;545;8345
AkaElHadj;AKA El hadj;Rédacteur web privé, homme de lettres.;6137;294;60;1849;8340
RE_RueilMalmais;Renaissance Rueil-Malmaison;Rejoignez-nous parti-renaissance.fr Compte officiel Renaissance Rueil-Malmaison Citoyens Européens Libres-penseurs Progressistes Audacieux Écologistes;1915;645;941;4831;8332
K0bayashi_maru;Kobayashi đŽââ ïžđ«đ·;Trust me! Iâm an engineer!;5730;116;139;2347;8332
ctrlstopmusic;François BDF // Ctrl+Stop;"Researcher / Producer / Enthousiast. 
Sociologie et criminologie : 
Vandalisme, Propriété, Trafics de drogue, Politiques publiques
+Mastering @ Beat Boutik Rec.";2463;704;150;5012;8329
lyc_bascan_ramb;Lycée Louis Bascan 🇪🇺🇺🇦🕊;Enseignement général et technologique. Enseignement professionnel.;6706;74;1105;441;8326
biblio_estp;Centre de doc' ESTP;Les documentalistes vous informent #architecture #construction #BTP #géniecivil #matériaux #grandesécoles #DD #ingénierie;6807;111;1329;73;8320
africarriere;afri-carrieres.com | Opportunités pour africains;"Trouvez des bourses d'études, appel à candidature, concours, compétitions, emplois, stages, prix, bourses international,
Pour infos: contact@africarrieres.com";5520;393;1193;1214;8320
Mondjolo;Veille SupagroFlorac;Ce fil Twitter concerne principalement les TICE, pour le bulletin de veille complet (péda, EEDD, agriculture...) voir : tinyurl.com/crpwfkj;7880;108;323;8;8319
SteffanPascal;pascal steffan;Passionné aimant les bonnes choses de la vie;1472;107;68;6669;8316
Gavroche_media;Gavroche;Premier média étudiant de la gauche souveraine • En quête de vérité, enquêtes d'insurgés • Association • DM ouverts aux questions;2034;227;3311;2740;8312
Articlophile;Articlophile;Lectures et Curation | #Articlophile;5122;575;578;2031;8306
Grain2Vie;Marjan Henricowicz;Décroissance / Génération écologie / né à 333,8 PPM / Vive le temps libéré du productivisme et de la croissance ! @GEcologie #degrowth #planetboundaries;4058;945;552;2750;8305
AmbCanAllemagne;Canada en Allemagne;Ambassade du Canada en Allemagne- English: @CanEmbGermany - Deutsch: @KanadaBotschaft - Informations supplémentaires sur covid-19:  bit.ly/canadaFR;4405;434;2762;703;8304
Louise008;Louise Giguère;;3426;156;72;4644;8298
tinenzeyimana;Martine Nzeyimana;| SRHR | Gender Equality. She\ Her;2463;858;1511;3465;8297
HistoryTom007;Tommy;"Je me méfie des partis.
Ils deviennent facilement des partis-pris.

Louis Charles Jean Robert de Mazade";2608;136;12;5535;8291
Mbalondrade;Mickael Balondrade;DG #BeEnergy ⚡️- Expert & Conférencier en intelligence économique -💡Consultant Stratégie-Marketing-Vente I📗 Auteur Forbes I Passion sport🏃 Défaut gourmand 🍭;6728;612;677;273;8290
CThomas2A;GOAT Toto;;2300;1895;1130;2963;8288
VoidSimonF;Simon Francoeur;Web designer/Developer since 1998 and a strong supporter of Nihilism.;4840;44;42;3357;8283
swiss_roufa;Roufa 🇨🇭;Une suissesse 🇨🇭;1080;1793;92;5314;8279
nathalie_dini;Nathalie DINI;Déléguée Régionale @engieGroup Auvergne-Rhône-Alpes.;1584;2480;2269;1937;8270
martingabriel_3;Martin GABRIEL;;5353;717;681;1515;8266
olivierabahati1;Olivier Bahati;;978;828;538;5921;8265
unfpaniger;UNFPA Niger;Réaliser un monde ou chaque grossesse est désirée...chaque accouchement est sans danger...et le potentiel de chaque jeune est accompli.;553;493;7108;108;8262
filierebeton;La Filière Béton;Le compte officiel de la Filière Béton, pour un futur responsable;3130;2211;2209;712;8262
peertube_stream;PeerTube.stream;"Instance PeerTube créée principalement pour les lives.
Administrateur : @raphgilles";8013;4;70;173;8260
PRacamier;Patrice Racamier;Intelligence;5002;92;40;3118;8252
MustaphaChaba10;Alpache;;2803;25;32;5390;8250
EspritlibreBen;Pris dans matrice à cause des faibles d’esprit;Guerrier dans l’âme, je dénonce le système de contrôle, l’arnaque KVID, les 💉☠️et le plan 2030, je veux rien savoir des croyants à la nouvelle religion KVID;4778;442;418;2610;8248
L_offusque;gaulois refractaire;not working is not a crime;7114;566;216;349;8245
sercatr;Jérôme S.;"Fervent défenseur du hasard et des maths. Pastafarien.
J'irai où Emmanuelle Ducros et Ricky Gervais iront. Ingé travaux maritimes et EnR.";3902;205;170;3963;8240
SPMla1ere;Saint-Pierre et Miquelon la 1ère;Compte officiel de Saint-Pierre et Miquelon la 1ère (@Francetele) /  Radio - TV - Internet;5515;77;2603;39;8234
Mariogwada1;shomarigwada;;4708;59;22;3439;8228
Indep_Senat;Indépendants Sénat;Compte officiel du Groupe #LesIndépendants - République & Territoires au #Sénat | #QAG • #DirectSenat | Président @ClaudeMalhuret;3006;1118;2729;1368;8221
al__Pacha;al Pacha م;Géographe urbaniste 🗺 Mim comme Muslim ☝️ défenseur des droits des majoritaires au Moyen-Orient;2140;747;345;4989;8221
DiependaeleG;Diependaele Gérald;"Pharmacien militaire ayant étudié à l'UCL
Grand amateur de sport et supporter du RSC Anderlecht
Bédéphile";4545;168;80;3425;8218
PlanetSciOccit;PlaneteSciencesOccitanie;Association loi 1901. Animations/évènements scientifiques, centres de loisirs, colonies de vacances, opérations scolaires et fablab éducatif à Ramonville !;2492;1177;1109;3437;8215
xelu_eth;BrokMuvOnly;Double OG crypto / l’informaticien de ta grand mère 🫐 🔴🟡 🎠✨ 888 #ARB;4037;332;348;3493;8210
mieparis;Etudiant·es à Paris;"La Maison des initiatives étudiantes vous accompagne à @Paris au
📍50 rue des Tournelles : Formations, appels à projets, aides alimentaires, santé mentale";4319;508;2269;1109;8205
mugulaeric;Mugulaeric;libéral, soife de servir les autres, politique;5697;1209;651;642;8199
PatDucratin;Patrick Ducratin OFFICIEL;Maire de Crougnières | Fier de ses convictions | A l'écoute des Français #EnAvantCrougnieres #Crougnieres2020  🇫🇷;7871;249;65;13;8198
Buglitch000;Bug-omb (shikai era ★);ravachol 💥 apolitique d'ultra-gauche post-troskiste ✧ sail to the moon;3674;709;126;3689;8198
fraise84x;fraise84x;;6217;51;29;1895;8192
loomyz;Use Y'urhead;Ce servir de sa tête n'a jamais fait de mal à personne, alors utilisez la votre si vous en avez une!;6181;16;54;1937;8188
YHaury44;Yannick Haury;Député du Pays de Retz 9ème circo Loire-Atlantique #Ensemble de la #MajoritéPrésidentielle #législatives2022 #avecvous #LaRem #Renaissance;2133;1054;4449;550;8186
Ammin_Youssouf;Ammin;Co-Founder @SocialAfrobytes & @TheColorsAfrica/ GM @AdvClb Paris/ Founder & ex-CEO @big_youth/ Top 100 Most Creative People in Business by @FastCompany;2429;665;1706;3383;8183
icones_media;ICONES.MEDIA;"Le média qui icônise 👸🏼👸🏻👸🏽👸🏾👸🏿 par @thenextmaker
Et ici, on t’aide à devenir une icône👇
iconescoaching.com";4098;1744;1756;582;8180
CiteDesChances;L'équipe Cité des Chances;Association apartisane qui démocratise la démocratie auprès des jeunes de banlieues et quartiers populaires ! #Citoyenneté #EducationPopulaire #Empowerment;2338;309;4494;1035;8176
OEHC_;OEHC;Contu ufficiale di l'Offiziu d'Ecchippamentu Idrolicu di Corsica;2033;1732;1911;2496;8172
Pauloyeo;Yeo N'goloho Paul;Service Santé;1419;1009;217;5520;8165
BamabiKc;Kcslam🇲🇱🇨🇮🇬🇳;Korotoumou Cissé artiste slameuse féministe engagée;2907;514;694;4049;8164
Franck39581060;Franck;Music, from punk rock to shoegaze, with a bit of heavy metal and some brit pop too. Vinyl lover. Nature lover. Poetry lover.  MS warrior. Welcome;3424;1109;437;3193;8163
Luxjean3;Lux jean;;228;65;32;7838;8163
arimaximilien;Nishimagizwe  Max;"Ingénieur Technicien en Telecoms.

Passioné par l'actualité mondiale.Sports en général , Football avant tout";4840;911;451;1959;8161
fxhuard;François-Xavier Huard;Président - directeur général de la Fédération nationale de l'industrie laitière @FNIL75 - ex @Economie_Gouv #CréateursDeProduitsLaitiers;3539;638;1053;2922;8152
JulieBlouin11;Julie Blouin;;5630;127;63;2331;8151
ClaudeLENGLET;Claude Lenglet;Acteur engagé de la Troisième Révolution Industrielle. Mes tweets n'engagent que moi. Résolument pro-Européen et pro vaccination .;2697;341;835;4274;8147
UtopieNumerique;Sebastien Claeys;Professeur associé @LettresSorbonne, Débat public @EspaceEthique, auteur @Ed_LePommier;1817;1360;1029;3939;8145
Kermitofmyballs;Shoryuka;"marginal, apolitical, data hoarder, stoic, allergic to manipulation
If it's obvious it's not necessarily highlighting the latter purpose";4968;378;51;2745;8142
trouldar;Kamel Trouldar;Je suis unique en mon genre, bien dans ma tête ... bien dans mes basket;2041;127;63;5911;8142
CanadaenItalie;Canada en Italie;Ambassade du Canada en Italie - English @CanadainItaly - Italiano: @CanadainItalia international.gc.ca/socialme…;5148;189;1915;885;8137
cryptomed34;đźš€med-ia 34;"#Bitcoin
#Tesla
#IA";673;615;145;6702;8135
sev_anto;Anto;;112;217;6;7800;8135
Locutus80;Locutus ⚛️🧪🖖;"Code is the law
Science is truth
Caring other is peace";1547;786;68;5734;8135
CKerrero;Christophe Kerrero;Recteur de la région académique Île-de-France, chancelier des universités, recteur de l’académie de Paris @Academie_Paris @SorbonneFr @RaIledeFrance;2206;1334;3484;1107;8131
lrigaux;Laurent Rigaux;Journaliste insulaire • @iciradiocanada • ex @lavoixacadienne @FrancopresseAPF @lalsace @SciencePresse @contexteenergie • @CUEJ_info promo Hanoï • Ex-ingénieur;4809;625;590;2096;8120
al1roques;Alain Roques;"Champagne lover 🍾, amateur photographer,  retired journalist -but being a journalist is beyond retirement age-.
мало знаю,но многое умею...";5557;135;123;2305;8120
Schnee68365686;Schnee 🇲🇫;Rigolons un peu des bêtises de droite et de gauche;2272;259;67;5520;8118
WNaitMazi;William NAIT MAZI;Manager AI for Sustainability & Climat change| Elasmo & Cephalopoda lover ðð¦ ð¦ | Compte personnel #RSE #CSR #IA #AI #Climatechange;245;3760;426;3685;8116
frdj33;f delort;À Bordeaux, je vote contre la pollution de l’air ! Les candidat·es aux #Municipales2020 doivent faire preuve de courage et s’engager à réduire le trafic routier;6675;81;33;1326;8115
maleye_diop;Maleye Diop;UNDP Resident Representative Mali. Former UNDP Congo Brazza + Burkina+Mali+Global Manager UNDP Public-Private Partship. Tweets own views & RTs not endorsements.;1634;562;2130;3786;8112
Reconquete28;Reconquête ! | Eure-et-Loir;"Twitter officiel de la fédération Reconquête! d’Eure-et-Loir 🇫🇷🌿

📩 dpt28@parti-reconquete.fr";2661;371;1009;4070;8111
ApollodoreLive;Apollodore;Observateur et citoyen de gauche (affligé), ancien syndicaliste actif. Ex-LePost.fr;4945;913;207;2039;8104
JeanpierreXavi1;Jean-pierre Xavier;;3762;405;47;3889;8103
md_gusgus;Doc. Gus ð¦·;Orthodontie et EsthÃ©tique ð¦· World Traveller ð âï¸;4279;231;1648;1940;8098
TBorneady;Tresor_Borneady;...;2925;113;48;5007;8093
SpacEarth_In;SpacEarth Initiative;Notre mission : mettre le spatial franco-europÃ©en au service des citoyen(ne)s. ðð° Aux commandes : les industries de la filiÃ¨re spatiale @GifasOfficiel.ð§âð;367;307;6449;968;8091
leon_guyot;Lionel lucien leon guyot;Chauffeur SPL .poliactive;2022;168;102;5794;8086
SergeGrouard;Serge Grouard;Maire d'#Orléans et Président d'Orléans Métropole;1337;1130;5024;593;8084
__srah672;سارة🪐;@__srah672pv;3205;348;386;4136;8075
loicBurel44;loïc Burel;;1428;94;62;6490;8074
WyzigardF;Wyzigard;Seule la logique et le bon sens commun sont nécessaires pour vivre en France : nous sommes avant tout français, héritiers d'une histoire.;5006;134;79;2843;8062
wouchenmountain;☝️ⵣ Cheikh En Boa 🇲🇦🪵;;4923;792;76;2266;8057
CyprienPoutrain;Cyprien Poutrain;#NUPES, crois à l’humanisme démocratique. La haine rend fou, l’empathie rend humain.;1611;736;561;5142;8050
haricotsbleus;Noa c:;"🌴80'𝐬 𝐃𝐈𝐒𝐂𝐎 𝐓𝐎𝐓𝐀𝐋𝐈𝐓𝐀𝐑𝐈𝐀𝐍🍹

Insta : noa_sli";2726;135;120;5067;8048
sven_olgson;Jeff Tweety ð¸;"Montage, rÃ©al, photographie. 
Pics & reports @ theheavychronicles.com
Videos & pics @ sylvain-golvet.com
New video : piped.video/d0BgNMl8IAE
Insta : @sven";3306;476;194;4064;8040
DomangeB;DOMANGE Bernard;"Artiste peintre ... mon pinceau suit plus volontiers les beautés de la nature que les vicissitudes humaines; il n'empêche, il sait résister ...";3370;505;515;3650;8040
LaplaneF;Laplane Florence;Architecte DPLG Respirologue Spécialiste du souffle dans tous ses états;2968;108;110;4853;8039
InfoBassin;InfoBassin;InfoBassin est un nouveau site de Presse pour les habitants du Bassin d’Arcachon, et les internautes intéressés.;4986;135;2891;24;8036
MaxYmeMusic;MaxVeG;"Mastodon : @maxyme@piaille.fr 
Heavy metal & prog | fan de maths abstraites | vegan | E-G
Achète mon album : 
CRYSTAL THRONE : crystalthrone.bandcamp.com";1928;117;4923;1067;8035
Jalabertpascal;Pascal Jalabert;Journaliste, éditorialiste politique, formateur, conseil;4059;1487;2142;347;8035
antoinecaplan;Antoine Caplan;"Candidat aux élections sénatoriales 2023
conseiller départemental • adjoint aux finances et aux commerces @Laval_la_Ville • rapporteur du budget @LavalAgglo";1586;954;1321;4165;8026
Plandemie19;Keyzo đšđ”;"Un Mensonge RĂ©pĂ©tĂ© Mille Fois đșđđ
                                  Ne Deviendra Jamais Une VĂ©ritĂ© đđ€Šâł

đšđ”đœđ§ đ„â€ïž

#LibertĂ©
#Frexit
#Article68";4071;642;345;2966;8024
HerveDebois;H2guerre;Humour Anglais bien lourd, mais français pour les Vannes !;4520;26;29;3444;8019
kiloutou;Kiloutou;"Bienvenue sur le compte officiel du groupe Kiloutou. 
Suivez notre #actualité & celle du #BTP !";4590;193;2044;1190;8017
cntguinee1;Conseil National de la Transition GN;Compte officiel du Conseil National de la Transition (CNT) Guinée;404;1036;5851;717;8008
MasenOfficiel;Masen;Masen, force inépuisable de développement #énergies_renouvelables #Maroc #ENR;2429;437;3895;1245;8006
DLVisionMode;Diane Lessard;"Suivre ses passions et capter l'air du temps
Rédactrice Mode, Art & Tendances de société
Site Web : DL Vision Mode
dlvisionmode.com";4160;372;267;3203;8002
BorgnietR;BORGNIET Rodolphe;"Adj au Numérique et à l'Innovation a @mairiedu16  Paris. 
Président de made in paris Luxury Fragrances.
hypsoe.fr apotheca.paris";1229;1454;922;4396;8001
EVAMBRAINUP_HA;Hélène Armande AUGUSTIN;ACCUSED DURING 11.09.01 EVENT OF PARANORMAL ACTIVITIES BY STUPIDS PERSONS WHO WANT SHOUT ME FOR JUSTICE. ERASED MY FIGURE WITH ACID , JUST TO THIEF MY FORTUNE!;4229;3478;98;195;8000
Pisan_03;Bourse PEA;More combat is harder, victory is beautiful. #bourse #action #dividende #trading #cac40;4420;165;297;3116;7998
BonsensDu;Du Bonsens;Les évènements de la vie n’arrêtent pas de me questionner! Mais adepte du simple bon sens...;6716;398;193;682;7989
Remi_Dubois_;remi dubois;Mes tweets n'engagent que ceux qui les lisent;5401;468;277;1833;7979
1001010P;J&P;đ¶;1094;77;20;6785;7976
RousseauxArnaud;Arnaud Rousseaux;Directeur général du Groupe Orchidées - Associations au service des séniors;1307;977;704;4985;7973
TurkEmbAbidjan;T.C. Abidjan Büyükelçiliği;Türkiye Cumhuriyeti Abidjan Büyükelçiliği - Ambassade de la République de Türkiye à Abidjan;2339;236;3859;1538;7972
YannickCanovas;Yannick Canovas;;706;385;27;6851;7969
r_naturellement;Reims Naturellement;Groupe de la majorité municipale unie autour d’Arnaud Robinet, Maire de Reims;3038;502;1127;3301;7968
DupontKarine11;Dupont Karine;;1833;463;44;5624;7964
quitain_a;A.quitain ð¸ LE GRAND CHANGEMENT APPROCHE ð¡;-/Ã·*+3~^:__1 NOUS AVONS ÃTÃ PRÃVENUS ET QU'AVONS-NOUS FAIT? â¡ï¸;6078;1620;74;188;7960
phdorthe33;Philippe Dorthe;"Président du Grand Port Maritime de Bordeaux.
Conseiller régional honoraire de la NouvelleAquitaine.
Conseiller départemental honoraire de la Gironde.";3028;982;1990;1958;7958
LeDuoMalseant;Le Duo Malséant;"El Duo.

Double Du, Hémicycliste du dimanche
Monsieur Za, Paléographe de l'humour

Leur mission : Pousser la langue française dans ses derniers retranchoirs.";3349;115;292;4188;7944
SPG_socrate;SPG;(M. Sc.) – économie appliquée. pour le libre marché!  la gauche nous ruinera ! notre argent c'est la notre, pas celle des queteux inefficaces;6685;144;95;1007;7931
Gandalf164;Gandalf_164 ð·ðº;"ObligÃ© de repartir de 0 aprÃ¨s une suspension dÃ©finitive...

Ma France est morte avec le rÃ©sultat truquÃ© du 20/09/1992... et depuis, j'attends le FREXIT...";3788;960;815;2366;7929
MaximeKonan02;Maxime Konan;J'aime beaucoup mangé le foutou igname de la Côte d'Ivoire , accompagné du vin blanc baoulé.;913;1300;132;5577;7922
bouleber;bertrand boulenger;Journaliste de sport, passé par @ESJLille. Collaborateur pour @LeCycle1 et @lavoixdunord. Cycliste et photographe animalier à mes heures perdues.;3134;185;188;4410;7917
AsnieresPcf;PCF Asnières;"Compte du PCF Asnières,
réseau social depuis 1920";3073;922;513;3405;7913
EVSUMR5600;Environnement Ville Société;"Laboratoire de recherche @CNRS
La pluralité scientifique pour comprendre les dynamiques des changements actuels et passés";1156;596;1081;5079;7912
PHILM7777;Mer;"Passionné par la redynamisation & le développement des centres villes.#FrenchTech #smartcity #IA
Digital Economy  
Université Paris 2. ESC Paris";4931;118;125;2730;7904
Obi_Yamato;Kami Sama;Les gens sur le net ont tous une énorme paire pour t'insulter, quand tu les rencontres dans la rue, ils baissent les yeux et prient pour ta clémence.;7535;60;35;268;7898
semouelhi;Seif;Punchliner - Barlou everyday - Road Glide rider - Berets MC Enforcer. Views, facts and opinions are mine.;3426;475;452;3544;7897
J_Pmag;Jumelages-Partenariats;"1er site dédié aux #coopérations #décentralisées, #jumelages à travers le monde
■L'actualité sur le fil
■Événements 
■Dossiers
📰Abonnez-vous bit.ly/2wsD";5992;1282;359;259;7892
BoujenaO;Othman Boujena;PhD, Associate Professor of Marketing, CRM & Big Data Passionate #research #pedagogy #neomabs #businessschool #AI #DesignThinking #CX #tech #Trends #marketing;6379;567;207;737;7890
PierreLeoMontr2;Pierre Leo Montreuil ð´ââ ï¸;;3377;138;77;4290;7882
cci_ardennes;CCI Ardennes;La CCI 08 accompagne le #développement des #entreprises et des #commerces qui souhaitent créer, transmettre, exporter ainsi que les porteurs de projets.;3077;728;1113;2962;7880
fannysarrail;SARRAIL Fanny;Mes tweets n'engagent que moið¤ Doctorante Cifre U-Psud - Ufolep (in)capacitÃ© d'adaptation des fÃ©dÃ©rations sportives face aux changements sociÃ©taux  ?;1163;917;443;5357;7880
jeanluclacroix7;jean-luc lacroix;;6813;50;33;983;7879
AffoudaI;AFFOUDA Foumilayo Isabelle;"Passionnée de l'#Agrobusiness
#TechniciennedeProductionVégétale
#BestofFarmingBusiness ; #Agriculture ; #Team229 ; #wasexo ; #FTIC";5655;96;330;1795;7876
Lavorred;Luigi Lavored;S'exprime avec respect, attend la même attitude. Simples commentaires ou avis.;5543;406;60;1851;7860
BernierChri;BERNIER Christophe;"Conseiller municipal délégué aux politiques en direction des personnes porteuses de #handicap à #Gennevilliers

Administrateur @Velib
🇫🇷 🇪🇺";5824;1030;782;221;7857
lemiroirdunord;le miroir du Nord;"Journal d'information en ligne traitant de l'actualité dans le Nord Pas de Calais : Flandre, Artois et Hainaut. Information alternative.
https://lemiroirdunord.";2777;1268;366;3444;7855
FreDRvet;RAVET Frédéric;Docteur Ingénieur en mécanique des fluides, impliqué dans la réflexion et la construction du futur énergétique compatible des contraintes climatiques;3269;47;53;4477;7846
LMJMpacific;LMJMpacificđź‡Şđź‡ş;"FranĂ§ais du monde, europĂ©en de coeur
Mission: contribuer au rayonnement de la France dans le monde";2721;41;21;5061;7844
Lazarocerrutti;Doc Nuit;;2066;196;118;5461;7841
morgane_69;Morgane69;;5751;379;75;1635;7840
MahutinCarlos;Carlos Mahutin Hounnouvi;Crypto trader¦¦Community management¦¦ Content Creator¦¦Brand Ambassador;565;2290;1104;3880;7839
FatimaHamatim;NDIAYE FATIMA;"Responsable #Evénementiel #Relations #Publiques @Le_CIDJ 
4 place du Louvre, Paris 1er";2667;566;539;4066;7838
ApecNormandie;Apec Normandie;Recruteurs, cadres et jeunes diplômés en Normandie : des infos, des conseils pour de belles rencontres professionnelles ! #emploi #recrutement #normandie;3777;572;1102;2386;7837
MamerEric2;Eric Mamer;Porte-parole en chef de la Commission @vonderleyen. In English on @MamerEric;1293;93;6068;379;7833
LookSharpParis;Look Sharp;Conseil en Communication & #Relationspresse #Relationspubliques #Startup #Innovation #RSE #DD #SmartCity #RH Membre @RsoEntreprendre soutien @viensvoirmontaf;4810;1199;1033;791;7833
fighter_l1;M.N jr;;2436;253;115;5024;7828
MonsieurEco;MonsieurEco;"Commenter, interroger, critiquer des faits économiques, voir politiques.
Préconise une hausse temporairement capée des loyers. #loyerattentiondanger";7101;71;76;574;7822
fontaine_isa;Isabelle Fontaine;"Vice-présidente principale, Affaires publiques et communications corporatives, Boralex
@Boralexinc @Boralexfr";1947;2690;1564;1621;7822
evssfr;Eric Companie;Le parti pris de la liberté - Auteur de logiciels - Concepteur de systèmes - Créateur de projets - Enseignant;4676;94;46;3005;7821
RANCHEREP;Philippe Ranchère;Passionné par les questions d'habitat et de logement, j'ai collaboré en ADIL (Roubaix, Loire-Atlantique et Finistère). Ce compte est personnel.;5415;1198;391;816;7820
BoudiaSM;Boudia S.M;Dans le field de la Recherche Scientifique, axé sur le Développement  Durable et les Energies Renouvelables. Actualité et culture.;3245;17;138;4419;7819
marcellaio68335;Marcellaiodimucca;đ«đ·đźđčjâai honte de ma France! jâai honte de Macron đ€ź!gouvernement pourri police de dictature đ€źanti gauchistes anti les Macronistes et leurs pourritures đ€ź;2612;1681;1681;1844;7818
FabriceBrun;Fabrice Brun;Député de l’Ardèche - Commission des Finances - Conseiller régional Auvergne-Rhône-Alpes;3395;402;3074;938;7809
claire_waysand;Claire Waysand;Executive Vice President / DGA @ENGIEgroup Corporate secretary, Strategy, Research Innovation, Communication #CarbonNeutralityTransition;2265;861;2952;1728;7806
Battosaii7;ヤシル 🇲🇦;;5778;1244;4;776;7802
herveplasman;HEPLA;;4020;316;75;3389;7800
xavier5192;Mr SkinnyFresh;unknown.;1895;145;22;5713;7775
BebertGPT;BĂ©bert đź¤–;"Mentionnez moi en commentaire, je commente le tweet !
BĂ©bert, le bon sens tout droit sorti de ChatGPT #OpenAI #robotđź¤– #TrollDeDroite #2ndDegrĂ© #PMU";7407;239;128;0;7774
Canope_40;Atelier Canopé 40;Atelier Canopé des Landes. Réseau de #formation des #enseignants :  #education #numérique #innovation #médiation #proximité #pédagogie #edd #emc #emi;3420;907;1793;1645;7765
CAI_Afrique;Centre Allemand d'Information en Afrique;"C'est ici! Infos sur l'Allemagne, en français.
Compte officiel du Ministère 🇩🇪 des Affaires étrangères.
RT≠endorsement. Mentions légales: t1p.de/zayax";420;733;5352;1258;7763
UN_Lemarquis;Bruno Lemarquis;Représentant Spécial Adjoint du Secrétaire Général @MONUSCO, @UN Coordinateur Résident et Coordinateur Humanitaire en République Démocratique du Congo;1442;536;3732;2051;7761
aicha_sif;Aïcha Sif;Adjointe au maire de Marseille en charge de l'agriculture urbaine, de l'alimentation durable, de la préservation des terres agricoles.🌈🌳🫑🍆🌻🌍🧘🏻‍♀️;962;2298;1912;2578;7750
JousserandotR;RèDj;;6432;486;52;779;7749
aNs0gl;"Anne-Sophie Gousse-Lessard;";"Dre en psycho sociale et environnementale; Mes recherches portent sur la motivation, la communication, l'écoanxiété, l'engagement, la mobilité mstdn.ca/@ansogl";2582;585;633;3936;7736
Bourchoisi;Bourchoisi;Je t'aide Ă  grandir dans ce monde de brute ! đź“š #Thread Crypto, finance & gĂ©opolitique;350;487;662;6234;7733
DELBOSjf;Jean-François DELBOS;Stratégies partenariales;2739;139;124;4731;7733
lindalinda7794;Linda;Twitter, c'est bien le seul réseau d'égouts et des couleurs qui permet de te soulager.;3052;2502;740;1427;7721
AumaleDuc;Duc d'Aumaleğ¨ğµğ¦ğ²;Un honnÃªte homme ne se pique de rien,  FranÃ§ois de La Rochefoucauld (et pas Michel Foucault).;6807;354;103;449;7713
ListesSurTout;Norent Claudio;"Conservateur & Nationaliste type ukrainien. 

#JambonBeurre #UkraineWillWin #Europe";2275;220;206;5003;7704
GAGGA_Alliance;GAGGA;The Global Alliance for Green and Gender Action rallies the collective power of #WomensRights, #Climate and #EnvironmentalJustice movements around the world ✊🌎;2016;780;1815;3092;7703
Didyme_W3;Didyme;;3128;119;42;4414;7703
CMartellus732;Carolus Martellus ð«ð·âï¸;Carolus Martellus , duc des Francs et maire du palais, dirigeant de la Francie, duc d'Austrasie,et souverain du royaume des Francs.;4244;507;337;2612;7700
manue97071992;ma.nue;adepte d’une sobriété gourmande. il y a toujours une face derriere la pile. Limits to growth. j’aimerai que la terre s’arrete pour descendre...;2233;386;45;5034;7698
IncuriousBastar;Painless_Brainless;;2310;94;46;5245;7695
ChenierPatriote;Patriote Chenier;Patriote Jean-Olivier Chénier (1806-1837) ⚜️;6551;340;105;697;7693
GBatiot;Guy Batiot;Conseiller municipal et communautaire EELV La-Roche-Sur-Yon.;5514;61;337;1779;7691
claudeferronV3R;Claude Ferron;Born at 337.1 CO2 ppm;1349;616;169;5547;7681
inforisque;Inforisque;Inforisque est le guide Santé et Sécurité pour la gestion des risques professionnels.;6225;96;1313;43;7677
Nordu_Yack;BokChok;oui;7499;14;1;162;7676
Ogic_officiel;OGIC;Construire des villes plus vertes, plus économes en ressources, plus  belles et plus solidaires. Pour faire surgir une nouvelle nature de ville.;1622;954;3074;2021;7671
stefjuan;Stef;Citoyen đ«đ· , patriote lambda amoureux de la LIBERTĂ et de la loi quand elle est simple.;2817;334;252;4267;7670
MyrtoTilianaki;Myrto Tilianaki;Climate advocacy officer @ccfd_tsolidaire. Offsets, net zero, land use, human rights. Previously UK advocacy and comms at @hrw, ex @MSF_france;2617;1545;1745;1762;7669
_CIRODD;CIRODD;Centre interdisciplinaire de recherche en opérationnalisation du développement durable. Premier regroupement stratégique FRQNT et FRQSC en DD au Qc.;2682;846;1444;2693;7665
CoachRoyParis91;💰 Coach_Paris91;💰 Coach Sportif disponible en privée. Concernant le coaching j’ai une lettre de recommandation suite à ma formation, que je peux transmettre en privée 🙂;1311;37;30;6280;7658
Majorel_France;Majorel France;Nous sommes Majorel. Nous concevons et mettons en œuvre des expériences client personnalisées pour les plus grandes marques au monde.;4740;260;1401;1250;7651
SooninkanLenme;SOONINKAN LENME;"nke ni sooninke nan bugu sooninkara,
je suis un Soninkè qui viens de soninkara,
I'm Soninkè from soninkara, 
eu sou um Soninkè qui vem de soninkara
#NKE";1035;1368;107;5140;7650
floriangaite;Florian Gaité;"Enseignant en philo de l'art (ESAAix), chercheur (Paris 1), critique d'art & de danse. Représentant Snéad-cgt, référent ""Ecoles d'art et de design en lutte""";2056;1406;1603;2581;7646
eaurobvq;ROBVQ;Le Regroupement des organismes de bassins versants du Québec (ROBVQ) oeuvre à la promotion de la gestion intégrée de l'eau au Québec.;4629;603;926;1488;7646
CarlosAQuenan;Carlos Quenan;Professeur des Universités, Sciences économiques, IHEAL Paris 3 Sorbonne Nouvelle, Vice-Président Institut des Amériques.;4602;1065;1750;224;7641
cyrildz;Cyrildz;"lyshoping.com : E-Commerce au Gabon
flished.com : Publication en Ligne
@lipabetaal : Payment en Ligne
Je poste rarement sur la tech, sauf si neces";5081;182;162;2215;7640
winstonvapala;zdenek;« Qui tient bon l'emporte. »;2932;558;79;4070;7639
sekamelica;Sekamelica (soon at GameCamp);"French indie game developer working on a metroidvania about insurrection ðªð© @Cnam_Enjmin crou ð¸ð¹Prev at @_Kalank â¡
I'm open to freelance work!";1686;870;442;4641;7639
ghostigoness;ghostigoness;;2986;599;197;3852;7634
TdP_FdE;Territoires de Progrès - Français de l'Etranger;Pour une gauche de gouvernement, de progrès, européenne et écologiste - Délégation Territoires de Progrès - Français établis hors de France;3526;545;513;3048;7632
Matt52687779;Matt;;1496;321;3;5804;7624
pdubenoit;Florent Benoit;;2558;104;32;4927;7621
PatriceAuffret;gomor@infosec.exchange;@ONYPHE founder and CTO - SinFP & Metabrik author - FreeBSD sysadmin - Perl sculptor - My views are those of my employer;4617;551;941;1511;7620
fun_papatt;John3 Major3;"Sell not virtue to purchase wealth, nor Liberty to purchase power. 
B.F.";3637;40;13;3929;7619
siecf;SIECF territoire d’énergie Flandre;Acteur public de l’energie et de la transition énergétique en Flandre #éclairagepublic #numérique #électricité #gaznaturel #irve #tepcv #CEE #ACTEE;1738;553;654;4670;7615
l_pigelet;Lucas Pigelet;"Journaliste a Libération - 6 dosed
Vive l'Ukraine et l'Europe, mettez un masque, protégez les autres.
Un homme peut etre une femme mais aussi une lampe, CQFD.";1948;135;17;5512;7612
LouisTrudeau;Trudeau Louis-Eric;I am a neuroscientist. I have other interests such as cycling. I am also an environmental activist who preaches by example. If it is to be, it is up to me.;1990;441;1217;3954;7602
CaroleLeBechec;Carole Le Bechec;Conseillère régionale de Bretagne. Présidente de la commission #climat #transitions #biodiversite. #saintmalo;4590;1390;914;707;7601
vnf_officiel;VNF - Voies navigables de France;VNF - Voies navigables de France #GestionDeLeau #LeauNousPorteð§ AmÃ©nagement des #territoiresð±#Logistique durableâ´ï¸ Plongez dans nos missions â¡ï¸ bit.ly/3r8RqAn;2109;567;3657;1267;7600
RobertHG_B;BobHG B Ph.D;alias Einstein/Albert/RoRo👉ex Hoche Versailles🧬🦠UFR Paris-Saclay Pharmaceutical & Biologicial Sciences Ph.D🔬Mobileye Global✨®️💉🩸🧪 FluctuatNecMergtur❤️💙;2523;1399;369;3308;7599
ThomasChappuis;Thomas Chappuis;;744;1017;540;5295;7596
Klur42;Klur42;Ruffiniste,《extrémiste de gauche》 rêvant d'une coalition de la gauche antilibérale et écologiste (plurielle, durable, réaliste);4164;619;491;2320;7594
CryptoBits_eu;Alexandre Yamajako;crypto*graphy* enthusiast;5012;298;143;2139;7592
AudranMistaire;Audran Mistaire;Réveillé et inquiet. Ni mouton, ni complotiste, ni optimiste, ni catastrophiste, ni anti-vax, ni pro-vax mais pro 🍷 naturel. #Runner #SportAddict #MusicLover;2235;1042;448;3865;7590
KoalemosMassss;Massss;Joue à Pokémon GO. Écoute de la musique. Mange du tiramisu. Intéressé par la politique. Et vive l'univers de Game of Thrones.;1653;392;72;5471;7588
jhrPoinsot;Philippe Poinsot;Rescuing the #SDGs - UN Resident Coordinator / Coordonnateur Résident @ONUCotedIvoire;3256;1294;2731;307;7588
espritvolcanix;Bioclimatix;Gaulois réfractaire,Gallogauchiste,communiste libertaire et supporter de l'ASM. Faites l'humour et l'amour avant qu'on nous colle des compteurs pour nous taxer;3765;122;49;3644;7580
Jmud;Juan Mig Juan;Vous devez être le changement que vous voulez voir dans ce monde. – Gandhi;4595;293;39;2643;7570
maysaanahiyan;Màysā 🤓;chercheur culturel intéressé par la culture arabe, en particulier les émiratis, Intéressé par tout ce qui touche au cinéma 📽️🍿;2768;1375;940;2481;7564
lmt_alex;Alexception;"đšâđ Ătudiant Ă  Sciences Po Lille en Master Politique Ă©cologie et soutenabilitĂ©
đâMilitant Ă©cologiste
đ Rapport Meadows, 1972 et dĂ©croissance";1888;608;178;4866;7540
CHDumonMorgan;Charles-Henri Dumon;CEO & Founder @MorganPhilips;6895;81;560;4;7540
gpsuisse;Greenpeace Suisse;Greenpeace est une organisation écologiste internationale et indépendante qui dénonce des problèmes écologiques globaux.;2879;1131;2538;982;7530
Hibiscu95242013;Hibiscus;Ingénieure retraitée -Renaissance;5064;92;61;2308;7525
NMobilites;News Tank Mobilités;News Tank Mobilités est le média de veille et d'informations stratégiques, politiques et économiques des mobilités.;2124;3837;1039;523;7523
skyenne1;Grant;Pour se faire comprendre, il faut employer des mots justes ! et pas juste des mots !;3506;418;172;3427;7523
ReevolutionP;Reevolution Productions;Dreams don’t work unless you do! Scripts, concepts, documentaries, music, films, series, everything comes from the imagination ... Let’s Go together!;2591;260;401;4270;7522
Arnaud_blabla;A;Localiste;3617;0;124;3776;7517
ensemble_mvt;Ensemble avec Macron;#ensemble : compte de soutien non officiel au mouvement de rassemblement de la Majorité Presidentielle autour d’Emmanuel Macron.;2648;3655;1083;126;7512
AlainM11260308;Alain MBS;;4525;553;94;2338;7510
EmilieChandler;Emilie Chandler;"đź‡«đź‡· DĂ©putĂ©e de la 1Ă¨re circonscription du Val d'Oise
âš–ď¸Ź Avocate
đźźŁ ChargĂ©e de mission sur le traitement des violences intrafamiliales";1706;870;2606;2321;7503
SharifNour92;الشريف نورالله عبد الرّحمان🌹;"🇬🇳🇲🇷🇲🇦
اللهم صلى على سيدنا محمد و آله أهل المقام لأكبر
Oldschool↔️ zéro polémique virtuelle
🔸Loyauté
🔸Respect 
🔸Tradition Muhammadienne
▪️LaForge▫️";1258;103;236;5905;7502
JeanMarcTrappie;Jean-Marc Trappier;"Expert VMware
VCP 310, 410, 510
VCP-DT 510
VCAP-DCD";7372;54;44;16;7486
laureldenantes;Laurel Denantes;Inscription récente afin d'avoir des informations diversifiées sur la situation actuelle.;5003;475;42;1958;7478
LandryAllard;JLA;;1090;88;72;6228;7478
LeguenHerv1;Le guen Hervé;;4804;0;27;2647;7478
Loic_Nicklaus;Loïc Nicklaus;#logementsocial #collter #relationclient #politiquelocale #economie #environnement #velotaf #humanrights Tweets personnels;2257;754;301;4154;7466
2ChristianETP;Energie transport et patrimoine-ChristianAmbrosi;"Solutions énergétiques et de transport simples et peu coûteuses, non punitives
Reprise en main SNCF EDF nucléaire et hydraulique
StopDénigrementServicesPublics";2657;174;73;4557;7461
BiodiversiteFR;BiodiversitéFR;Informations sur la #biodiversité, l'#écologie, le #climat en France et à travers le Monde. #ODD #Agenda2030;1926;347;606;4577;7456
Jessica_GuiotDa;NessaSurion;;1563;202;18;5672;7455
BNEIassos;BNEI - Bureau National des Élèves Ingénieurs;"Le BNEI est l'unique organisation représentative des élèves-#ingénieurs
contact@bnei.fr • 07 49 22 85 99
#esr";2532;1253;2736;933;7454
canopea_be;Canopea;Canopea (ancien Inter-Environnement Wallonie) est une fédération d'associations environnementales belges.;3006;637;2620;1188;7451
aggloboulonnais;CA du Boulonnais;"Compte officiel de la Communauté d'agglomération du Boulonnais
#aggloboulonnais #boulonnais #aggloCAB #CAB";4327;380;2237;501;7445
veronicau08;veronica u;No soy ni me hago, existo por eso soy presencia ððð;3821;109;14;3501;7445
NIndependante;Nation Indépendante;là pour flex, esprit shonen 🫒🪨🗣️🗡️;4717;155;43;2529;7444
nacirih12;Hassan NACIRI;Ambassadeur/          Royaume du Maroc;2420;609;2891;1522;7442
_TychoBrahe_;Geoffroy Séré;Professor in ecosystem services provided by anthropized soils @Univ_Lorraine +  @ENSAIA / active in @GISFI1 + @SUITMA3 + @IMPACT_Deepsurf / minimalist musician;3091;626;461;3256;7434
CamilleAugey;Camille Augey;Adjointe au Maire de #Lyon en charge de l'Emploi et de l'Economie durable | Conseillère métropolitaine;1141;472;2263;3557;7433
y_yaagoubi;Youssef 🇲🇦;"🌸✨ 
 #المغرب
#DimaMaghrib 🇲🇦";905;2121;160;4244;7430
LeFigaro_Emploi;Le Figaro Emploi;;3132;23;4265;9;7429
FoxLeMartien;Numa Noïde;;545;186;30;6667;7428
JamesLemeray;JL;;2594;254;18;4558;7424
loic_angot;Loic Angot;;3162;154;227;3857;7400
AlexTerieurdici;Alex Terieur;D'ici est la vérité : je ne suis pas le frère d'Alain. Rien ne sert de courir quand faute de lièvre on a qu'un lapin posé là par hasard.;4387;114;106;2786;7393
MarieMoerman;Marie Moerman;"Agronome curieuse qui cherche à comprendre comment fonctionne le Monde.
#agriculture #sociologie #géopolitique #sciences";1645;453;309;4981;7388
sebcrzt;Sébastien C.;"Ici surtout pour l’écologie.
Chercheur en neurosciences pendant un moment, maintenant dans l'IA.
@DesFaiseurs
@sebcrzt@piaille.fr sur Mastodon";2443;1583;144;3216;7386
FrancoisRAGE;François RAGE;Maire de Cournon d'Auvergne, 1er Vice-Président @clermontmetropole chargé de la mobilité durable, Président @smtc63;1214;639;1309;4224;7386
_AzzaTurki_;عزة تركي;"dep_comptabilité_
plus_belles_affiches_Tunisie";6685;39;40;619;7383
RaphieJarrige;Raphaëlle Jarrige;"Médiation scientifique & Ingénierie Culturelle - @RotondeSciences @MINES_StEtienne  Ex @inp_cnrs
#médiation #science #art #exposition #public #égalitéFH #créer";2124;933;420;3904;7381
semperco91;semperco;la capitale de la France est Paris, pas Bruxelles, pas Washington ni Moscou. La France doit faire entendre sa voix.;5311;69;170;1822;7372
michelbessiere;Dr Bessiere Michel;"Praticien de la recherche à la retraite. Dr Etat
Militant @sgencfdt
ex dir ST/Valo @synchroSOLEIL
Conseiller municipal de Brantôme en Périgord";4188;258;188;2734;7368
EricMboma;Eric Mboma™;🤷🏾‍♂️See the END from the BEGINNING. #PLUMBER: CLEARS the pipes & keeps the sludge MOVING.;242;4225;2596;292;7355
ulyssedorioz;Ulysse Dorioz;Mes tweets n'engagent QUE MOI;1462;804;383;4704;7353
EDF_GrandEst;EDF Grand Est;Compte officiel de la Délégation régionale #EDF #GrandEst #Innovation #Numérique #EDFpulse #TransitionEnergétique #Pulse #RSE;2324;719;1315;2993;7351
iliasse59631087;iliasse;1+1=11;703;76;54;6518;7351
apnql;APNQL_AFNQL;L’APNQL est l’organisme régional politique qui regroupe les 43 chefs des PN du Qc-L/AFNQL is the regional political org regrouping the 43 Chiefs of the QC-L FN;4661;296;2268;126;7351
DInNominePatriZ;In Nomine Patri;A man not meddling in politics deserves to pass, not for a peaceful citizen, but for a useless citizen.;2081;473;177;4618;7349
wattscdotcom;WATTSC 🇲🇦 ☀️⚡🔌🔋;WATTSC est une société marocaine 🇲🇦 intervenant dans les projets de transition énergétique: renouvelables, audit énergétique, & mobilité électrique.;7140;140;37;31;7348
Ling_Lhamo;Ling Lhamo;Youtube piped.video/channel/UCPLi_WT…;4257;701;428;1958;7344
matzenox;AEG MatZenox 💛🤍;Lead IOS marmelade-app: Organisme de formation a distance (HabElec / AIPR / CACES) Fondateur Aegis 083/100 💛🤍 Fan Inconditionnel de Sanji;1499;534;31;5277;7341
ChristopheHuy;Christophe Collignon;Ministre wallon du Logement, des Pouvoirs locaux et de la Ville. Bourgmestre en titre de Huy. Et grand supporter du Standard de Liège...;2524;956;2508;1349;7337
JeanmarcAllais;JM;RUBANS;2365;1036;361;3571;7333
CaptainGaul;Captain France;Je suis né lors du baptême de Clovis mais avant je m'appelais autrement.;3559;67;32;3674;7332
antmahe;Antonin Mahé;Élu @VilledePaimpol • Animateur @JeunesSoc22 • Conseil National @lesjeunessoc • SF comm' & jeunesse @Socialistes22 • L3 Histoire @UnivRennes_2 • #NUPES;2230;941;866;3293;7330
JehannoSylvie;Sylvie Jehanno;PDG /Chairman & CEO @dalkia Groupe @EDFofficiel #TransitionEnergétique #EnergiesRenouvelables #Territoires #Numérique #Innovation;856;1107;4469;898;7330
leblancjeanfran;JeanFrancois Leblanc;100% renewables | Personal opinions;6395;71;723;140;7329
EeroAilio;Eero Ailio;Advisor Directorate for Just Transition, Consumers, Energy Effiency & Innovation, @energy4europe @EU_Commission. #CleanenergyEU. The views here are personal.;1857;214;707;4550;7328
CinderellovaB;Cindy 🌸;Instagram : @Cinderellova;1624;74;69;5561;7328
ClaraHWhyte;Clara H. Whyte;Founder @PaideiaMundi - Using #philosophy, #psychology, #neuroscience, #ecology and #arts to understand the roots of #biophilia. Ahimsa. Animal Welfare. Yoga.;2415;2621;247;2042;7325
kmalo64489216;kmalo;Mère d'un covid long de 22 ans.;337;556;79;6347;7319
L_o_2_z_o;lo2zo.pcc.eth;1) What;2787;1617;425;2482;7311
Scrmbldegg;Œuf mayo 🇺🇦;Si ce que tu as à dire n'est pas plus beau que le silence, alors tais-toi.;3695;388;20;3206;7309
JeanYvesMasson;Jean-Yves Masson;Scientist, kids chauffeur,  DIY hobbyist, proud father of 4. Expecting the unexpected.;1047;885;1011;4356;7299
CRivenq;Christophe Rivenq;Président d'@AlesAgglo / 1er adjoint au maire @VilledAles #MaxRoustan #Alès / Président @republicains30 / Conseiller régional #NousOccitanie / 1+1=Trois;4292;346;1680;980;7298
AlineAbravanel;Aline Abravanel;"Azuréenne tournée vers 🇪🇺🌳🌍
#CotedAzur

Conseillère Municipale #AntibesJLP
& Agglo #CASA
#MajoritePresidentielle
#Renaissance (x2) CN #TDP";1832;527;490;4447;7296
fspfsyndicat;FSPF;Fédération des Syndicats Pharmaceutiques de France (Président : @philippebesset) | Retrouvez le #13h45Live ici 👇🏼;2676;77;3871;667;7291
PiKarros;đšđ” Pi_karros;"Recevoir sans fiertĂ©; perdre avec dĂ©sintĂ©ressement.";1231;344;60;5643;7278
J_duChaffaut;Jean du Chaffaut;Membre de l'équipe de @fxbellamy au Parlement européen #ITRE. Intervenant @SciencesPo38;1112;793;964;4408;7277
b_etche;Bixente Etcheçaharreta;Porte parole et Conseiller régional délégué à la Communication de la Nouvelle Aquitaine | Alain Rousset | Alumni @sciencespo | Fondateur @dtge_asso;1805;1091;1545;2835;7276
EnCommun_parti;En Commun !;Le parti de l’écologie, des solidarités et de la démocratie citoyenne au sein de la majorité présidentielle : Pour une France En Commun !;1576;133;2713;2850;7272
mailmeoften;Venkat B;;6168;450;149;482;7249
BylyCjo7;Byly;"Anti Macron, Anti Pass, Anti Vax, Anti Mondialiste.
Souverainiste, Pro Russe.
7ème édition chez l'oiseau bleu, je teste mon VPN.";4221;1439;230;1354;7244
3245Leo;leo3245 | Suiswap;Stancer @coinstancy;3115;342;39;3745;7241
Seboftheworld1;Sebastien Schmidt;francais de l'etranger.;4720;41;22;2452;7235
LucG69770480;Luc G;"Curiosité
Efficacite";6321;689;68;152;7230
marcellinegold1;marcelline goldstaub;Paris Paris Paris !!!;7217;8;5;0;7230
LPO_RemiBelleau;Lycée Rémi Belleau;Lycée des métiers du commerce et de la gestion des entreprises, Lycée général et technologique à Nogent-le-Rotrou @ac_orleanstours;3431;850;489;2457;7227
acti;Agence digitale acti;"25 experts pour vous accompagner sur le digital #Marketing #UX #WordPress #Drupal #Symfony #Ecoconception #GreenDataCenter 
ðAppelez-nous : 04 37 37 25 10";2861;494;3101;757;7213
Filiere_3E;Filière 3E;"L'information des professionnels de l'#EcoEfficacité énergétique et de la domotique #TransitionEnergetique
#EnergiesRenouvelables #EnergiesVertes #EnR 🍃";4458;1107;1491;154;7210
ICoulerot;Isa Rose Coulerot;Ancienne en Pharma.. Naturopathe *en master de diététique et nutrition *;1056;217;44;5892;7209
apxw29;Vous avez le pouvoir;;2879;415;51;3864;7209
dstesjules;Jules 🕸;plus many que tony 🤌;5065;953;200;986;7204
Archives_94;archives_94;Compte officiel des Archives départementales du Val-de-Marne;2051;501;1230;3420;7202
Brouers;Dimitri Brouers 🇲🇬;Entrepreneur du XXI ème siècle - Consultant en #Communication #Web & Développement durable / #RSE - Heureux fondateur de l'#Association MadaAllStar;3438;1742;1914;107;7201
mcudel;Manuel Cudel;Journaliste @midilibre | @lexpress;2203;569;1663;2764;7199
CFernique;Christophe FERNIQUE;Conseiller Environnement & Développement Durable @CCIHerault #GreenIT #Ecoconception #RSE #ENR #LabelEnvol #AchatsResponsables #TourismeDurable. #Actu;1175;423;380;5220;7198
rachid_unt;๐ฅ๐ฎ๐ฐ๐ต๐ถ๐ฑ ๐๐ข๐จ๐๐๐๐ ๐;Prรฉsident de l'Union Nationale des Taxis ๐;1322;1957;1038;2881;7198
TheophileLecor1;Theo Lecorse;"Afflige. Si tweeter me le permettait j'insulterais la majorite d'entre vous ;)";5091;346;20;1739;7196
Nouiriabdelk1;Abdelkrim NOUIRI;"diplômé en détection sous marine spécialiste dans la configuration du sonar 
je n'aime pas les racistes et les xénophobes.
nous sommes tous égaux devant Dieu.";5414;409;110;1241;7174
LiveDjib;Djib-Live;Djib-live,  société de communication;2533;630;3918;86;7167
ThomasLeGout1;Thomas Le Gout;"En France depuis 2018 ð¨ðµðªð¸
PassionnÃ© par les langues
Espagnol C2, Anglais C2, FranÃ§ais C1, Allemand B2, Italien B2, Russe B1 - Trader OIL/GAS chez C....";2123;76;38;4924;7161
excoffier_isa;EXCOFFIER Isabelle;;3555;309;128;3169;7161
MakhzanPow;Makhzan P;THE MAKHZAN IS THE FORMER MOROCCAN POLITICAL INSTITUTION UNDER THE SULTANATE/EMPIRE đź‡˛đź‡¦;901;1808;2514;1937;7160
PG_JKmastodons;Durand Philippe;""" La mort n'est pas la pire chose de la vie. 
Le pire, c'est ce qui meurt en nous quand on vit."" Albert Einstein";6862;228;61;5;7156
Edegrandmaison;Eric de Grandmaison;Reporter régional Ouest-France Pays de la Loire - 57 ans;5283;540;1162;171;7156
sebdaucourt;Sébastien Daucourt;De sources concordantes, passé directeur régional Franche-Comté de l'Est Républicain. Sportif dans l'âme.;4600;1005;1064;485;7154
arau_bxl;ARAU action urbaine;L’Atelier de Recherche et d’Action Urbaines, fondé en 1969 par des Bruxellois qui revendiquent le droit à la ville. #urbanisme #mobilité;3076;580;1960;1536;7152
sebastiendepet1;Sébastien Depetris;"Agent de Tri 
Syded du Lot 
Pour un Développement Durable 
Les Matalines  46150 Catus 
 syded-lot.fr";3171;750;139;3092;7152
CCIMartinique;CCI Martinique;La CCI Martinique accompagne tous les entrepreneur.e.s dans leur projet de création ou de développement d'entreprise dans le commerce, le service ou l'industrie;2380;180;4103;488;7151
JaneLallement;Lallement Jeanne;Professeure des Universités  @UnivLaRochelle / #SciencesGestion #chercheuse #emarketing #timeperception #mobility #CSR;1134;1433;1170;3412;7149
Incubateur_CAE;Incubateur Centrale-Audencia-Ensa;Un accompagnement entrepreneurial unique grâce à l'expertise des 3 écoles de l'Alliance Centrale Nantes, Audencia et Ensa Nantes. #innovation #entrepreneuriat;3805;1296;1477;570;7148
BillyzeClic;Billy-ze-Clic;;4597;150;99;2301;7147
yeesalagrihub;Yeesal Agri Hub;ð¥#Agribusiness,#Agritech & #GreenEconomy Hub of West Africa: inclusive innovation,resilience & #impact agripreneurship ecosystem- linktr.ee/yeesalagrihub;2306;896;2817;1120;7139
jntronc;Jean-Noël Tronc;DG Centre national d’enseignement à distance @CNED;2533;450;3373;770;7126
VirginieMollet;Virginie Mollet;Je suis une fouineuse d'infos sur tout ce qui touche au référencement, à Google, etc...;2833;2152;2132;0;7117
Natan_ANEPF;Natan Goulin;Actuel Vice-président en charge des Tutorats d’Entrée dans les Études de Santé à @pharma_ANEPF | Étudiant en 4e année à @FacPharma_54;905;645;530;5035;7115
godawgs8282;Laurent-Kevin;Mens Soccer at Mercer '99 / Vainqueur Division d'Honneur Ligue Pas-de-Calais 2001 / Won Canterbury & District League 2005;2704;176;21;4208;7109
BoomNykkkau;BooomNykkkau;"Autour de nous attendant l'esclavage
Les libéraux se vautrent dans leur veulerie
A eux la paix, mais à nous le courage
De risquer tout pour secourir la Patrie";838;224;57;5989;7108
MrSnowBall8;Mister Snow;;5589;70;12;1433;7104
NoureauTeri;teri;;91;190;166;6656;7103
mercantour;Parc national du Mercantour;#mercantour #parcnational #Alpes #nature #culture #nationalpark #france;2427;118;4418;138;7101
gilloulou;Gilles Sube;;2086;22;39;4954;7101
Franck3375;Franck ð«ð·;J'aime la ð«ð· France ð«ð· et j'aime son histoire !;3820;55;35;3190;7100
FlorianChauche9;Florian Chauche;Député de la 2e circonscription du Territoire de #Belfort - La @FranceInsoumise - #NUPES - Conseiller municipal @encommunbelfort - @Fi_Belfort;1437;515;2559;2584;7095
Heyjuanito1;Heyjuanito;Pacifiste, agnostique, écolo, humaniste et soignant, dans un monde qui se définit à l'inverse de ces valeurs...;6248;122;47;674;7091
EstelleDesalb;Estelle;Citoyenne française;2631;120;19;4310;7080
noone1233445;mea mea;;5133;31;40;1866;7070
PaulLagram;Lagram Paul;đđâ€ïžđ€;1964;115;57;4932;7068
lyliluna33;Lyliluna33;;4678;145;27;2215;7065
GenErasmus22;GenerationErasmus ð¨ðµðªðº;"Born in France and raised citizen of EU.

Losers have an ideology, winners have a plan.

Blocage = flemme intellectuelle.

Bon vivant: piped.video/ZRKoy-KDDzs";5313;639;106;1003;7061
VirginieDrapier;Drapier Virginie;Présidente bénévole @Cedisformation #sobriété #logement #emploi #formation #santé #handicap #Lille4;3144;489;396;3031;7060
yannchaillou;Yann Chaillou;Fondateur de @TousOrleans;3269;493;1077;2217;7056
VinceMegami;Vincenzo Megami;Simple citoyen observateur du déclin Francilien;1588;390;44;5032;7054
pvmagfrance;pv magazine France;;5354;627;1052;16;7049
GCoutey;Guillaume Coutey;Maire de Malaunay Conseiller Departemental du Canton de Notre Dame de Bondeville;1737;736;1187;3389;7049
BulldogRaymond;Raymond;;6601;162;24;262;7049
TerraVitis;Terra Vitis;La signature des vignerons français qui respectent la nature, les hommes et les vins | #Viticultureresponsable #SustainableViticulture #TerraVitis;1950;826;1418;2854;7048
BussacchiniD;Donatello;;93;334;33;6588;7048
MaMauger;Marie-Andrée Mauger;Mairesse de l'arrondissement de Verdun | Membre du comité exécutif, responsable de la transition écologique et de l’environnement;3325;1282;2081;354;7042
KakomaAlbert;patriote;Politique ,Actualités ,Histoire, je crois que pour chaque bonne raison de mentir il en existe des très bonnes raisons pour dire la vérité.;4544;644;156;1693;7037
2001Camus;Camus 2001;Bonjour. Je suis majeur et vacciné, sauf contre la connerie.;3493;42;38;3463;7036
prince_astor;LaPaillEenCartON­čžÖ­čĆ╝­čŹí­čŹí­čŹí;Ma├«tre de la conception et fabrication de tout en carton;3446;29;48;3504;7027
daddycool2022;Meunier Philippe;sous-citoyen 2020-2021-2022-2023 ? je ne pensais pas être si souple après 55 tours de Soleil pour éviter les fléchettes. Le CO2 c'est la vie 🌍;1954;122;72;4877;7025
CalvoEmile;Emile Calvo⚡;;754;112;28;6128;7022
LesEcrivainsBKO;ESLE Les Ecrivains;Twitter officiel de l'Etablissement Scolaire @LesEcrivainsBKO đČđ± membre du rĂ©seau â¶âșâ»âș, l'#ESLE accueille les Ă©lĂšves de la crĂšche Ă  troisiĂšme.;875;2611;616;2914;7016
gganek;Gabriel;;6029;522;77;386;7014
LOpinion_Ma;L'Opinion;L'actualité en continu;6030;0;973;5;7008
JournalLeFranco;Journal Le Franco;"Seul média francophone consacré à l’actualité albertaine

📰 S'abonner 👉 cutt.ly/0vrYT9y
✒️ redaction@lefranco.ab.ca

Notre application mobile : Frabio";3245;787;2426;545;7003
CrimsonViper4;Redpill Viper ð¥âï¸ð¬;;5000;217;108;1677;7002
JobBwanga;Job-Steve MONGA;Exp.Entrepreneur,Father, @YouthOngd Founder ,Public speaker.Human Right Defender.Passion pour une #jeunesse d'#Excellence & #Autonome.+243995342539;1822;2734;418;2024;6998
FuriAussie;FuriAussie;Supporter du CF63 depuis 1997 et amateur de stats avancees!;3184;24;148;3638;6994
A__Link;Alain Paquet;"L'observation recueille les faits ; 
la réflexion les combine ; 
l'expérience vérifie le résultat de la combinaison.
- Denis Diderot -";3437;199;55;3303;6994
manzduff;KuSoMaCinEmARDC;cinéaste -entrepreneur culturel.+243998870408;2982;1070;272;2663;6987
M_o_w_g_l_i;_Mowgli;"Élevé par des loups, je draguouile les meufs à la rivière. 
Je danse parfois avec des ours.

Je respecte mes interlocuteurs, merci de ne pas m'insulter.";5289;440;328;918;6975
Mad_Margaux;Mad_Margaux;;1047;754;266;4908;6975
Guillau11750366;Guillaume;;3073;24;18;3860;6975
URIOPSS_BFC;URIOPSS BFC;Association qui regroupe près de 800 associations, services et établissements de solidarité oeuvrant dans l'ensemble du champ sanitaire, social et médico-social;4032;1696;926;320;6974
RiCFranck;Franck d'Angers et d'ailleurs;Curieux des savoirs et curieux des autres. Angevin de cœur. CSP + transclasse. Fils de prolos agricoles. Écolo défroqué, esprit décillé. Sans certitude.;2546;961;90;3363;6960
MarcDargis11;Marc Dargis;Peintre et  plâtrier de la construction CCQ je suis à la retraite 58 ans.;3516;448;223;2770;6957
NdiHamidou;Hamidou_N'DIAYE;Un vieux père. Je commente des trucs sur le Mali 🇲🇱.;2219;359;239;4139;6956
MichelMULUMBAM1;Michel MULUMBA MUYA BUK.;"▪︎ Lauréat du Concours de Plaidoirie en DIH Cx-R/Belgique ;
▪ Diplômé en Droit de l'OHADA/Univ. de Bordeaux/France ;
▪ Initiateur de l'ADJC-ASBL ;
▪︎ AVOCAT.";694;2153;1130;2967;6944
baiapersa;baiapersa;Trazer água no bico;2498;1513;519;2412;6942
AEMQ_;AEMQ;L'Association de l'exploration minière du Qc promeut l’exploration durable et responsable des ressources minérales et leur contribution à l’économie québécoise.;3350;961;1454;1172;6937
MarroncleA;MARRONCLE ANNICK;;6855;16;15;49;6935
Agathe_CIWF;Agathe_CIWF;Chargée d'affaires publiques @CIWF_FR ciwf.fr agrociwf.fr;2449;1594;1042;1847;6932
JadeBoivinTwitt;Jade Boivin;"Ingénieure agronome @AgroParisTech, engagée pour la #décroissance
🌍 Conseillère aux affaires économiques pour les députés @EcologistesAN |
Bretagne et Paris";382;541;550;5457;6930
hibooexpert;hiboo.expert;"On sélectionne pour vous les meilleures valeurs pour rendre vos investissements plus simples 📈 Découvrez nos analyses ici 👇

#bourse #finance #value";2101;1125;3419;282;6927
Mrwidriss;Marwa Idriss;الانحناء الوحيد الذي يدل على كرامة واستقامة هو انحناؤك بين يدي الله عز وجل.;1321;169;145;5289;6924
eazystonk;eazystonk;Here for fun & crypto 👌;3027;1714;190;1988;6919
nfinfi_docteur;Nien-Nien;;3038;59;158;3664;6919
J_Sancho03;ðŸ‡°ðŸ‡²ðŸ‡©ðŸ‡ª;;461;28;11;6418;6918
Audiar_infos;Audiar;"Agence d'#urbanisme de Rennes
#Audiar #Prospective #Economie #Mobilité #Logement #Planification #Environnement #Fnau";1400;2426;1854;1236;6916
ecofi;Ecofi;Ecofi est une société de gestion engagée qui a le statut d'entreprise à mission #FinanceResponsable #AssetManagement #ISR #FinanceDurable @credit_coop_;4006;281;1621;1004;6912
Ehadjisow;Eloomubaye;#Ingénieur agro-économiste# Elément Cheikh Al Islam.;343;921;405;5235;6904
MarcoouScea;MARCOOU;Pour un monde de vérité;5961;403;118;422;6904
CouturierCathy;Catherine COUTURIER Députée;"Compte officiel de 𝗖𝗔𝗧𝗛𝗘𝗥𝗜𝗡𝗘 𝗖𝗢𝗨𝗧𝗨𝗥𝗜𝗘𝗥 

#Députée #LFI #NUPES #Creuse
Comm. Dév. Dur. 
Délég° Collectivités Terr.

Ne tweete pas en personne";1497;1141;2718;1546;6902
IsaMai68;isabelle ruault;Fait partie de la team bus RATP: 335 lignes de bus et 20000 collaborateurs au service des voyageurs franciliens.;1047;964;301;4590;6902
adleanco;adleanco;Connaître le passé est une manière de s'en libérer. Raymond Aron.;2881;38;16;3963;6898
Farfadetsusap;Les Farfadets USAP;Club de supporters de l'#USAP depuis 2004! L'#actualité du #Rugby en pays #CATALAN et dans le reste du #Monde sans jamais se prendre au sérieux! rejoignez-nous!;1812;555;709;3819;6895
JJulienCAQ;Jonatan Julien;Député de Charlesbourg, ministre responsable des Infrastructures et ministre responsable de la région de la Capitale-Nationale;1599;310;4193;782;6884
ASA_PNE;ASA PNE;Association pour le Suivi de l'Aménagement Paris Nord-Est, engagée dans les processus de concertation sur l'aménagement urbain et la transition écologique.;3636;664;924;1659;6883
InnomineSns;innominé;••• Externe en médecine ••• // Dubnation  // Parlons du fond plutôt que de la forme, par pitié;2473;146;17;4244;6880
NoamLeandri;Noam Leandri ♻️;#inegalites #transitionjuste #ecologie Mes tweets n’engagent que moi;1123;359;865;4529;6876
Greg0o7;Greg;"Plus aucune compassion.
Merci à Reconquête! de nous donner l'espoir de sauver notre fragile pays.
la France aux Français.
Vive la France.";2320;1211;387;2956;6874
HelenePapper;Helene Papper;Director, Global Communications & Advocacy @UNđź‡şđź‡ł@ IFAD. Tweets stories to create #dialogue #education for change, #conflictprevention #genderEQ #climateaction;2034;1365;1380;2090;6869
RN77Circo5;François Lenormand;;3359;112;242;3156;6869
vponsinet;Valérian Ponsinet;Pharmacien, bureau national @FSPF_officiel : chargé de la #pharmacie #numérique et de la transmission de l’officine #teampharma #eSanté;2377;664;642;3185;6868
Okanajordan1;OKANA jordan;"fondateur du Thin-thank @prospectiveGa/ 
@changementClimatiques @Gouvernance @LutteContre la pauvreté et l' @innovation, @Agriculture.";923;498;229;5212;6862
mrcvrrtt;Marco6;;1250;171;55;5384;6860
gros_svp;Simon Tremblay;Arrêtons d’écouter seulement les groupes de pression, les journalistes et les écolos et gérons le Québec pour notre prospérité collective dans le respect.;3915;449;109;2385;6858
AigSylvain;🚀Sylvain - Objectif Lune 🌝💰📈📊;Choisis ton vaisseau, prends les commandes et attache ta ceinture ! 🚀 On fait décoller tes revenus ensemble ! 🚀 Rejoins la communauté👇🏻;2522;610;1312;2414;6858
robert_troni;Robert Troni;;5310;706;42;799;6857
Weld_BenSba3;Adnane Sbaï;;3838;215;443;2359;6855
CapitalInnov;Capital & Innovation;Vous lancez votre #startup ? Le Pôle Capital & Innovation du @CA_alp_prov soutient les #projets innovants en 13, 84 et 05 #Aix #Marseille;2837;650;1282;2084;6853
ulmiens;Trompette Guerrière;"🇫🇷🚩 ""L'homme est né pour le bonheur et pour la liberté, et partout il est esclave et malheureux !"" 🇫🇷 🚩. Mon serv discord : discord.gg/FF5rD5s5";4346;182;241;2082;6851
VivianeLapointe;Viviane Lapointe;Member of Parliament Sudbury | Députée Sudbury | Nigerian name Aduke 🍁;1464;815;1692;2878;6849
maximo157p;maxime cote;#crypto;450;4995;701;702;6848
Desiree_McGraw;Désirée McGraw;Députée de / MNA for Notre-Dame-de-Grâce. Lutte contre changements climatiques + environnement. Faune + parcs. Relations canadiennes + francophonie canadienne.;2338;1311;1729;1469;6847
OlivierDupuy7;Olivier Dupuy;autodidacte intéressé par tout ce qui nous entoure.notre existence est fabriqué au cœur des étoiles. quel est le sens de la vie…;2561;476;43;3763;6843
MakoboClement;Makobo Clement;Animateur Conférencier du DIH et Droit de l'Homme.;4468;467;152;1756;6843
FrenchTechLim;Communauté French Tech Limousin;Compte officiel de la Communauté #FrenchTech #Limousin. Rejoignez la communauté avec #FrenchTechLim !;3092;385;1982;1381;6840
garincha1966;GARINCHA;Rapprochement Gauche du travail Droite des valeurs.;3706;360;59;2714;6839
TsarPopa;Tsar Popa - #LeCompteurMÃ©gotsð­;"Follow me si tu â¥ï¸ ce qui suit : je suis...
@LeCompteurMÃ©gotsð­
_ amateur de calembours ð
_ rÃ©voltÃ©â 
_ ramasseurs de dÃ©chets ð­ð®

Devise : In Vino Veritasð·";4085;109;56;2589;6839
ntchango9;Fabrice NTCHANGO;CEO Akewa Accélérateur I Committed to climate action🌍I Engaged for SDGs Achievement I Social Entrepreneur;2402;3344;845;244;6835
metrop_davenir;Métropole d'Avenir;Groupe majoritaire de @Toulouse Métropole avec @jlmoudenc réunissant les élus de la Droite, du Centre et de la Société civile;3815;367;1113;1537;6832
lvri4;Laurent;;5020;92;44;1674;6830
zoogenot;Zoe Genot ᵖᵃʳᵒᵈᶦᵉ;Candidate pour remplacer Benoît Hellings 🤩  Maîtresse en KPI📊 écoféminoislamophile🌿🧕 Députée, spécialiste en résolutions inutiles & tracts polémiques.;4465;1340;544;471;6820
ENERLIS_FR;ENERLIS;ENERLIS | Entreprendre un nouveau monde énergétique;1627;1777;3252;162;6818
le_maulf;Le Maulf Noëlle;"Secrétaire regionale d EELV Normandie.
Militante associative, syndicale et politique";2656;192;174;3789;6811
LgDELUMEAU;LGD;Feed - commodities Trader;2396;1043;1462;1909;6810
josephguirot;99BEVTZ;DrankHeadđŹđŠ |420Records|;3176;298;214;3121;6809
RECtlse;Les Rencontres de l'Esprit Critique;"Les Rencontres de l'Esprit Critique.
Confs, ateliers, animations & spectacles pour toute la famille.
Replays sur piped.video/c/RECTOULOUSE #RECTLSE23";1193;1207;2916;1490;6806
MTL_VSP;Arrondissement VSP;L’arrondissement de Villeray–Saint-Michel–Parc-Extension : cosmopolite, branché et familial ! Téléphone : 311 (compte officiel);2685;1140;2580;384;6789
dominiqueTA;Dominique TA;Militante écolo-féministe utopiste, conseillère départementale des Hauts-de-Seine, adjointe à la Maire à la Transition écologique #Malakoff #Montrouge;2613;1308;1641;1210;6772
Matthias75015;đ Matthias đ€;Ce compte est initialement un compte de supporter du #PSGđ , il aborde des outils interactifs đ€pour amĂ©liorer votre Xp  đ€Źdu web socialâœïž, Ex Block chain đ;3535;904;81;2251;6771
VirginieMeunier;Virginie Meunier;"DGS à @Mantes_la_ville.
1ère adjointe au Maire d'@Aubergenville
#CommerceDeProximité #Communication #Numérique #Prévention.
Ex-Dircom @Sports_gouv @Jeunes_gouv.";1922;1750;771;2326;6769
GroupeEcomedia;Groupe Ecomedia;Groupe de presse économique régional. ECO Savoie Mont Blanc, ECO de l'Ain, ECO Nord Isère, L'Extension, Courrier Liberté Mag, ActivMag, etc.;6566;60;142;0;6768
attindoglofreju;attindoglo frejus;juriste /Blogueur/militant des droits de l'homme à #Amnesty_International_bénin.;3117;574;855;2217;6763
PetrAnto12;PetrAnto.eth ⚛️ ⚵;"Happy Life maximalist

Ethereum domain, Solana PFP, Cosmos IBC
Blockchain is the tool we need to build the next century";4275;1336;194;957;6762
JinxGachetteF;Jinx;Épicurien, j'aime la vie, les belles rencontres et se retrouver autour d'une bonne table et un bon verre de vin afin de partager nos idées.;5696;14;1;1048;6759
Neutral5685;Neutral;"A partir de mnt, les troll seront automatiq. bloqués (+ de tps a perdre). A savoir : compte récent ou -5 abonnés; que des réponses et spams ; insultes,grossier";3689;629;432;2007;6757
Ecophanie;Yves Garenne;Un zeste de convictions, déjà 3 décades d'expériences, une foi constante dans l'être humain…;2228;526;247;3755;6756
GeerinckxF;Geerinckx Francis;;1769;91;48;4846;6754
CarolinaGalloLa;Carolina Gallo;Law, communication, sustainable energy, tech & leadership.;3007;821;608;2315;6751
AmigoMahula;MAHULA AMIGO;"Analyste et Consultant en Politique Etrangère, en Géopolitique, Géostrategie, Droit Internationale, Gestion et Resolution des Conflits; Chercheur indépendant.";2166;307;300;3977;6750
IBTourisme;Baleares Tourisme;Office du Tourisme des Baléares #Majorque #Minorque #Ibiza #Formentera #voyages 🇪🇸 @TurismeBalears 🇬🇧 @BalearicTour 🇩🇪 @dieBalearen 🇮🇹 @BaleariTur;4372;532;1641;202;6747
FranceBalogh;François Balogh;;299;60;7;6380;6746
enkoro_sylvain;Dr. Sylvain Patrick ENKORO;Homme Politique, Sénateur Élu du département de Lekoni - Lekori et de la Commune d’Akieni, ancien Président du RESOLAB, Ancien DG de l’AGASA.;3337;634;668;2105;6744
BonSens47865369;BillyduBayou;;4440;27;29;2247;6743
EadgGdea;Eadg Gdea;Eadg;5759;39;15;927;6740
capsuleCorp_S;Sayan☻️;;2902;296;52;3490;6740
BeurtonLeMignon;Beurton-Le Mignon;CEO @yellowbr1cks | Élue CCI 49 | V-P Medef Anjou #nocode #tech #createch #art #entreprenariat;1451;873;604;3810;6738
lesptitskipik;lesptitskipik;Les P’tits Kipik se donne pour objet de mettre en œuvre des actions de nature à promouvoir la sauvegarde des hérissons;2505;167;1330;2735;6737
IYBSSD2022;Int. Yr. Basic Sciences for Sust. Development;Basic sciences are the sine qua non of sustainable development;4758;304;760;914;6736
AFGNV;AFGNV;Association Française du Gaz Naturel Véhicule;3608;223;2758;144;6733
ClavetLabrecque;Samuel Clavet-labrecque;Un Québécois francophone de Québec ⚜️ |25| Étudiant en développement durable du territoire | Ulaval | CQ de Maizerets;293;115;110;6215;6733
EMahatshi;Leader Exousia mahatshi sheta ð¨ð©;"CANDIDAT PROVINCIAL en 2023 ð¨ð©

LicenciÃ© en Leadership et Gouvernanceâª

Amoureux de la bonne gouvernanceâª";978;245;573;4923;6719
DiplomateRoddy;Roddy Diplomate;"Entrepreneur
Volontaire
Bénévole des démunis
Cadre de l'UNC
J'aime le Congo🇨🇩";472;885;1592;3764;6713
CharlierFranck1;Charlier Franck;Directeur-adjoint Handisertion , Conseiller Régional Bourgogne Franche Comté Délégué aux Sports, Adjoint au Maire de Gueugnon , Secrétaire Parti Socialiste 71;1125;330;504;4750;6709
QuotaClimat;QuotaClimat;Association engagée pour un meilleur traitement des enjeux écologiques dans les médias.;2185;460;3409;655;6709
poissecaille39;poissecaille;;3633;260;52;2764;6709
AlbertBramane;Albert Bramane;Cave ne cadas;1498;708;93;4407;6706
julesteem;Esklav@Révolté🇭🇹;Lè blan yo te vin en Afrik,nou te gen tè et yo te gen bib.Yo te anseyé nou pou nou priyé ak jé nou fèmen, lè nou louvri jé nou, blan yo t gintan pran tè ​​yo😩;1760;835;363;3745;6703
driss_diallo;Darys Junior;Ingénieur Financier, Directeur Général ORSRE, Homme Public, Citoyen du Monde.;2164;1043;476;3019;6702
JEANTETFRANCOI2;JEANTET FRANCOISE;;6589;31;6;70;6696
cath_lel;Catherine Lelievre;Responsable #communication. Je pense l’impensable, j'imagine l’inimaginable | Mes tweets n'engagent que moi.;2211;757;797;2929;6694
olivier_andreu;Olivier Andreu;Trend Analyst: Techs, Energy, Geopolitics, Mobility ð«ð·ðªðº ð¨ð­ð¯ðµð¹ð¼;823;624;91;5155;6693
Min_HydroRDC;Ministère des Hydrocarbures RDC;Compte officiel du ministère des hydrocarbures de la République Démocratique du Congo 🇨🇩;494;111;5958;124;6687
FZ_Cestas;Frédéric ZGAINSKI 🇫🇷🇪🇺;🏛️ Député 7e Gironde - Canéjan Cestas Gradignan Pessac - Conseiller Municipal #Cestas & Cdc Jalle Eau Bourde - chef d’entreprise - @imtatlantique;1033;1252;768;3633;6686
CWIEMEexpo;CWIEME;LEADING THE GLOBAL ELECTRIAL ENGINEERING REVOLUTION #CWIEME;3758;1414;1273;236;6681
SaMajesteNap;Asklépios;"Étudiant Droit⚖️/❤️Médecine.

Patriote/Libéral/Progressiste/Écologiste

Affilié Reconquête!/Divers Droite 🇫🇷";297;73;44;6263;6677
Nicolas64c;Niko;Combien désespérante la folie de l'homme, son mépris des autres,les signes trop nombreux que les leçons les plus élémentaires de l'histoire sont si mal retenues;4325;121;55;2175;6676
laurentdejoie;Laurent DEJOIE;Vice Pdt #ConseilRégional @PaysdelaLoire Pdt du #Notariat Francophone  Pdt Mission Europe International CSN Maire Honoraire #VERTOU #ComitéEuropéenRegions;1970;722;1685;2295;6672
CooperationCG;Ministère de la Coopération Internationale - Congo;Compte officiel du ministère de la #Coopération Internationale et de la Promotion du Partenariat Public-privé de la République du #Congo.;782;43;5837;9;6671
RevueRelations;Revue Relations;Revue d'analyse sociale critique qui œuvre à la promotion d'une société juste et solidaire depuis 1941. #80ansAuCœurDuLienSocial.;2269;1527;1840;1035;6671
Wilfried;Wilfried ð;#KhmerVert, #EcoTerroriste potentiel...;2199;779;279;3414;6671
VivoenergyMaroc;Vivo Energy Maroc;Vivo Energy Maroc est l’entreprise en charge de la commercialisation et de la distribution de carburants et lubrifiants de marque Shell au Maroc.;1577;441;4286;364;6668
ElisaBrasset;Élisa 🌷;Picarde atypique | Soutien 🚜 | Humaniste | Commerciale & sociétaire dans une SCOP| 🚀 Freelance a ses heures perdues |Ensemble nous sommes plus forts| 💙✨;2935;171;99;3452;6657
greveduclimat;GrÃ¨ve du Climat Suisse ð¥ #StrikeForFuture;"Pour la justice climatique et sociale. StratÃ©gie: grÃ¨ve gÃ©nÃ©rale
ðlinktr.ee/GreveDuClimatCH";2784;358;1751;1760;6653
mairie6_8;Mairie des 6e et 8e arrondissements de Marseille;Compte officiel de la  Mairie des 6e & 8e Arrondissements de Marseille;2193;802;3160;498;6653
HopitalFoch;Hôpital Foch;Etablissement de santé privé;1949;333;3829;540;6651
artcile;Lucile Cognard;"Involved in lacanian psychoanalysis (also webmaster & moderator in such an international asso). PhD in computer science. Franco-belge. 
@artcile@mastodon.top";5013;107;218;1308;6646
SylvainBaron4;Sylvain Baron;Je recherche un macroniste convaincu et courageux, prêt à me défier dans un débat public sur tous sujets relatifs à notre souveraineté nationale.;5188;115;489;845;6637
FuzionEsport_Fr;FUᏃᏆᏫN ᎬᏚᏢᏫᎡᎢ;🇫🇷🇪🇺 • European Esport organization under law 1901 from @sarthefr | Our partners/affiliate 🤝 @Kapolifr @ffjv_officiel @FatalGrips @InstantGamingFr;551;17;5450;617;6635
Aprifel_FR;Aprifel;Agence pour la #Recherche et l’#Information en #Fruits et #Légumes;2943;480;1781;1429;6633
Departement19;Département Corrèze;Compte Twitter officiel du Conseil départemental de la #Corrèze. Toutes les actualités. Retrouvez nous sur facebook.com/departementcor…;2083;347;3757;437;6624
ventdesmaires;Ventdesmaires;Nous sommes le vent des maires et élus révoltés par l’implantation abusive et autoritaire d’éoliennes. Trop c’est trop, non c’est non. ventdesmaires@laposte.net;1974;248;1132;3270;6624
Antho3197326279;Antho31;;2450;83;25;4064;6622
dardenne_emilie;Émilie Dardenne;"Maîtresse de conf. HDR @UnivRennes_2 anglais animal studies
Responsable DU Animaux et société 🐷👱‍♀️🐟
📕 Introduction aux études animales, Puf, 2ème éd. 2022";1800;568;1470;2783;6621
hessovalais;hessovalais;Au carrefour de la recherche, de l’enseignement et de l’innovation, la HES-SO Valais-Wallis offre un enseignement moderne, qualifié et axé sur la pratique.;2626;172;2819;1001;6618
Camaradramane15;Camso Camara;"Cyber Militant.... 
Observateur de la paix 
CEL:00225 0709707692";1347;622;1114;3532;6615
sleguilFR;sleguilFR;Écologue indépendante, pas écologiste. Guide nature, stratégie/comm scientifique. Parle biodiversité, paysage, agri, ville & campagne 🇫🇷🇱🇺🇬🇧 alt @sleguil;1811;1190;3035;575;6611
DeguenonEugene;Taïwo Eugène DEGUENON;Activiste des DH | Blogueur | Web-activiste | Ambassadeur ODD  | Fake-checker | CM | Médi & Faci de dév. Humilité;1613;1123;1287;2580;6603
HorizonsBreizh;Horizons Bretagne;Président fondateur de @HorizonsLeParti : @EPhilippe_LH • Secrétaire Général : @ChristopheBEchu • Référent pour la Bretagne : @RonanLoas;1885;253;1279;3185;6602
EugeneKedesh;kedou;ingénieur civil,logisticien,interprète,très hospitalier et toujours près à tout.;2482;1242;315;2563;6602
Nouvelles_ABC;L'ABC;L’alliée indispensable et fervent promoteur de la profession juridique au Canada. | Tweet us in English @CBA_News;5640;157;590;211;6598
Iapensee;Claude Gilbert KAMBA;Development worker, more than 20 years in development at international level. I believe in change that protects the people. Positive change.;1700;827;534;3532;6593
Gaysper_Fr;Gaysper France;;4639;60;32;1851;6582
Twittosdu91;En Marche Sur la Tête;🇫🇷 Comme durant le CNR, Refusons le stérile clivage Gauche-Droite pour redonner à la France sa pleine et entière souveraineté ! #FREXIT;1863;583;172;3963;6581
proteinindcan;Protein Industries Canada;The future of food is Canada.;1968;391;2562;1657;6578
ChebalMarc;Marc Chebal;"(Future épitaphe)
Passant passe ton chemin parce que si j'étais vivant tu serais mort. Alors ne pleure pas ma mort célèbre ma vie 🤗";5385;1;38;1147;6571
cedric_mizele;CEDRIC MIZELE;;2300;635;760;2876;6571
LeReveilduMidi;Le Réveil du Midi;#Hebdomadaire d'#actualités indépendant habilité à publier annonces légales et judiciaires, appels d'offres, et ventes sur saisie immobilière dans le #Gard.;4534;558;825;652;6569
AFHalifax;AF.Halifax;Established in Halifax since 1903. Belongs to the world's largest network of French language schools & cultural centres. 5509 Young Street, Halifax, NS;1954;588;1620;2406;6568
MEQ_QME;Manufacturiers et Exportateurs du Québec;"Plus grande association industrielle au Québec. 
Main-d'œuvre, #Innovation, #Exportation";2990;931;1643;999;6563
KpakpatoM;Kpakpato Medias;;5853;432;65;211;6561
AngeliFrederic;Frédéric Angeli ⚡️;"Mobility Program Director | Software République @Groupe_Renault
#OpenInnovation #SutainableMobility
#Sovereignity #Mobility #Decarbonization #Multimodal";1013;948;780;3818;6559
Mathieu52127651;La France dans le Bon Sens;"Le Libéralisme au service du bien commun.
68 millionième Président de la République.";4221;275;89;1971;6556
StepanYvan;Yvan Skottuba-Stepan;Conseiller municipal délégué #TransitionEcologique, Urbanisme, PLUM et permis de construire, Cagnes-sur-Mer - #Renaissance;2174;285;308;3782;6549
zafa113;zafa;;4758;819;48;918;6543
PhilippeE31;Philippe ðâ¢ï¸;La dictature parfaite serait une dictature qui aurait les apparences de la dÃ©mocratie, une prison sans murs dont les prisonniers ne songeraient pas Ã  sâÃ©vaderð¦«;5878;31;35;596;6540
BoileauClaude;Claude Boileau;"""Viens
Un nouveau jour va se lever
Et son soleil 
Brillera pour la majorité qui s'éveille"" (Jacques Michel)";3486;714;89;2250;6539
ClairePinto91;Claire Pinto ð²ð»ð¦;ConseillÃ¨re municipale de la minoritÃ© Ã  Palaiseau / @EELV / @FCPE_nationale;3362;554;928;1693;6537
Ally_said_no;Ally - of the mountain ð´ð¥;"She/Her - ðð³ï¸âð  
Ã gauche de la gauche du pote d'extrÃªme gauche de ton pote d'ultra gauche. Je hais 99,98% des hommesâ¡â»ï¸";1548;165;84;4726;6523
LeLouverture;Le Louverture;informer en formant et de former en informant |Email:lelouverture1@gmail.com;2091;1259;1251;1916;6517
la__mante;La Mante;"Loser en bourse depuis Dec 2001,
Je regarde de + en + le fondamental
Fan d'obv court terme";4834;15;130;1526;6505
R24Officiel;R24.BE FR;Retrouvez Suivez en direct l'actualité et Radio en Belgique et à l'international sur le site de R24;6487;0;12;0;6499
tulipe77429910;A3 les piles 🔋🔌;"Benis soit l'ignorant qui ne connait pas le doute      
Tacos 2 viande 13€🌯";215;262;18;6004;6499
Thomas_ANESTAPS;Thomas Chapotat;ðPremier Vice-prÃ©sident GÃ©nÃ©ral Ã  lâ@ANESTAPSð³;1071;404;454;4568;6497
Erispo3;Erispoë;;6147;57;7;276;6487
Alasko73;Alasko Diallo;I'❤️ MALI;3154;927;528;1873;6482
jebelhadi;J.E.Belhadi;«Quand un peuple ne défend plus ses libertés et ses droits, il devient mûr pour l’esclavage”.  JJ Rousseau;3634;332;172;2344;6482
MagazineMci;Magazine MCI;Le #MagazineMCI reflète l'actualité industrielle et manufacturière québécoise. Le MCI est LA référence!;4458;561;939;524;6482
TheJaread;Citoyen, c'est tout.;"Homme blanc cis barbu,
Tendance khmer vert mention écolo bobo gaucho cyclo,
Bullitter à ses heures,
Parfois brakeless parce que.
#criticalmass #carisover";2323;370;209;3577;6479
axeltardieu;Axel Tardieu;"Vidéo journaliste à Montréal (Canada) pour le 24 Heures. 
Previously based in Paris, working for Arte, France 2, M6, Canal+. 
DM for Signal/Telegram/ProtonMail.";3464;733;1210;1069;6476
GlobalInfos;Global Infos;"Production audiovisuelle et média en ligne, pour la RDC, l'Afrique et le monde
Consultance en communication, Impression sur tout support, Intermédiaire Médias";5859;344;242;25;6470
USJCFDT;CFDT Journalistes;CFDT-Journalistes sur tous les fronts sociaux et déonto de la profession. Justice pour les confrères tués, agressés, baillonnés ici et ailleurs.;2960;305;2075;1118;6458
vadimusconseils;vadiMAP;Pioneering Building Energy AI for companies seeking optimal energy solutions benchmarking.#MovingontoGreen with vadiMAP.com;5593;468;197;197;6455
fautquonenparle;Faut qu'on en parle;Faut qu'on en parle ! ® est un magazine de société diffusé chaque mois sur des radios FM / DAB+ / webradios. fautquonenparle.fr #fqep #radio #debat;3794;503;394;1763;6454
skyzonte;Skyzonte;;2921;16;19;3492;6448
alouche31;Alouche31;Gamer, keen on science, graduate in industrial product design & processing, programmer of my free time. 🇫🇷🇬🇧🇯🇵;4650;226;22;1549;6447
SundaKastaagir;Ramrod;Art, Virtual Photographer, Electronic entertainment, technophile, Israelite, french from Paris;3177;155;31;3074;6437
Judak34;Ke sunrt;;3238;421;52;2722;6433
DorianeBecue;Doriane Bécue;Maire de #Tourcoing. Vice-Présidente en charge de l'insertion et retour à l'emploi @departement59. 🇫🇷;2066;867;2593;903;6429
HCCanGhana;Canada au Ghana;Haut-commissariat du Canada au Ghana - English @CanHCGhana - international.gc.ca/mediasso…;3538;189;2447;252;6426
atlanticinfos1;Atlantic Infos;;4918;988;513;4;6423
attendreunpeu;réfléchissons;Ne rien retweeter sans l'avoir vraiment lu, et vérifié.;3490;1178;65;1690;6423
lemilaparis;Le Mila;Créé en 2002, le Mila est une association qui héberge et accompagne des structures de la filière musicale 🤝 #LaMilaFamily. Lucie Monrocq & Aude Merlet 😎;2986;645;2124;662;6417
unss_70;@Unss_70;"Partageons plus que du sport en Haute-Saône:
Pour les élèves, par les élèves.";1498;645;537;3731;6411
CanadaArgentine;Canada en Argentine;"Ambassade du Canada en Argentine.
English @CanadaArgentina | Español @EmbCanArgentina";4217;68;2059;66;6410
Vi_albu;alb_Vi;Petit filou à mes heures perdues;2056;104;21;4229;6410
LyceePommerit;Lycée Pommerit;"Des formations de la 4ème à la Licence Pro. 
Site internet : lycee.pommerit.fr/

Lycée POMMERIT 22450 La Roche-Jaudy";1353;424;566;4066;6409
la_FAE;FAE;La FAE, c’est plus de 66 500 profs rassemblés pour améliorer leurs conditions de travail et protéger l'école publique! 👩🏻‍🏫🧑🏽‍🏫👨🏼‍🏫;1893;989;2838;686;6406
PhilJLau;Philippe;« A full and fair weight you shall have, a full and fair measure you shall have, that your days may be long in the land that the Lord your God is giving you »;4752;264;91;1292;6399
VerdiereSimon;Simon VerdiÃ¨re ð¢;"Toujours heureux de ne jamais Ãªtre content.

Auteur pour Mr. Mondialisation : mrmondialisation.org/?s=verdâ¦";5310;469;292;322;6393
Yannlebondoseur;yann lebondoseur;Simple citoyen tenant un blog d'économie et de politique version protectionniste, keynésien et farouchement anti-UE .;5187;285;144;773;6389
_B_LJ;Benjamin La Joie;"#transitionEcologique #politique #geopolitique
Responsable territorial GRDF Paris. 
Trésorier des PIMMS Médiation de Paris.";638;3615;390;1741;6384
bretonfish2;bretonfish2;;6251;21;47;54;6373
Optedif;Optédif Formation;Centre de formation créé par les formateurs. Optez pour la différence Optédif. #Formation #Formateur #Compétence;6144;127;94;3;6368
noncitoyenne44;Stef44;Je discute avec tous tant que c’est respectueux et dans la bonne humeur, sinon passe ton chemin car je bloque. Nantes;4946;170;152;1092;6360
RullOlivier;Olivier Rull;Building sustainable pension for today's workers @CaravelPension Impact driven entrepreneur @GreenTechEarth @DomosKit;806;2650;1741;1157;6354
jbaptisteDrouet;JBDrouet;Responsable régional formation compétences @medefpdl #emploi #apprentissage #recrutement #compétences #inclusion #rse;1802;966;658;2917;6343
ANTOINEDSP;ANTOINEDSP;cadre secteur bancaire (retraite);1013;426;60;4843;6342
Coleg243;Colette Egea;;5335;29;71;907;6342
ulysse_RP;Ulysse Communication;Agence de #RP par les ex-journalistes @MocciJeanPh et @NicolasDaniels2 #communication #finance #assetmanagement #patrimoine #immobilier #privateequity;3724;1052;745;819;6340
mwananshie;Francois Alain;;5431;91;320;498;6340
EricPainTeamsun;Eric PAIN;#solaire #Industrie #innovation #decarbonation- Co-Fondateur de TEAMsun et de SUNNYPROD- Fondateur du ClusterSolaire de Normandie Énergies - Trésorier FFB-GMPV;3668;198;209;2263;6338
eaufrere;EsOpE;;3651;60;17;2608;6336
ICN_RCC;ICN | RCC;The Inter-Council Network is a coalition of Regional Councils for International Cooperation committed to global justice & social change.;2521;874;821;2120;6336
AntoineBouziat;Antoine BOUZIAT;Geoscientist at IFPEN - Numerical models & #digital in subsurface industries - Rocks, tech and cool sciency stuffs :) - #AI for #Geology - Views are only my own;821;3531;1324;659;6335
michel_brillaud;michel brillaud;;6311;1;21;1;6334
DarilvStras;DARILV académie de Strasbourg;"Délégation académique aux relations internationales et aux
langues vivantes @acstrasbourg.
Mobilités internationales, action régionale transfrontalière";2998;633;711;1991;6333
InsafZed;Nassoufy;« The greatest enemy of knowledge is not ignorance, it is the illusion of knowledge. » Stephen Hawking.;2791;238;263;3037;6329
MatthieuRegnier;Matthieu Régnier;"Faire avancer le monde avec SENS. 
Lead Maker (& CEO) @DAGOMA3d - 1/Water 2/Electricity 3/Data 4/Objects #3dprinting";4432;438;415;1041;6326
River1Paradis;Collectif Riverains Paradis;"Collectif de riverains de la rue de Paradis (75010 Paris) 
Compte apolitique
Nos propositions pour notre rue : bit.ly/39VYlJj";2976;226;516;2608;6326
crypto_minages;crypto mythique 🇫🇷;Pro nucléaire, crypto actif, Web3, Générative A.I.;5326;213;67;716;6322
AGERCA1;AGERCA;L'AGERCA est une association d'entreprises et de la société civile qui évolue dans le secteur de la Gestion des Risques et des Désastres (GRD) en Haiti.;2718;373;1887;1342;6320
PatJob3;larry burnout;Geek , grand amoureux de l'être humain et mon cul sur la commode tu es juste un fumier de collabo 🤣 ah oui j'oubliais à tous les petits larbins 🖕;3484;129;105;2596;6314
SweAmbMorocco;Jörgen Karlsson;Ambassadeur de Suède au Maroc 🇲🇦 🇸🇪;1050;1280;3119;860;6309
Journalecoma;journaleco.ma;Support digital d'actualité economique et financier au Maroc;5546;315;90;355;6306
Ben45889244;Ben;;4076;37;27;2161;6301
Julien_Ville_;Julien Ville;Professeur des Universités @UBO_UnivBrest, Secrétaire Gén. Ligue @Occitanie #Natation, Trésorier du Groupe Français de Rhéologie, AVEYRONNAIS;2146;356;493;3302;6297
descartes_devin;Descartes Développement & Innovation;Développement & promotion Pôle d'Excellence #VilleDurable #CitéDescartes, #innovation, #IncubateurDescartes, #FablabDescartes atelier de fabrication numérique;2182;959;1268;1886;6295
ArtDuCombat;Art du combat;"GSP IS the true GOAT forever.....
pronoms : go/fuck/yourself";4233;146;26;1887;6292
ArnaudDelebarre;Arnaud Delebarre;"Né en 316 ppm CO2. #Energie. #Enseignement. #Environnement. #Mathématiques. #Montagne. Apprécie les idées et esprits affûtés ; donc peu le macronisme.";4593;180;361;1157;6291
BBTigredusoleil;BBTigredusoleil;The official Twitt of BBTigredusoleil ^_^;2104;94;24;4069;6291
CMM_info;Communauté métropolitaine de Montréal (CMM);82 municipalités = 4,1M personnes = moitié du Québec | Bâtir un #GrandMontréal compétitif, attractif, solidaire et responsable 🌳🚴 🚅;2229;914;1526;1620;6289
GildasGouez;gIGi;;4563;580;126;1018;6287
MyriamGorlier;Myriam gorlier đźš€& đźŹ„;Mes tweets nâ€™engagent que moi #FuturDuTravail #Impact;2944;642;384;2314;6284
Madininair972;Madininair;"Madininair est l'observatoire de la qualité de l’#air en #Martinique.
#QualitéAir";3849;288;1075;1071;6283
ADufumier;Alexis Dufumier;Consultant / Ingénieur agro : marchés, distribution, écologie scientifique, innovation, science de l'évolution et des écosystèmes appliquée à l'agriculture etc.;2852;1543;1876;11;6282
SUIFSU_CRETEIL;SUI-FSU, Créteil;"LE SYNDICAT UNITAIRE DE L'INSPECTION (SUI-FSU) Créteil

Né le 10 novembre 2021, le SUI-FSU (fusion du SNPI-FSU et du SIA) syndique notamment IEN et IA-IPR";3364;301;432;2184;6281
citemetiers22;Cité des Métiers 22;Informations et conseils sur les #métiers, la #formation, l'#orientation, la recherche d'#emploi et le changement de vie #professionnelle ! citedesmetiers22.fr;3359;1018;1358;544;6279
cathmacgregor;Catherine MacGregor;CEO @ENGIEgroup - Directrice générale d’ENGIE;228;385;4632;1034;6279
lucierigal;Lucie Rigal;Social-democrate;446;2567;2445;821;6279
PouvoirDeVivre;Le Pacte du Pouvoir de Vivre;Plus de 60 organisations unies pour répondre à l'urgence sociale et climatique;831;99;4914;430;6274
jem_toto;toto jem;"Habite en Indre et Loire. Couple Franco-Québécois
Critique de la (dé)raison pure.
Voilà pourquoi la macronie ne m'a pas encore atteint le cerveau (et le bras)";5692;80;84;414;6270
ParlDiplomacy;Parl Diplomacy;Official account for info about the diplomatic work of Canadian Parliamentarians. Notices: ow.ly/dEFh30bHrrE  FR : @DiplomatieParl;2087;35;4143;1;6266
MBB_assurances_;MBB ASSURANCES;Assureur de proximité pour les Particuliers, Professionnels, Entreprises et collectivités;4647;58;23;1537;6265
eelvParis10;EELV PARIS 10;Groupe local #EELV du 10eme arrondissement || Co-secrétaires : @leaChataigne et @jmhupel;2822;1151;1519;773;6265
DreyfusLawFirm;Dreyfus & associés;Dreyfus is internationally recognized as one of the few intellectual property firms with expertise in the digital economy.;3172;1740;1163;178;6253
johntartempion;John Tartempion;Centres d'intérêts divers;2200;85;34;3933;6252
RefHotel;Ref-hotel;Offers a wide range of platforms for referencing hotel and travel websites, in several languages.;2944;1988;1319;0;6251
ThierryOLIVIE16;Thierry OLIVIER;Juste de passage - je tente de comprendre le monde qui  m'entoure - avec plus ou moins de bonheur à la clef;1343;209;19;4680;6251
zeutwinsMomo;DZ REVENGE 🇩🇿🇩🇿;Défends le patrimoine algérien contre les usurpateurs. Ils ont pris notre silence pour de la faiblesse mais on était juste gentils et tolérants. C'est terminé !;2776;98;424;2950;6248
AT_Titan75;AT-Titan75ð¨ðµð¬ð§;"ð«ð· Fils d'ouvrier, Ex-Juriste, 
Militant AthÃ©e, 
L'essence de la culture occidentale, c'est le droit, pas le MacDo. Samuel Huntington.ð«ð·âð¼ðð¤¿ð®ð·ðð";2821;188;131;3108;6248
Yasrod4;Yasrod🥷11🏆❤️💙;@neymarjr @memgrizz💙🧸@psg_inside❤️💙 @carlosalcaraz🐐. 🇩🇿🇲🇦🇵🇸;4649;65;46;1481;6241
HDevambez;gypaetre;;1761;20;17;4443;6241
Gilba02568853;Gilba;Ok;4457;281;72;1431;6241
ClintH0rris;Clint Horris;j'aime la funk et zidane;4972;393;135;740;6240
AlainCanonne;Alain Canonne;Délégué Général de Solidarité Laïque - Mes tweets n'engagent que moi;1942;837;671;2787;6237
imgsat973;Gwenael Régnier;"Enseignant H-Geo ; doctorant à l'EHESS ; intérêt pour l'utilisation des images satellite en classe de géographie";377;265;196;5391;6229
CDuqueroix;Ch. DUQUEROIX;« Seul un esprit éduqué peut comprendre une pensée différente de la sienne sans avoir à l'accepter » Aristote (Mes tweets n’engagent que moi...);1642;352;395;3839;6228
Mule__du_pape2;Mule__du_Pape ✌️;Compte tenu par mon équipe. Les tweets écrits par Mule du Pape sont indiqués MP. Membre du collectif des Commentateurs Atterrés. Chargé de mission pas claire.;3149;1281;529;1266;6225
AdonisEvra;Adonis Evraïkós;Nul n'est censé me connaitre, et pourtant je suis là où personne ne m'attend.;4070;83;43;2028;6224
NormandLoviat;Norman;Engineer, currently busy with innovation management and energy transition // Rockstar @ the Postponed;1390;328;56;4448;6222
ChancelierKoni1;Chancelier Koni;Secrétaire Gén de la Fondation Nguvu FNG, Ingénieur électromécanicien, Promoteur de CHANEKK Services, Entrepreneur et Prédicateur de l'évangile de Jésus-Christ;452;1792;659;3316;6219
DoGui3891;Dorian Guinard;"Enseignant-Chercheur. MCF en droit public à l'@UGrenobleAlpes - @SciencesPo38. 
Droit de l'environnement. Droit public de la concurrence. 
Compte personnel.";2909;300;1447;1563;6219
JeunesseNupes;ð´Prolo Mag;"Les Vrais News. ð°
Pas dictÃ©es par les Ãlites. â
Seulement le vrai. â¬ï¸";1961;679;3397;181;6218
Tribune78430;Tribune Louveciennes;Flash info sur l'actualité de Louveciennes et de ses environs. Relais du site internet La Tribune de Louveciennes.;5193;194;591;235;6213
ColzaDifferent;Colza ≠;#ColzaDifferent Bienvenue ! Ici, on parle des nouvelles pratiques de culture du #colza (actualités, conseils techniques, innovations, interviews & vidéos) 🌱;1387;425;1572;2827;6211
UddNormandie;đź‡®đź‡ą đź‡­đź‡şRECONQUĂŠTE NATIONALE FRANCE đź‡˛đź‡« â„˘ď¸Ź;đź‡˛đź‡« | @Reconquete_off | @ZemmourEric | @MLP_officiel | @dupontaignan | @f_philippot | @UPR_Asselineau| @P_Vardon | @Stephane_Ravier | @RNational_off đź‡®đź‡ą;3139;205;2403;459;6206
FondTransdev;Fondation Transdev;La Fondation Transdev fête ses 20 ans ! Suivez nos actualités et celles des projets que nous soutenons. #emploi #éducation #culture #sport #socInn #mécénat #ESS;3038;996;1609;561;6204
AleZagaMendez;Alejandra Zaga Mendez;Députée solidaire de Verdun.;1809;864;1715;1814;6202
steeve603;steeve603;;3103;359;214;2523;6199
DavidLegros33;David LEgRoS;"Electromobiliste

#5Echanges et on acte le désaccord en se quittant bons amis.

Vous pouvez aussi me retrouver sur @kenny@framapiaf.org Pweteur depuis 2017 TM";4365;442;461;930;6198
FrCarriere2;François Carrière;;592;126;77;5403;6198
Philippe_Auge;Philippe Augé;Président de l'Université de Montpellier @umontpellier,  Professeur de Droit public;886;371;2903;2032;6192
elephantech225;Elephantech;L’actualité technologique en Côte d’Ivoire, du continent africain et celui d’ailleurs sur l’innovation, économie numérique, e-commerce, emploi, analyses.;2827;393;2614;356;6190
Rachetrox;Rachetrox;;5528;39;29;591;6187
TMoeurs;TaZz ๐๐;Y a toujours une solution, la difficultรฉ c'est de la trouver - John H. Smith;5175;288;364;357;6184
xrParisIDF;Extinction Rebellion Paris / Île-de-France;Compte Paris / IDF d'Extinction Rebellion Désobéissance civile non-violente contre l’effondrement écologique ! ⏳ Rejoignez-nous ⏳;1709;191;2177;2106;6183
SimpleF12656939;Simple Facts;On Twitter to document thesis on Brexit and Russian convergences in trolling.  « if you have the choice of being right or being kind, be factual. »;3740;288;32;2116;6176
SandraD19165112;Sandy 🌎🌏🌍;;3606;18;5;2536;6165
YumiUtopia;Utopia;Should we be wise but not haughty, passionate but not devotees, and should we be free but not irreverent. Ma connerie m aide à supporter mon intelligence;4304;94;94;1671;6163
Mg3Jiji;JMeGa;;271;34;25;5830;6160
Argost_;Lman;;251;196;18;5694;6159
tx_analysor;tx;"alpha finder | threadoooor
All my research: cutt.ly/74Bwzlk

writer @snowball
advisor @PlebVCC
learning @tokengineering";2747;74;1040;2291;6152
LiLiOTB;• LiLi •;Feminist / Humanist;3994;208;53;1894;6149
bibliopolymtl;Biblio Poly Mtl;Le génie et les sciences sont au cœur de la Bibliothèque Louise-Lalonde-Lamarre de @polymtl, qui soutient et met de l’avant la #RecherchePolyMtl;3479;649;580;1437;6145
HamelFabien;Hamel Fabien;Astronaute terrestre, engagé et passager du monde.;1112;100;42;4890;6144
QuilicoUgo;Esthète;La banalité et la médiocrité sont le fruit de l'ignorance et de l'inculture/ن/ciné & audio-phile   🇮🇹;2313;530;496;2803;6142
BernaEmmanuelle;berem92;CTEVS @académie de Poitiers #perdir;1249;421;427;4045;6142
GrillandGarden2;Grill and Garden;"Specialite barbecue artisanal

 Mardi-Dimanche 12h-21h 📱/wha 693690387
Situe yassa Face ancien pesage entree Camco";894;1356;2547;1336;6133
LuMaetz;L Maetz;Ălu local progressiste đȘđș Maire-adjoint du VĂ©sinet (78);2075;231;132;3694;6132
Chross19;Chro;"He/Him
22 yo
Trop de gacha , tue le gacha";1863;136;16;4115;6130
ClasheurJ;Clasheur Jerome;fb.watch/bcLf04i1Mz/;4412;45;43;1612;6112
ilyessghz2;ilyessghz;"Investisseur #Bitcoin • Social Media #Crypto, #Web3 • Analyse + Partage • AIrdrop🎁🪂 • I LOVE #BNB #ETH #BTC #ATOM #APE •
 
gazo fanboy  💼⬇️";1056;327;689;4035;6107
PlasticOdyssey;Plastic Odyssey;⛴ An expedition around the world to reduce plastic waste in the ocean and build a global network of local recycling initiatives ♻️ #plasticpollution;1268;285;3059;1483;6095
Jontrans;Transports Jontrans;"Les spécialistes du transport de matières dangereuses et des conteneurs Dry Bulk et citernes.
#Jontrans #Conteneur #Transport #Logistique #Lyon #SaintEtienne";5482;482;127;3;6094
PhilippePellie1;Philippe Pellier;je m appelle Zangra, je suis vieux colonel au fort de Belonsio .;3220;1128;394;1351;6093
emmanuelkalonji;Emmanuel KALONJI KABEYA SHABANZA;"Correspondant régional de Deutsche Welle (DW) DW Afrique  dw.com/francais 
Journaliste à @TopCongoGKasai Mbujimayi";1025;3058;1187;823;6093
haby_haby2;Habyarimana Léon;;1106;726;1846;2414;6092
JP__Benoit;Jean-Pierre Benoit;Directeur et Rédacteur en chef de RCF Reims-Ardennes;3646;952;1100;388;6086
CEGivors2020;Mohamed Boudjellaba;"Maire #Givors #ConstruisonsEnsemble
@EELV @GEcologie";3173;216;1426;1270;6085
TankEnergies;News Tank Energies;Média global sur abonnement dédié à l'information des dirigeants du monde de l'#énergie //  #gaz #électricité #renouvelables #réseau #nucléaire;1810;1047;720;2507;6084
LaVoieEstLibre_;La Voie Est Libre✊🌍✊;COLLECTIF CITOYEN - Aménageons la RN126! Non à l’autoroute Castres-Toulouse! Intérêt général, gratuité, environnement, préservation des terres agricoles...;1806;331;1619;2324;6080
terresdenvol;@terresdenvol;Territoire réunissant @AulnaySousBois, #LeBourget, @leblanc_mesnil, @Ville_Dugny, @VilledeDrancy, @SevranVille, @VilleTremblay @VilleVillepinte.;2358;333;1640;1748;6079
CF2ID;CF2ID;#bibliothèques #documentation #musées #patrimoine #archives - Conseil et formation. Préparation aux concours et examens professionnels de la fonction publique;3874;157;1417;627;6075
ENSAT_INP;ENSAT - L'AgroToulouse;École Nationale Supérieure Agronomique de Toulouse;2499;465;2148;953;6065
PaulH_B;Paul-HB.;;5801;40;58;164;6063
ASATILDAISAKSON;Åsa-Tilda Isakson (official account);"International family. Seven languages. Girlfriend to E (Texas, USA). US Diplomat Immunity. Kids; Swe, French citizens. Freedom. Love. Privacy. Family. Democracy";3037;15;1;3008;6061
epticxl1;Nadirrrux マ;🇲🇦;324;253;376;5108;6061
philippe_gi;Philippe Girard;Technicien Productions végétales spécialisées. #mestweetsnengagentquemoi;2018;468;396;3175;6057
PresseDILA;Service Presse DILA;"Service presse à destination des journalistes
DILA - Services du Premier ministre
#JORF #Légifrance Service-public.fr Vie-publique.fr";334;4532;1024;166;6056
HarounBouazzi;Haroun Bouazzi;"Député de Maurice-Richard
Porte-parole de Québec solidaire en matière d'économie et d'innovation, d'énergie, de finances, de cybersécurité et du numérique";2099;615;2845;494;6053
EELVBourgogne;EELVBourgogne đ»;Compte officiel d'Europe Ecologie Les Verts Bourgogne;2554;441;599;2459;6053
Ghassen90059054;Ghass;;1212;278;64;4498;6052
TIEMO12;Ibra kalil🇲🇱;;855;193;83;4916;6047
DRouages;De l'huile dans les rouages ⚙️;"Conseil en management - J'accompagne les entreprises dans leur volonté d'amélioration continue, organisationnelle et managériale 🛠
#QSE #RSE #Agilité #podcast";3400;728;250;1669;6047
SbastienLauwers;Sébastien Lauwers;(v) auto-confirmed account, Spécialiste de Rien☀️🌪🌊⚡️;3823;891;64;1261;6039
SOSOrdinet;Association SOSOrdi.net;"Entraide informatique gratuite, actualités informatiques 🔎📱🦟🛠️💻 sosordi.net/boutique-en-li… 👉👕👈 buymeacoffee.com/sosordinet
sosordinet.bio.link";5226;12;339;462;6039
FrBiomethane;France Biomethane;"Un groupe d’experts qui désire accompagner et démocratiser toutes les étapes de la révolution du #biomethane en France 🌿
LinkedIn : swll.to/qZVAl";1795;532;2842;864;6033
denisboudy;Denis BOUDY;Responsable d'activité solutions digitales & Cybersécurité @ScredinSoftware & @GroupeIngerop;3064;1447;524;998;6033
algerie62info;Algerie62;Journal d'Information Générale Online;5877;81;70;1;6029
Louarn2;Hervé Louarn ❤️;"Conseiller délégué à la mobilité - Landéda l'Aber Wrac'h
#Teletravail #Mobilité #AutoStop #Covoiturage #TransportsCollectifs #Durable #Solidarite #Partage";3002;760;606;1659;6027
BoumeurGilbert;Dr complotiste 🐭;Docteur devenu complotiste le 12 juillet 2021. Crypto, pour la liberté ! Trader, enseignant, écrivain etc. #ftm #matic #eth;2397;451;1134;2041;6023
CyrilVioleau;cyrille Violeau;Rien a dire;5313;22;38;646;6019
ATokenInvestor;CryptoFun;"#Crypto-curious #Crypto-addict
Nobody can literaly follow me

Que ce soit dans la rue ou sur Twitter je déteste qu'on me suive 😎

100% sans parti politique";2149;531;31;3305;6016
joh_kouassi;Johanne Kouassi;Conseillère de Paris PEC #paris13 déléguée à la Petite enfance et aux familles;783;1061;807;3359;6010
GoldorakDust;Goldorak.e;écosocialiss’ non binaire multi genré;2924;155;87;2842;6008
domitillecrn;Domitille Caron;;1562;452;286;3701;6001
F_Rivieres;Fondation Rivières;"Ensemble pour la protection des rivières et des cours d'eau du Québec
Organisateur principal de @LeGrandSplash 💦";2577;1046;1889;488;6000
villedegrigny91;Ville de Grigny (91);Compte officiel de la Ville de #Grigny (30 000 habitants) ! Ville la plus jeune de l'Essonne, membre du réseau mondial des maires pour la paix.;3485;525;1118;871;5999
2SAINTPABLO;🕊️;full time pretty girl 🇨🇲;4938;90;209;759;5996
FullbrightSteve;Steve Fullbright;;5286;82;46;580;5994
AntoThoraval;Antoine Thoraval đ»;"Histoire de la SĂ©curitĂ©. 
ActualitĂ©, sport, politique, photo.";1253;448;62;4223;5986
cikurukamera;Chavez Kamera;ChargĂ© de communication de MKAAJI MPYA asbl| Task Force #YPARD |Chercheur au centre Angaza Institute đź‡¨đź‡©;59;4499;653;772;5983
JHPCr;Jérôme Cristiani;journaliste;3605;1200;772;397;5974
Gazdaujourdhui;Gaz d'aujourd'hui;­čôîQuotidien sp├ęcialis├ę sur le secteur ├ęnerg├ętique. ­čôîFocus gaz/gaz renouvelables/hydrog├Ęne. Ô×í´ŞĆAnalyse, DATAS, infographies et ITW Ô×í´ŞĆWeb et print;2022;503;2089;1355;5969
alincar43;Alincar Jacquecene;I’m humble, wise, kind and intelligent. I’m trying to expose everything behind the most interesting. Membre @nouse_vip;1940;1093;1630;1302;5965
LaurentScapin;Scapin laurent;tuttut;3049;51;17;2848;5965
france_sdg;SDG CHAMPIONS France;Mise en œuvre opérationnelle de l'Agenda 2030/2030 Agenda operational implementation;426;4578;624;335;5963
EvaCyrCt1;BiblioCritique;Bibliothécaire travaillant maintenant au Québec, je m'intéresse à la bibliothéconomie critique et à l'évolution des bibliothèques. #critlib #polqc;5429;247;262;23;5961
KaufmanetBroad;Kaufman & Broad;Depuis sa création en 1968, Kaufman & Broad a commercialisé ou fait construire près de 124 000 logements et 820 000 m² de bureaux et locaux d’activité.;1377;1003;3357;219;5956
Agns5Agnes;Agnès Agnès;"Être heureux c'est être libre..
La voix est notre PEUPLE
L'âme est notre NATION";3904;19;51;1979;5953
BanzaMukenge;Pathy banza;"Ingénieur, Master en Management des Opérations et Entrepreneur ; Domaine entrepreneurial :Études, Énergies, Génie civils et constructions";2811;510;179;2449;5949
CreaSUDCom;Créa-SUD;L’Agence (toujours) au 💙 de l’événement.   Groupe indépendant de communication événementielle : plus de 25 ans d'expérience.;2255;624;971;2096;5946
iconicyous;yousð¤â¨;Ã©lÃ¨ve-ingÃ©nieur Ã  mes heures perdues;3968;113;974;890;5945
MCroisard;Le meilleur ami de l'homme đź—ş đź‡«đź‡·đźŚż đź’¤;Meilleur ami de tout le monde. Sauf des supporters anglais.;3780;735;559;862;5936
sylchery;Sylvain Chery;co-founder, director of Agile Partner. Entrepreneur, startup mentor, Agile project manager, CSM, CSP, SAFe Agilist and Agile coach & trainer.;2623;1502;1020;791;5936
Waelieu;Mathieu Ferragut;Publicitaire #Nexity #ExWPP #ExPublicis #ExDAN #ExOmg  +  formateur & consulting + Ex #essec #berkeley #Hetic + 3xpapa;2911;916;350;1755;5932
Pierre_Igot;Pierre Igot;Traducteur, auteur, correcteur. ATTENTION : Je ne mâche pas mes mots. Âmes sensibles s'abstenir. L'heure est grave. Site Web : fauxamis.fr;4267;32;1594;26;5919
PfChenu;Pierre-François Chenu;"Directeur relations institutionnelles @ENGIEgroup
#énergie #biogaz #électricité #TransitionEnergétique #CEE #Arenh #ENGIE
Mes tweets n'engagent que moi";2040;816;736;2322;5914
Eau_et_Climat;Eau&Climatđ§;ActualitĂ©s et informations sur la gestion de l'#eau en France et Ă  travers le #Monde. #RĂ©silience #Territoires #ODD6 đ§;1279;547;599;3489;5914
EELV_85;EE-LV Vendée🌻🌍;;1084;486;211;4131;5912
clemdescamps;Clément Descamps;Liberté • Égalité • Solidarités • Progrès;4792;116;367;636;5911
preservons;Nantes-Atlantique - Préservons l'humain;;2626;460;269;2553;5908
Senami_Senami;Senami;;5634;12;39;218;5903
OnakuduF;ONAKUDU Francis;Je sais que Dieu a fait de moi son fils (jean 1 :11-13), je le ressemble (gen 1:26-27), je suis vrai adorateur ( jean 4 :23-24) et l'adore jour et nuit (ap 7).;4636;332;143;789;5900
kikijoel;Genevrier Christian;Retraité - Passion les Verts de Sainté - Associés Supporters ASSE Abonné Stade Geoffroy Guichard . Et Grand FAN Johnny HALLYDAY.;4342;353;262;939;5896
Candide18;Candide;"""La démocratie pingouine ne se gouvernait point par elle-même;elle obéissait à une oligarchie financière qui faisait l'opinion par les journaux"" Anatole France";2973;108;102;2712;5895
BowzoleDozo;Bowzal;;4609;33;17;1229;5888
damien_charte;Damien Charte;Militant @UnionSolidaires / @SyndicatASSO;2831;481;293;2282;5887
guigui30000;Karman-line;J'aime la science, l'astronomie et fabriquer des trucs;3501;51;54;2279;5885
sallesleMonde;AlainSalles;Chef du service Idées & Débats du Monde.;2706;925;2178;69;5878
MotivaleD;MotiVale;I'm not in this world to live up to your expectations and you're not in to live up to mine. Electron libre de pensée, de réflexion et d'action. Carpe diem⏳;2898;108;35;2835;5876
WatchServ;WatchServ;Sortir de l'UE;2617;149;53;3052;5871
_Seen2207;Seen;Une biographie 🤔🤔;993;449;56;4367;5865
NikiFontaine7;Niki Fontaine;#DirCom @Bouygues_Immo, City & Culture lover tweeting about #Realestate #Sustainablecities #Smartcities #RSE #Climat #Architecture.;1514;301;675;3372;5862
ReconqueteRhone;RECONQUÊTE! | Rhône;Fédération RECONQUÊTE! 🇫🇷 | Rhône 🦁⚜️| Délégué départemental : Xavier FOURBOUL | Rejoignez-nous !;2285;216;2109;1250;5860
sinseedz;sinseedz;;2967;373;13;2504;5857
summit_fr_io;Summit.io;Nous rendons accessible l'univers de la blockchain et des cryptomonnaies en construisant ensemble un écosystème transparent, éthique et compréhensible.;1341;138;2650;1727;5856
MetPas69;MetPas69;;795;12;17;5031;5855
jerebokk;jeremie;intéressé par le développement économique, l'inclusion financière et les fintech.;3255;414;582;1603;5854
emilior56447670;Rodri 60;;2922;46;24;2855;5847
ilhan_alxdr;Ilhan ALEXANDRE;đEuskal Herria | VP @agissonsmvnt | Ălu CAVL @acbordeaux | Membre CRJ @NvelleAquitaine | #FlorenceLasserre;439;342;76;4990;5847
Corto_74;Benoît HUMBERT;;519;245;62;5016;5842
zaidmhadjou;ZBM;Juriste de formation, en droit international public;2903;390;93;2456;5842
Ch_Vannier;Christian Vannier ðð;ð Fondateur @Forumeteoclimat : rendez-vous incontournable dâÃ©ducation & de mobilisation face aux enjeux climatiques â¡ï¸ Membre @PressClubFrance;1774;431;597;3039;5841
Fred_celtic;Fred_LD29;Mouvement Ultra / SB29 / MCFC / actualités / Celtic Ultras 2001;3595;284;287;1671;5837
expattxUsa;C;;4736;133;50;917;5836
YpomoniFR;Ypomoni Sud-Est;Patience;2692;124;193;2826;5835
G_Cordelier;Guillaume CORDELIER;#Digital, #Normandie, #Transfonum, #Agile, #Gestiondeprojet, #Marketingdigital, #Conduiteduchangement, #Management, #Basket;1474;366;463;3529;5832
emaho_asso;émaho;Accélérateur d’inclusion #numérique et d'innovation depuis 12 ans 🚀 !;1930;1027;674;2200;5831
DeInternaute;L’internaute de trop;"Compte sans ambition éditoriale.
C'est nul d'être médiocre.
PP volée à Ptiluc";463;385;23;4951;5822
MballaJoel;Zumokuta;Africains jusqu'au bout des ongles ð/Faut apprendre aux Africains qu'un Paradis Ã§a se construit ð¤·ð¿ââï¸ð¤·ð¿ââï¸ð¤·ð¿ââï¸, ð¨ð²/â¤Jesus;1268;203;40;4305;5816
Socialmag_news;Social mag;Social Mag est un média couvrant l'actualité #RSE et #ESS française et internationale. Parce que les bonnes idées se piochent partout.;1297;2470;2032;7;5806
apdeq;APDEQ;"Association des professionnels en développement économique du Québec.
Mission: Développer les compétences, valoriser la profession, favoriser le réseautage!";3163;819;1820;2;5804
So_amazzingg;S.BELY đ„;PressePlanet;430;111;168;5090;5799
NegJah;Mr.;facebook.com/PourUnMeilleurA… @PUMA75000 Président de l’#AssociationPUMA   100\100 #Franco initiateur de réflexion;4492;328;36;934;5790
DiDiiX_93;Dan-Dylan 🧢;"YouTuber and Gamer enthusiast.
Main Content : SAO (Sword Art Online), GTA, RDR, Bully and Watch Dogs |
YouTube Channel : DiDiiX_93";3290;193;36;2269;5788
JZannou;Jacob N. ZANNOU;"Global Health Specialist.
Panafricaniste.
la Richesse de l'occident est directement proportionelle aux vols, pillages,et crimes comis contre l'Afrique.";2836;806;334;1808;5784
Crusader_BZH92;Crusader92;;2306;1002;362;2114;5784
GuillaumeBen44;Guillaume Ben 🌻✌️🌊;co-animateur #EELV #Nantes - #NUPES laterrenosluttes.fr/;2148;698;733;2201;5780
pourquoi2703;VN;Mère, Humaniste, Éveillée, Chrétienne, Entrepreneure sociale, RP & banquière. Devise: La beauté est en toute chose et chaque Homme a une part du divin en lui.;2795;358;141;2483;5777
Thors2013;Arnaud;Mes filles;4180;685;22;888;5775
MineVerrzs;Bon;empathie et science;4268;927;243;337;5775
unwokecanada;Deux xième;;1212;38;41;4482;5773
DigitalRealtyFR;Digital Realty France;Interxion devient Digital Realty et fournit la plus grande plateforme de data centers au monde.;3257;459;987;1066;5769
zlutonium;zlutonium;;3771;269;44;1685;5769
actuprime;Actu Prime Infos;;5651;42;75;0;5768
cityramag;Cityramag;Magazine de référence concernant l' #actualité des #villes de demain : #SmartGrids, #SmartCity, #TransitionEnergétique, #objetsconnectés.;1075;2623;2059;10;5767
mathieugisele2;mathieu gisele;;1796;26;7;3934;5763
HuguesBeyler;Hugues Beyler;Directeur Agriculture et Filières à la Fédération du commerce et de la distribution (@FCDfrance);4470;296;793;185;5744
PierreJeanMaure;Pierre Jean Maurel;l'art est ma vie, je suis Pierre Jean Maurel.;5615;49;69;11;5744
melanievilboux;Melanie VILBOUX;Directrice des Professionnels et l’Agriculture #BPGO #banque #TeamAgriBPGO 👨‍🌾 #TeamProBPGO Ambassadrice secteur agriculture et Pro @bpgrandouest;1499;908;650;2687;5744
CaroitEleonore;Eleonore Caroit;Députée des Français établis en Amérique latine et Caraïbes - VP ComAEtrangères - Avocate droit international - Présidente GA 🇫🇷🇨🇱 Vice-présidente GA 🇫🇷🌎;801;378;3421;1144;5744
francdean2;IpseDixit;a stone in the middle of the sea;2345;180;12;3206;5743
pberat;Pierre Bérat;Engagé pour une droite ouverte, européenne, qui ne se désintéresse pas des Métropoles. Elu régional et municipal de Lyon jusqu'en 2020/2021.;3227;589;1476;446;5738
SylvainGodinot;Sylvain Godinot;Adjoint au maire de Lyon à la transition écologique et au patrimoine. militant écologiste. conseiller 1er arrondissement aux sports. conseiller métropolitain.;1336;404;1531;2465;5736
lydecweb;Lydec;Opérateur de services publics, Lydec gère la distribution d’eau et d’électricité, l’assainissement liquide et l’éclairage public du Grand Casablanca;3166;315;2088;162;5731
Chrstianb1;Christian Bellefleur;"Associé de recherche
Recherche universitaire biomédicale";3690;167;61;1810;5728
Sylverbell1961;Michel Cournoyer;;5512;90;101;25;5728
kante_taki;Taki KANTE (Farafina);"M. of Audit and Management control. Profoundly African. Citizen of the world. Passionnate about sciences, litterature, politics. 
I totally own my tweets ­čç▓­čç▒";1358;966;424;2979;5727
franckbaldwin;Stage4;Le vieux monde se meurt, le nouveau monde tarde à apparaître et dans ce clair-obscur surgissent les monstres;2481;58;8;3174;5721
FransylvaFrance;Fransylva;Compte officiel de la fédération nationale des forestiers privés . Représente & défend les propriétaires  #forêt #bois #environnement #économie #sylviculture;2027;367;2239;1087;5720
JacquesGIORDAN1;Jacques Giordano;L'énergie SOLAIRE est la ressource abondante,économique, inépuisable de la France et disponible aujourd'hui chez TOUS avec les technologies que nous maîtrisons.;2087;2642;587;401;5717
ClaudineClodell;Claudine Clodelle;Musique, spectacles, partage,  humour, dérision, émotions, photos, découvertes pour  VIVRE AUTREMENT VOS LOISIRS !;4905;99;327;384;5715
MayKuroBankai;MayKuroBankai;;4135;33;8;1532;5708
_bruno_marty_;Bruno Martyᅠᅠᅠᅠᅠᅠᅠᅠᅠᅠᅠᅠ;;4440;463;446;346;5695
daho_daso;Daho;;5565;1;11;113;5690
RadioHeisenberg;Heisenberg;"#Actualité #Normandie #Humeur #Environnement #Musique

Et plein d'autres sujets d'intérêts!";1224;159;15;4291;5689
audreyaronica;Audrey38;Bureau dĂ©partemental Renaissance 38đ«đ· RĂ©fĂ©rente EgalitĂ© Femmes-Hommes @olivierveran @servanehugues Patient Expert Asso AFVD/Handicap invisible;1360;817;337;3159;5673
DMorneau;DMorneau-Doublelight Productions International;Doublelight Productions (Videos-Communications-Web):DG-GM/Réalisateur-Director/ Sports-Méditation-Yoga-Vegan;4390;194;349;732;5665
IHEST;IHEST;Institut des Hautes Études pour la Science et la Technologie / Décider avec les sciences;2617;664;1391;990;5662
AssociationERQc;Production ERQuébec;Association québécoise de la production d'énergie renouvelable (AQPER);3753;598;988;322;5661
PhL57000;Philippe;Always Look on the Bright Side of Life;2064;126;27;3442;5659
romaintitus77;Romain Titus;Littérature;913;4217;525;2;5657
letoulois;le Toulois;« Sans la liberté de blâmer il n’est pas d’éloge flatteur »;3761;211;39;1644;5655
genest_paule;Paule Genest;Je suis une artiste visuel et une penseuse libre. J'aime la bouffe végétarienne mais je ne dénigre pas les fruits de mer et le poisson. Je cultive mon jardin.;1384;96;61;4111;5652
FrancoiseCardou;Françoise Cardou;Postdoc @UTSC, PhD @USherbrooke & @NRCan looking at #FunctionalTraits, #Communities, #UrbanEcology. Reader. Opinionated. Pretty curious about most things...;947;486;365;3852;5650
MgzJerome;Jérôme Mgz;Ce qui fait de moi une personne spéciale c'est moi , ma façon de penser;1973;240;105;3329;5647
BenoitFelicien;Felicien Benoit;Morigènons derechef tous les fauteurs de chienlit .;3399;418;113;1715;5645
AQC_FR;AQC;Association loi 1901, principale mission : prévenir les désordres dans le #bâtiment et améliorer la qualité de la #construction.;2267;447;1812;1118;5644
mazan72497981;mazan;;1625;92;32;3882;5631
pl_mllt;_;......;1729;8;5;3884;5626
MarieCras;Marie Martin ✈️;Consultante #SEO :) Je suis sur #toulouse et fan de ☀️ #lol;2108;1786;1569;161;5624
HaitiClimat;HaitiClimat;Première plateforme multimédia haïtienne spécialisée dans le traitement et la production de contenus sur l'environnement le climat et les énergies renouvelables;2503;210;1929;978;5620
FritzBenjamfg;Fritz Benjamin;;687;139;20;4773;5619
Mer_guez;Guez;La roue tourne va tourner.;2688;617;140;2174;5619
InstitutFMES;Institut FMES;"Think tank spécialisé sur les #enjeux de #sécurité et de #défense en #Méditerranée et au #Moyenorient - formations (SMHES, S2M, cybersécurité)

linkr.bio";2097;1724;1428;362;5611
enquetaction;Enquet'Action Haiti;Le média d’enquête indépendant, critique et alternatif ! Il traite d’enjeux de société négligés ou peu traités en profondeur dans les médias traditionnels.;2799;603;1558;650;5610
SassiXavier;Xavier Sassi;;1808;383;731;2685;5607
Ecolo_ToulouseM;Groupe élu·e·s écologistes de Toulouse & Métropole;"Groupe de 8 élu·e·s @EELV, @GenerationsMvt, sans étiquette.
👉présidé par @AntoineMAURICE à Toulouse
👉co-présidé par @izahardy & @karmann_thomas à la Métropole";1876;936;916;1869;5597
LaureMoreau78;Laure Moreau;"Citoyenne libre et vivante, parfois militante.
Sympathisante / adhérente 
RENAISSANCE Européenne / AGIR / HORIZONS";3375;331;414;1475;5595
bbel34;Boris Bellanger;Greffier principal. Adjoint au maire de Montpellier, délégué au patrimoine historique et au quartier Centre. Socialiste. Montpelliérain d'origine bretonne !;978;982;930;2702;5592
jjgumais;Gumais Jean-Jacques;Founder/CEO @kaiserKafe| Vice-President Communications @paindespoir|AviationMP @IATA;1177;841;135;3432;5585
LamineS52930050;Lamine Sy;;992;95;69;4426;5582
MOMOPINUP;Monique;retraitée fonction publique;3877;528;60;1115;5580
lavenirfaitpeur;Martin DeSantis 🏴‍☠️🇺🇲 🇦🇷;Go woke Go Broke.;3714;62;148;1652;5576
CThomassinPP;Clément Thomassin;Consultant Senior #CDI #CDD #interim chez @Page Personnel. Métiers #Supplychain #Achats #Transports #Logistique.  #Recrutement #Carrière #RH #Management #QVT;4369;711;336;158;5574
DigiLydia;Lydia Digironimo;"Proviseur adjoint LPO du Pays de Condé-Referente FOQUALE- perdir2021-#promosimonedebeauvoir
CPEFOREVER-Passionnée du triple effort (Nager, rouler, courir)";1768;375;553;2870;5566
KounandiSeka;Seka Kounandi;Toujours prêt pour le service;1440;504;218;3399;5561
edelabrousse25;Horizons Besançon;;816;1597;795;2352;5560
benoit_ribon;Benoit Ribon;"Ingénieur, éco-conseiller, docteur en aménagement du territoire 
#Data #MetabolismeTerritorial #énergie #ressources #Vélo #OSM, fondateur de @dynartio";1583;1113;1042;1819;5557
ULHYSSE;JP;"""L'être qui a juré de vivre libre ou mourir se joue de la colère des tyrans""...🇫🇷🇪🇺🇺🇸🇺🇦🇪🇪";1589;50;35;3883;5557
ZACOSTYLE;ππ πππππ πππππππ, πππ.;"One-stop destination for all  people looking for a bespoke shirt ||
We make yours  as ours.
wa.me/+25768344665.
No place for negative aura.";930;1068;1264;2292;5554
paris_segolene;Paris Ségolène;"Prof de SVT🔬clg REP,RUPN, formatrice EDD, ludif-addict et over-connectée.
Membre de la Team Ludens 🎮🎲🃏
Admin du gpe Facebook pédagogies actives en sciences.";1558;842;1266;1885;5551
hcharrondiere;Helene Charrondière;Consultante #Santé #eSanté #Pharmacie #Officine #IndustriePharmaceutique #Télémédecine #Pharma;3217;501;965;862;5545
Melenchon4Ever;φ FALLAIT VOTER CHONCHON φ #JLM2022;"Si vous vous definissez par:

Il,elle,he,she,they,lgbtq,feministe etc.. Soit 𝗔𝗨𝗧𝗥𝗘 qu'être 𝗛𝗨𝗠𝗔𝗜𝗡 𝗔𝗩𝗔𝗡𝗧 𝗧𝗢𝗨𝗧 ?

Dégagez de mon profil !";2681;198;188;2478;5545
marcgrosman75;MG75;Enseignant en Master Energie et Systèmes Embarqués, Pilote avions-drones, Liberté, Egalité, Fraternité, Vive la République , Centriste;4498;9;41;995;5543
TSystemsFrance;T-Systems France;"Toute notre actualité : infos, événements et nouveautés. #cloud #gaiaX #cloudsouverain
Leader européen de l'IT, partenaires de votre transformation #numérique";3518;187;1061;774;5540
FranceMontplai1;__MF__;;3260;224;38;2016;5538
thcalvat;thierry calvat;@jurissante Cofondateur @cercleVS #aidantsfamiliaux, #vulnérabilité, vulnérabiliste, hétérosexuel et hussard de cœur;2507;187;500;2342;5536
FizNico;NicoFiz;;461;119;16;4940;5536
JorysB3;Jorys Bovet;đïž đ«đ· DĂ©putĂ© de lâAllier Ă  @AssembleeNat âą Membre @AN_DevDur đ đ;1642;1017;1735;1138;5532
gaiaproject;Gaia Project | Projet Gaia;Empowering youth to take action on climate change! – Outiller les jeunes pour passer à l'action contre les changements climatiques!;2726;943;1013;849;5531
Menfall;Gwenaël 😎✈️;Breizh eo ma bro - Sciences et Affaires la semaine - Aviateur le week-end;4765;354;340;70;5529
GuiotNoel;Noël Guiot;Pragmatist / Radical Environmentalism;4323;617;187;401;5528
bessaiahmohamm1;bessaiah mohammed;;3077;31;2;2418;5528
GwilymCJones;Gwilym Jones;Ambassadeur de l’Union européenne en République Islamique de Mauritanie. All views my own. RT≠endorsement;2018;267;1149;2092;5526
PRIMAQUEBEC;PRIMA Québec;PRIMA Québec anime et soutient l’écosystème des matériaux avancés, un moteur d’innovation et de croissance pour le Québec.;2204;785;819;1712;5520
marjol67;Marianne Joly;Programmatrice radio;3291;1548;633;40;5512
Steph_Leon29;LEON Stéphanie;;4276;18;9;1208;5511
cgicquel;Camille Gicquel;Adjointe au maire #Argenteuil #urbanisme #amenagement • VP Terr #BoucleNorddeSeine #deveco • Entrepreneur • Mom • 🐎🚲🏍Rider • Beekeeper • Archer • 🇫🇷🇪🇺;1069;1666;355;2418;5508
sonergia;Sonergia;Spécialiste du financement de l'#EfficacitéEnergetique depuis 2009, #CEE #MaPrimeRenov #StopPrécaritéEnergétique #rénovation #TransitionEnergétique;2045;1883;1000;575;5503
tomalaprod;LilOctavioTVđ§Ș;21Yođ CandyGuyđč start pc at S15 (movement enjoyer since S16) apexlegendsstatus.com/profilâŠ #cfguserareloser;3222;202;54;2024;5502
CourtageSve;SVE COURTAGE NEW'S;Toute l'actu courtier, immo, banque, assurance ici;5391;53;17;33;5494
RouillonJeremy;Jeremy Rouillon;;908;31;11;4541;5491
Gallyan;Guillaume ð¬ð±;#climat #laravel;718;1410;178;3183;5489
vinc_robin;vincent robin;Paleoecologist - Historical Ecologist - Professor @labo_liec @Univ_Lorraine liec.univ-lorraine.fr/presen…;1532;1144;499;2312;5487
antonio_perucha;Antonio Perucha Checa;"On sait où l'on va si on sait d'où l'on vient. 
Militant CGT en Vendée. UGICT MÉTAUX.
Se sabe dónde vamos si sabemos de dónde venimos.";3153;1730;521;79;5483
toma5111;toma5111;;3705;96;11;1671;5483
mat42290;mathisp42;"S'unir sur l'essentiel plutÃ´t que se diviser sur le superficiel. 

L'avenir sera sobre ou il sera sombre
ðð";1082;505;50;3842;5479
e_henaut;Edouard Hénaut;"Directeur général France @transdevFR.
Chaque jour, nous permettons à des millions de passagers de se déplacer plus librement. #Mobilité";1155;1453;1515;1355;5478
RamyTabassi;Ram's;;2321;282;24;2845;5472
Anniecouni41;#Cath vériT;profile satirique dédié à l’incompétence(systémique),l’intolérance(latent)au racisme (légiférer)et à la stupidité (journalistique)Rude and cynic. not 4 everyone;5220;143;55;52;5470
TransitionActiv;TransitonActiv;"Faire connaître les #actions en faveur du #changement dans l'#environnement, le #social et l'#économie.
#emplois #formation #appel #projets #innovation #plans";4836;353;79;201;5469
MarieEveTrudel1;Marie-Ève Trudel;Journaliste | Radio-Canada Mauricie et Centre-du-Québec | marie-eve.trudel@radio-canada.ca;2683;1130;1607;41;5461
mediatextehaiti;Média Texte;actualités, nouvelles;240;609;4485;125;5459
TrotzkiZhuyizhe;ShroomLeninist特色社会主义;Marxist with the IMT - L'Étincelle/der Funke - fr/eng/de~/zh? - ☭☭☭;1277;51;161;3970;5459
eyePomme;eyePhone;La simplicité est la sophistication suprême / simplicity is the ultimate sophistication (Léonard de Vinci);5300;12;128;17;5457
ProjetKairos;Instant Kairos;Un vegan perdu sur Twitter;2382;90;108;2875;5455
Takoulakmou;TAKOU JUN;"AMBASSADOR OF NATURE, forest , Wildlife , climate , people . volunteer, leader . 
sociable
UNICEF";270;1662;250;3272;5454
GroupeURD;Groupe URD;Think-tank indépendant spécialisé dans l’analyse et l'amélioration des pratiques de l'aide internationale #humanitaire #revueHEM;1846;846;2339;422;5453
corail_blanchi;Corail 🇨🇳;🏆🏆;1696;924;1065;1765;5450
rodolphe_muller;Rodolphe MULLER;Fondateur de BiG SUCCESS et spécialiste de la communication #audiovisuelle sous toutes ses formes #BrandContent #CrowdSourcing #Startup #Innovation #Talents;2358;1827;1231;28;5444
martonola;Martonol;;4534;54;22;828;5438
etiennegingras;Etienne Gingras;;1965;143;64;3264;5436
FAOBenin;FAO au Benin;La Représentation de la FAO au Bénin. Toutes les informations sur la @FAO au Benin. Suivez notre Directeur général QU Dongyu @FAODG;2229;251;1487;1468;5435
oim_mali;OIM Mali;Compte officiel de l'Organisme des Nations Unies chargé des migrations au Mali.;1132;192;3421;689;5434
Marocv_Economie;Marocv.com Economie;L'actualité économique au Maroc.;5399;4;23;1;5427
HElyason;Haik Elyason;"Technologue
Penseur libre
Perfect pitch
Le manichéisme et la grégarité m'insupportent
Français, Européen mais pas Européiste
H blanc hetero cis genre: hate me!";3305;537;368;1215;5425
ardoresmanent;GB;đ¶đđ«đ·đȘđŠđșđŠ Citoyen Ă©câąoâąlectique. Allergique Ă  tout fanatisme. Croit encore au bon sens populaire. piaille.fr/@GB & piaille.fr/ardoresmanent;1202;265;24;3932;5423
RenanViguie;Renan Viguié;#histoire #géographie / Comité d'histoire de l'énergie / #thèse Chauffage en France XXe (CEMMC);2595;968;873;983;5419
MercedesF1Actu;MercedesF1.ActuFrance;L’actualité Mercedes-AMG F1 en Français 🇫🇷 🗓️ Round 8/22 : Canada 🇨🇦 16-18 Juin 2023. 🏆 8x WCC - 9x WDC;2399;236;908;1863;5406
sogoodradio;So good;Pour un monde meilleur (ou moins pire).;1033;319;3262;791;5405
RIOCM;RIOCM;Le Regroupement intersectoriel des organismes communautaires de Montréal réunit 350 organismes communautaires en santé et services sociaux et autres secteurs.;1773;1056;2029;547;5405
LucileRqf;Lucile de Roquefeuil;"KAM @Visibrain #comdecrise #reputationmanagement
#Environnement #Climat #Ecologie";2111;1703;364;1226;5404
MDerieker;martin derieker;;505;124;40;4733;5402
KonradLiberty;Konrad Liberty;;3981;105;21;1293;5400
GiancarloCecco;Giancarlo Cecco;Trader, Analyste, Forex, Bourse, #BitcoinđđFondateur Forex.Quebec;2467;74;1633;1223;5397
SamiraDIRAT;DIRAT Samira;;1189;532;112;3564;5397
347pictures;Ajoutez un nom;;1372;447;129;3446;5394
solsolidaires;Solutions Solidaires;La plateforme des solidarités nouvelles / Évènement annuel & plateforme pour impulser des idées et expérimentations qui répondent au défi social-écologique.;1474;349;724;2847;5394
blasfred030;BLAS;;2689;250;119;2330;5388
citoyenattere;Citoyen atterré;Aime le débat et la confrontation des idées #lafrancemaladedugauchisme;3496;607;74;1207;5384
GromierHeim;Laurence Gromier-Heimð¨ðµðªðºðºð¦;"ConseillÃ¨re des FranÃ§ais de lÂ´Etranger 
PrÃ©sidente du Conseil consulaire-BW-BaviÃ¨re";1626;491;252;3010;5379
OptimEast_Paris;Thomas Annonier;"À l'Est, bien du nouveau !
Militant professionnel de l'Est parisien 
#Économie #Numérique #Culture #Urbanisme #Communication #SSD93... 
Compte présentable";2520;1899;781;179;5379
AudericMaret;MARET AUDERIC;Enseignant-chercheur. Docteur de l’EHESS histoire urbaine. Île-de-France. Art, patrimoine et histoire. #Aubervilliers;1056;1313;506;2500;5375
LacasseNicRDS;Nicolas Lacasse;Rédacteur Web/Télé à @rdsca;126;186;76;4976;5364
MorEric2;Moré Eric;;3126;151;57;2028;5362
Gcqqu;Silvertothemoonð«ð· ðªð;achat gold silver recommande goldavenue.com/fr/r/a527f600â¦;3487;116;41;1713;5357
11emeArt;11ème Art;"L'art a ses raisons que le foot n'ignore pas. 

@ValentinAznar @Alexandremsd @QuitteJules @Floliska @TomAbadie98 @BillalMasmoudi @levraimothas @DuclosZacharie";1964;1018;1733;626;5341
InstitutEDS;Institut EDS;L'Institut en environnement, développement et société de l'Université Laval : le carrefour des connaissances pour un développement durable;3355;274;818;893;5340
JAjo35120;jacques araujo;je sais lire et j'aime comprendre alors : NO PASARAN - Résistance;4873;24;29;414;5340
YouthSid;Youth Initiative for Sustainable and Inclusive Dev;Promouvoir le bien - être social, l'égalité des sexes, la justice, le leadership, l'éducation et la santé des jeunes, des femmes et des personnes handicapées.;165;181;387;4601;5334
Christi33402074;Christian ROY;;3565;16;5;1742;5328
PressPepper;PressPepper;Agence de presse spécialisée dans l'actualité judiciaire régionale. Ce compte reprend les dépêches publiées chez les clients. Alimenté par @guillaumefrouin;2446;1161;1411;309;5327
DclicToulouse;Dclic;Compte animé par les documentalistes du réseau Dclic;5143;131;46;0;5320
Majid_Haitami;Trusted news;Protect yourself and your families;4618;205;115;381;5319
BelAnneClaire1;Anne-Claire BEL;Vice Présidente déléguée à la transition écologique pour la CRESS PACA/ Directrice régionale PACA Compagnons Bâtisseurs Provence;1045;1887;623;1757;5312
chris98417729;Kris ☀️⚡️🔋 🌎🌳♻️;Pourfendeur d’extrémistes à gauche et à droite ! FossilFuelsFighter 💪 ne raffole pas du ☢️ mais à défaut de mieux le trouve indispensable ! #ecomoderniste;2399;142;63;2707;5311
Chrono_env;Chrono-environnement;Chrono-environnement est une unité mixte de recherche sous la tutelle du @CNRS et de l'@Univ_BFC. #Interactions #humains #environnement;2077;319;871;2038;5305
ENSG_IGN;ENSG_IGN;Grande école #ingénieurs en #géomatique de l'@IGNFrance habilitée CTI  #numérique #BigData #informatique #3D #GPS #SIG #cartographie #télédétection #recherche;1619;551;1740;1384;5294
lcibiarque;JALcibiarqueğºğ¦;MaÃ®tres chez nous| leftist â¢ social democrat| FranÃ§ais/English| Like Ancient Greece, but not like that.;1693;204;62;3331;5290
algorium_;Algorium;le terminator T1000;3047;450;138;1651;5286
_4g0r4_;Restless;"If everyone abandoned “legal tender” for gold and goods in contracts and other exchanges, it is doubtful that even taxation could sustain the modern State.
SEK3";2509;206;77;2493;5285
AmbCanGuatemala;Canada au Guatemala;Ambassade du Canada au Guatemala | English: @CanEmbGuatemala | Español: @EmbCanGuatemala;3859;259;850;314;5282
ManofOfficiel;Grain de Blé;Prospective politique et anticipative de la défense;2270;121;93;2792;5276
PrinceA82360133;Gruikui;;2006;133;38;3097;5274
AmbMarocBeLux;Le Maroc en Belgique et au Luxembourg;ð²ð¦ Compte Officiel de l'Ambassade du Royaume du Maroc en Belgique et au Luxembourg;1460;249;3049;508;5266
AurelienSOUSTRE;Aurélien SOUSTRE;Maître de conférences associé @iaelyon @UJML, cadre de banque, membre du Comité consultatif du secteur financier #CCSF, admin. @MalakoffHumanis @FONDSDEGARANTIE;718;1658;335;2544;5255
JCE_Paris;JCI Paris;Jeune Chambre Economique de @Paris. Créer des changements positifs pour tous en progressant individuellement. #TeamParEFI #sEngager #SeFormer #Impacter;1761;616;1624;1251;5252
marco_il_biondo;Marco il Biondo;"Géopoète.
Le savoir c'est de connaître l'étendue de son ignorance

Jin – Jiyan – Azadi";4209;469;45;526;5249
Fra_Raynaud;Françoise Raynaud;#innovation # entrepreneur Ex DG Adjointe #LRSY et VP Agglo Présidente #Oryon mandataire #MedefPdL #Conseil Académique de l’Éducation Nationale #vendee;3313;549;667;720;5249
dw_nicholas;Nicolas B. ✌️🔺;Au commencement était le verbe.;3308;136;26;1778;5248
BelisleFrance;France Bélisle;Mairesse de Gatineau;1545;488;2054;1154;5241
oligarch452;The Spirited;;2002;150;35;3054;5241
ANABF5;Association nationale des ABF;L’association nationale des architectes des bâtiments de France (ANABF) a pour objet de promouvoir la qualité architecturale, urbaine et paysagère.;3109;150;1881;97;5237
Swkswkswkswkswk;Swkswkswk;Free-rider;2298;154;619;2165;5236
RomainCarballo;Romain Carballo;;1148;346;237;3504;5235
Gilles_LAWSON;Gilles LAWSON;Blogueur à @RFI | Ambassadeur à @ESCEN_school | Cofondateur de @OperonGroup |;1363;2202;675;990;5230
MGuindonRC;Martin Guindon;Journaliste radio/web pour @IciAbitibi de Radio-Canada à Amos.;2513;1560;534;613;5220
PhilippeBouba;Philippe BOUBA;Professeur de Lettres-Histoire ð¤â¤ï¸ 5Ã¨me vice-prÃ©sident @ctdeguyane ð©âð«ð¨âðð©âð¬ Enseignement supÃ©rieur et Recherche;1593;1386;1453;786;5218
QtvAltrntv;Quantitative Alternatives;đ Ătudiant passionnĂ© de bourse et dâanalyse đ je partage mes acquis et mon savoir đ§ mfinanceassetliabilities@gmail.com pour projets ou collaborations pro đ€;2499;161;1104;1450;5214
JeanLemire;Jean Lemire;Émissaire aux changements climatiques et aux enjeux nordiques et arctiques;482;2043;2044;642;5211
Gittes_Jake_;Gittes Jake;Vieux mâle blanc européiste et macronard. Parisien, en plus.;2993;191;44;1982;5210
AS24_Stations;AS 24;The official Twitter account of AS 24, the international network of stations and services (including tolls), dedicated to road transport professionals.;1893;897;1957;459;5206
AFNUM_FRANCE;AFNUM;"L'Alliance Française des industries du Numérique regroupe 60 entreprises industrielles qui forment le socle numérique.
Ensemble, donnons du sens au numérique !";2105;430;766;1905;5206
AuFilDesMaths;Au fil des maths;Au fil des maths - Le bulletin de l'#APMEP (apmep.fr). Revue papier trimestrielle et revue numérique augmentée.;936;285;3320;642;5183
SimardK;Karl Simard;;2426;175;85;2497;5183
agora_france;Publications Agora;Pour les investisseurs débutants ou aguerris, nous mettons notre réseau d'experts au service de votre indépendance financière #Finance #Trading #Epargne;2325;775;1947;135;5182
franziska_mnhrz;franziska meinherz;Postdoc on post-pandemic urban mobilities @TUM_STS | anticapitaliste écoféministe & queer @solidariteSvaud & @greveduclimat | #CCLausanne avec Ensemble à Gauche;1727;645;699;2109;5180
Yvinho4;Yvinho;;3132;26;19;2002;5179
HadrienBuclin;Hadrien Buclin;"député au Grand Conseil vaudois pour Ensemble à gauche - solidaritéS, membre Syndicat des services publics, ASLOCA, coopérative Jardin Potager ; historien";862;117;762;3438;5179
LeontiCap;Leonti;ð§  Apprends Ã  investir dans les sociÃ©tÃ©s non cotÃ©es Ã  partir de 100 â¬ ð¡ IngÃ©nieur ð¦ Financement de l'innovation (17 Mâ¬ investis);2100;205;534;2337;5176
Caroline26181;Caroline;Sports natation ski;375;299;21;4474;5169
PP_Rayne_;PéPèRe;Chasseur de faiseurs de mauvaise foi;1740;488;51;2889;5168
zorgman1929;Zorg Man;"""QUAND LA VERITE N'EST PAS LIBRE, LA LIBERTÉ N'EST PAS VRAIE."" JACQUES PREVERT - « Ils ne sont pas corrompus, ils sont la corruption. » Juan Branco";1687;167;26;3288;5168
CHAMPAFRED;Champavier;;2383;62;41;2679;5165
PittxreGiorgio;๐๐ข๐จ๐ซ๐ ๐ข๐จ;โ โ โ  โ  โ  โ โ ๐๐จ๐ฆ๐๐ญ๐ข๐ฆ๐๐ฌ ๐ก๐จ๐ฆ๐ ๐ข๐ฌ ๐ ๐ฉ๐๐ซ๐ฌ๐จ๐ง;3842;127;128;1066;5163
chateau_gontier;Château-Gontier;Bienvenue sur le compte officiel de la Ville et du Pays de #ChâteauGontier. Suivez l'actualité en tweets et sur facebook.com/chateaugontier | #CollTerr;2230;315;1703;914;5162
DarisKata;Daris mwana ndjibu;;594;52;59;4456;5161
arthur_skr;skr_113;;2169;50;8;2928;5155
fabricehermel;Fabrice Hermel;Directeur de la communication @banquedefrance;293;845;524;3489;5151
VanessaGuider;vanessa guider;EX #RRH et DAF reconvertie au service de l’#emploi conseillère Boucau #CEP #formation #recrutement #numérique #digital #i4emploi Mes tweets n'engagent que moi;1002;808;522;2818;5150
22hMax;22H MAX;Retrouvez du Lundi au Jeudi de 22h à 00h, 22h Max présenté par @MaximeSwitek;3975;0;1174;0;5149
FACE_06;FACE 06;Fédération des Associations et Corporations Étudiantes des Alpes-Maritimes • 1ère orga de jeunesse du 06 ☀️;2035;356;2156;601;5148
Smraihi;Saida Mraihi;"Doctorante sciences de l'éducation - CREAD
Ingénierie pédagogique -  Arts & Métiers 
Interaction enseignant-étudiant, pédagogie universitaire";2811;898;1002;436;5147
C3RD4;C3RD;Centre de Recherche sur les Relations entre les Risques et le Droit créé en 2006 au sein de la @fld_lille_issy de @UnivCatholille @FacultesUCLille;2496;894;515;1238;5143
SiamoLy;SiamoLy;;1146;91;48;3856;5141
ChineAmbMaroc;Ambassade de Chine au Maroc;"Compte officiel de l'Ambassade de la République populaire de Chine au Royaume du Maroc.
Site: bit.ly/3qShTou
Facebook: bit.ly/3Cu05Cq";677;302;3252;908;5139
WeAreOverade;Overade;Because we didn't want you to choose between freedom & security  we've created PLIXI FIT, first bicycle foldable helmet. It protects you and then disappears.;1940;1959;841;395;5135
FDE_Lyon;Forum de l'Entrepreneuriat;"(Jeunes / futurs) #entrepreneurs, RDV sur nos salons #FDE pour concrétiser vos projets d'#entrepreneuriat

Prochaine date : 1er juin à Saint-Etienne";2314;384;1177;1259;5134
donatien_gomis;Donatien Gomis ð¸ð³â¨;La VÃ©ritÃ© commence Ã  nous Ã©chapper Ã  la seconde mÃªme oÃ¹ notre regard relÃ¢che sa tension, elle nous Ã©chappe en nous laissant lâillusion que nous la suivions.;2692;520;486;1436;5134
RJ_SCF;RJ-SCF;Réseau des Jeunes Chimistes - SCF (RJ-SCF) @reseauSCF - French Young Chemists' Network, member of #EYCN @YoungChemists and @IYCN;2250;420;1524;934;5128
analyst_anime;Analyst Anime;;4472;135;30;488;5125
obourdais;cherry picker;;4966;38;31;87;5122
Lingnieur2;The greate library- La grande bibliothèque;"We have launched this library📚 and hope to play an active role in contributing to the expansion of readership around the world 📕
#Freebooks
#learnEnglish";1754;800;1059;1506;5119
Blancdespagne;chagros;;4992;72;30;22;5116
AGRTQ;AGRTQ;L'Asso. des Groupes de ressources techniques (GRT) est un réseau d'entreprises d'économie sociale qui promeut et développe le logement communautaire au Québec;2190;585;942;1398;5115
saleh_dinguia;Saleh Dinguia;économie et énergie…;2199;344;922;1649;5114
pellerin_is;Isabelle Pellerin;VP de @metropolerennes #ESR #innovation VP @RegionBretagne déléguée aux #lycées et vie lycéenne;1779;149;1301;1870;5099
PhilippaRowland;Philippa Rowland;Chair, Religions for Peace Australia, Pres. Multifaith SA. Committed to nature, sustainability, climate justice & community-led solutions. All comments my own.;3504;428;376;787;5095
pdfkasale;Jérémie Kasale;"Leadership dans le sang,
Chercheur en EASI(Enseignant,Administrateur et Infirmier.)
Motivateur, doué de la politique.";1034;998;563;2500;5095
AbdouKarimNDAO3;Abdou Karim NDAO;Abdou Karim Ndao;1159;245;140;3549;5093
Palmafrique;Palmafrique;L’actualité du palmier à huile et de l’huile de palme en Côte d’Ivoire et dans le monde. Retrouvez également toute l’actualité de la société Palmafrique.;2924;553;1537;77;5091
DehorsLeZarabes;DehorsLesZarabes;;188;47;18;4837;5090
Pascalaubistro1;Pascal au bistrot;bobo écolo gauchiasse qui roule en vélo et grille les feux rouges, fan de Pascal Obispo;2694;71;16;2301;5082
FontenayDemain;๐๐ข๐ก๐ง๐๐ก๐๐ฌ ๐๐๐ ๐๐๐ก;"Liste Plurielle Municipale 2020 Fontenay-aux-roses avec @laurent_vastel

fontenayauxrosesdemain@gmail.com
#FontenayAuxRoses #fontenay92";1772;1278;373;1654;5077
SalledejeuG;Vivre_sans_trop_subir;"La famille. Douce France. La cuisine française.
La mer, la montagne, la vie. 
Citoyen lambda à la recherche du bon sens et  des vérités.";1960;73;54;2990;5077
EcoConscienceTV;EcoConscience TV;"Première Web TV thématique écologique au Togo. Media social pour des citoyens éco-responsables.
Nos 3 piliers : Eco-journalisme | Environnement | Genre";2234;463;600;1779;5076
FrancisRiether;Francis Riether;Directeur Developpement Territorial  EDF Commerce Sud-Ouest #energie #transitionenergetique #DD #numerique #innovation #NouvelleAquitaine #BxMetro #gironde;2271;261;616;1927;5075
ThomasD79638521;Thomas.Econest;passionné de construction écologique, d'écologie et d'architecture d'intérieur. Déterminé à faire une différence ! 💪 💡🌿;181;135;95;4661;5072
fred7115;fred7115;moi;1869;78;18;3103;5068
classerichelieu;classerichelieu;Easy;3785;50;24;1207;5066
MahuziesP;Mahuziès Philippe;CPD culture scientifique et EDD DSDEN34 / Vice Président OCCE 34;448;257;196;4164;5065
jmpe_france;Je m'engage pour l'école !;Je m’engage pour l’école ! #JMPE est une association : enseignants, chefs d’établissements, parents d’élèves, étudiants, tous citoyens. Twitter depuis mai 2020;1157;1289;1594;1022;5062
CathBoundjia;Catherine Boundjia;Consultante en stratégie & innovation • Citoyenne engagée, dév économique, justice sociale, Militante 🇨🇦⚜️, Prés. de la Commission politique du #liberalquebec;898;482;554;3126;5060
jplpsb19;JPLPSB19;;5048;1;5;0;5054
majidhamdani7;Hamdani;"Juriste 
#FreePalestine 🇵🇸 
@realmadrid @cristiano #obito_uchiha";1596;443;240;2773;5052
hanson_dany;Dany Hanson;Je suis tout, sauf un suiveur. Pour moi, être est mieux que paraître, alors Je suis pour Celui qui EST. La vérité c'est ce qui me défini. l'hypocrisie, je hais.;1152;208;39;3652;5051
Lt_Charette;Lt Charette;"Deus Ex Machina du christianisme.
Génétique intacte.";2655;290;77;2022;5044
JeanneRobin_Qc;Jeanne Robin;Directrice principale de @Vivreenville, cofondatrice et présidente de @pietonsquebec;1052;659;2016;1308;5035
SFP_officiel;SFP;Société Française de Physique / French Physical Society;1461;496;2501;572;5030
AnneGerin38;Anne Gérin;VP déléguée Sécurité Département #Isère Pdte #SDIS38 Canton #Voiron 1ère adjointe culture animations démocratie RH #Voreppe #Partiradical;1444;320;552;2713;5029
youssoufTra1;youssouf Tra;Je suis très direct,honnête et fidèle à mes engagements.;1594;124;74;3236;5028
thinkaboutFR;Simple French Man (SFM) juste me;;1531;108;10;3376;5025
derrickj6669;π π’πππ ππ πππ π π ππππ π’π¨π;;2257;502;112;2153;5024
Uside_Conseil;Uside;1er cabinet de conseil spécialiste des mutations culturelles et des comportements en entreprise;2395;1054;1384;190;5023
GournetXavier;n;;4466;46;25;478;5015
DavidVo74820499;David Vogel;Will never comply with all the absurdities thrown at us by abusive governments. No face underwear, no jab, no ausweis of shame,no physical distancing;2631;51;152;2180;5014
Neil55635437;Neil đ;observe, learn, reflect, apply, adapt;2939;249;74;1749;5011
Aigoul_Paris;Aì🌹Paris;Сделаем Всё Невозможное для Победы Украины! 🍀Добро всегда побеждает! 🇫🇷🇰🇿🇨🇳🇹🇷… 🌏;1012;441;64;3494;5011
en_psy;Psy EN ð§ SociÃ©tÃ©;"Comment (se) pe(a)nse la sociÃ©tÃ© ?
#interpsysocial Organisation de l'Ã©cole.
L'#orientation : espace pour rÃ©flÃ©chir Ã  l'organisation de la citÃ©.
#PsyEN";3107;576;280;1044;5007
coucoucestmoe;Coucou c moé;« J’ai des connaissances en chimie que t’as pas. Frappe-moi, je t’empoisonne »;2602;25;30;2344;5001
clugery;CLUGERY Arnaud erb;Directeur opérationnel à Eau et Rivières de Bretagne, mes tweets n'engagent  que moi.;906;226;543;3324;4999
SamuelGuingand;LegionWar;Saint HIMARS (high mobility anti-russian système);1920;176;35;2866;4997
MonsieurBeignet;Neurotic Tupperware;"Live fast, love dogs.
Co-Host @TRMNTRRDSHW";4042;117;21;809;4989
Tlataste;Zat;Développeur front-end.;4241;110;92;542;4985
cyrillemagnetto;Cyrille Magnetto;✦ VP Innovation - Chief Metaverse Officer @AXAFrance ✦ Product Strategist - Futurist - Facilitator ✦ Teacher & Mentor @ISCOM;1613;1763;835;769;4980
kaayxol;Kaayxol;kaayxol.com;4906;33;3;32;4974
SUAPSPoitiers;SUAPS UnivPoitiers;Service Universitaire des Activités Physiques et Sportives #sport#suaps#universitépoitiers#étudiant#viecampus#cvec#shn#stapspoitiers #cliquetonsport;2525;584;1052;813;4974
gatsia1;gatsia;Vivre avec conviction;3084;60;27;1800;4971
mouky1981;Moumou ben moumou;;1392;395;29;3144;4960
ThibaultHanin;Thibault Hanin;;2838;98;621;1403;4960
mamanufacture;AdB;Quand histoire & géographie se mêlent à d'autres.;4749;16;30;163;4958
CouillesDacier;Roger Vibranium;On me dit souvent que je suis dur.;1087;146;25;3695;4953
jcourduries;Jérôme Courduriès;Anthropologue, enseignant-chercheur à l’Université Toulouse Jean Jaurès.;1196;643;412;2700;4951
LeouPoldine;Léou, Poldine ?;Pour qu'on écoute les sciences et les nuances, en quête des youpis cachés sur le chemin aride et bariolé du plus grand défi de l'humanité;1727;256;33;2932;4948
ImpactHubBKO;Impact Hub Bamako;Co-working - Incubateur - Impact. Impact Hub Bamako est le 1er Impact Hub [@ImpactHub] en Afrique Francophone.  #impinv #socent #Bamako #Mali;1543;332;2111;961;4947
LandtsheerMarc;De Landtsheer Marc;Face a l'évidence scientifique il est important de vous informer et d'agir au quotidien à la mesure de vos moyens pour limiter les dégâts sur le vivant.;3801;160;98;879;4938
HateObject;Object of Hate;Social media sucks, so here I am for you to hate me;1725;243;55;2915;4938
NPicchiottino;Nicolas Picchiottino;Directeur de @AFD_France en #Martinique #MondeEnCommun;554;592;682;3103;4931
odst943;aogya2ods902;;167;94;10;4655;4926
shp13;Steph;;1156;236;29;3505;4926
pacco_ba;PaccoBa;Petit je voulais résoudre des problèmes, du coup je suis ingé en prospective énergétique| Formé à @AvenirClim ❤️ | Fais des graphs pour expliquer les enjeux ENJ;1001;789;247;2877;4914
ghernand706;Gilles Hernandez;;4900;4;3;4;4911
VGLinfos;Voix des Grands Lacs/Info en temps réel;"la voix des grands lacs se veut un médias d'informations générale
 voixdesgrandslacs@gmail.com";1387;540;600;2383;4910
leparisien2024;Le Parisien | JO ð¥;Le compte pour suivre l'actualitÃ© des Jeux olympiques avec @le_Parisien #Paris2024 â½ï¸ðð¥ðï¸ââï¸ðð¤¸ââï¸â¹ð½ââï¸ð¤ºð¤¾ð¼ââï¸ð¥;2185;19;2702;2;4908
CegepJonquiere;Cégep de Jonquiere;Le Cégep de Jonquière regroupe le plus grand nombre d’élèves au Saguenay–Lac-Saint-Jean, ce qui en fait un cégep populaire et dynamique.;1304;1023;2543;36;4906
FeydelSandrine;Sandrine Feydel;Journaliste Pôle Planète @france3tv @france2tv @francetvinfo «Climat : les pétroliers savaient » Nature, nouvel eldorado de la finance » « Océans de plastique »;2544;938;1252;171;4905
mitagor;Michel Gorin;Bibliothécaires et Bibliothèques : enjeux/éthique/rôle social/3e lieu/associations… mais surtout nature/Alpes/Jura/culture/gastronomie/thé/politique/français…;2428;360;322;1794;4904
UfipEM;Ufip Énergies et Mobilités;UfipEM est une organisation professionnelle de fournisseurs multi-#énergies. Notre mission: accompagner nos membres & accompagner la #transition. #Mobilités;3440;194;1021;248;4903
Jibay78;Jibay Studio ð¬;"VidÃ©o / Motion / Graphiste digital / illustrateur / Minimaliste
Monteur pour @pierregiannone / @numadeo_
CrÃ©ateur de miniatures Youtube";1395;213;79;3209;4896
VincentFASSIO1;Vincent FASSIO;AÉSIO Mutuelle;182;202;291;4219;4894
BureauIBCR;International Bureau for Children's​ Rights;ONG œuvrant pour la promotion et la protection des droits de l'enfant dans le monde | NGO working for the promotion & protection of children's rights worldwide;1864;937;843;1249;4893
COSUSAid;COSUS Aid/Urgences_Réhabilitation_Développement;COSUS Aid/Coordination d'Organisations Secours d'Urgences et Aide au Dévelopmt.  #Urgence_Réhabilitation_Dvpmt. FOCUS: #ODD #Femme_Jeune. cosusaidrdc@gmail.com;1109;1393;393;1996;4891
PhilDurFr;PhilDur đȘđș đ«đ·;PassionnĂ© par le chemin de fer et les moyens de transports. Humaniste et Europhile. Le poing et la rose en souvenir d'une gauche rĂ©publicaine. Ni RN, ni NUPES.;3002;90;60;1737;4889
cyrilvermeulen;Cyril Vermeulen;Entrepreneur, Angel Investor. @TheGalionP @50Partners;1859;383;462;2182;4886
GloireMaranatha;Maranatha Gloire;Seigneur Jésus-Christ;2089;67;18;2712;4886
AugustinCps;Augustin Campos;Freelance journalist and photographer - Environment, extractivism and migrations. Worked with @lemondefr @libe @ledevoir @jeune_afrique @bastamag @lecourrier;1705;1525;353;1298;4881
BSR_Associes;BSR & Associés;Cabinet d'expertise comptable à CHATEAUROUX dans l'INDRE.;2882;1416;504;73;4875
MoneIgnace;Mone Ignace Mohamed;￼     @UN /   .@antonioguterres;3079;587;29;1172;4867
AntounQuentin;Antoine Quentin;Délégué général @Ilec_asso Intérêt pour l’#UnionEuropéenne #innovation #nudge les découvertes et la #fantasy;1259;433;592;2583;4867
Senvieassoc;Senvie Association ๐ธ๐ณโค๏ธ๐;Ici, les jeunes font leur part ! Et toi ? Loy xaar ? Rejoins-nous et fais ta part pour ta communautรฉ. Notre boutique solidaire @BoutiqueSenvie ๐ฏ;1477;179;1306;1904;4866
fabricevalda;Fabrice Valda;"Inactif/12 ans, Réveillé, Révolté à présent !
Déteste la propagande, le mensonge, l'injustice, la corruption. Ensemble on sera plus fort ! Aime la🍒sur le 🥧";2155;436;82;2189;4862
TanShanLiMTL;Tan Shan Li;李丹珊 / Conseillère d'arrondissement de @projetmontreal dans le @SO_MTL – District de Saint-Henri-Est – Petite-Bourgogne – Pointe-Saint-Charles – Griffintown;120;269;61;4411;4861
FRTP_AuRA;FRTP Auvergne-Rhône-Alpes;🔎 La Fédération Régionale des Travaux Publics Auvergne Rhône-Alpes représente et défend les intérêts des entreprises de TP présentes sur son territoire.;1773;595;1273;1218;4859
FairPlay4Planet;Fair Play For Planet;♻️ ➡️ Le label éco-responsable pour les clubs, les sites et les évènements sportifs. #FPFP #FairPlayForPlanet;1677;733;960;1485;4855
Madinina67;Madinina;Passionnée de la vie // SIG forever🏀⚪️🔴// Colossiens 3:14;987;89;33;3745;4854
VSoille;NoireCleo;;630;224;15;3983;4852
MbiawaYannick;Mbiawa yannick franck;Celui qui est ignorant dort en paix. Mais à quel prix dira-t-on?;3997;139;62;652;4850
AmbCanCRHNNI;Canada au Costa Rica, Honduras et Nicaragua;Ambassade du Canada au Costa Rica, Honduras et Nicaragua l English: @CanEmbCRHNNI l Español: @EmbCanCRHNNI;3127;314;832;570;4843
JR253970;NENNI LECOMTOIS;;4467;59;7;309;4842
JeanmiPeugeot;Caporal Peugeot;;2928;191;123;1597;4839
dexma_FR;Spacewell Energy (Dexma) France;SGE en nuage pour une #ProductivitéÉnergétique basée sur les données, une #GestionDeLÉnergie claire et des économies vérifiées pour ESCOs, OEMs et Utilities.;3609;536;288;397;4830
marianneGINESTA;Marianne GINESTA;Responsable des RH et de la communication institutionnelle.;1268;462;122;2975;4827
philippemlau;Philipp Lausberg;Policy Analyst @epc_eu, focus on EU political economy. Interested in all things EU & East Europe. @Mariecurie_alum, former @REESOxford, co-fndr @directukraine;124;3192;1228;282;4826
olvrsBDC;Arnaud;;3437;626;93;669;4825
Bailla64;Bailla;;3989;138;45;644;4816
guichard_fred;Frederic guichard;Mes tweets n’engagent que moi. @EnCommun_parti, #TransitionÉcologique #industrie #Innovation;980;301;179;3350;4810
GavaldaPatrice;Geronimo;"Radicalement contre la misère et l'exploitation ! 
Ancien ouvrier du Livre. - D'inspiration marxiste.
GeronimoTW sur Mediapart.fr";1834;666;851;1456;4807
ImmobyCAAP;L'Immobilier by CAAP;Toute l'expertise #immo du 1er financeur de l'Habitat en #Alpes #Provence;3894;206;280;427;4807
frovandooren;frank Van Dooren;Une vie de chien:-);3176;95;45;1491;4807
EricKrezel;krezel Eric;Maire de Ceffonds (52) Vice-Président des maires ruraux de France, Président Haute-Marne, VP « innovation rurale » agglo saint-Dizier Der et Blaise;1519;345;388;2550;4802
CiteSolidarite;Cité de la Solidarité Internationale;Plateforme transfrontalière de la #solidarité internationale à l'échelle transfrontalière #France #Suisse #GrandGenève #Annemasse #SI;2333;700;1319;450;4802
cq_les_bails;c'est quoi les bails;;1091;127;9;3574;4801
TdeChassey;Thibaut de Chassey;Partner Elaïs Orium, a private equity group  specialized in European SMEs active in manufacturing, energy and healthcare. Also farmer and producer of hydropower;2852;801;227;919;4799
Ana_archi_;Ana;;372;1021;138;3266;4797
Spike2577;Spike;;2824;78;6;1882;4790
cirus_smith;Cirus Smith;;2685;14;15;2072;4786
invisiblelucie;No One;anonyme de gauche, féministe et artiste. le combo gagnant.;789;203;22;3768;4782
Mahaut_Herrmann;Mahaut Herrmann;Catho et écolo, écolo et catho. Autrice avec @Taigasangare de La vie oubliée (Première Partie) et de Comprendre et vivre l'écologie (Éditions de l'Emmanuel).;2554;408;1219;600;4781
DariaChernovaFR;Daria Chernova;Entrepreneure đź’Ą Cofounder @renowmeofficial & @madamnofficiel Coach #entrepreneuriat Ă  @ESCP_bs âś¨ Opinions are my own âśŹď¸Ź;2599;383;266;1529;4777
Teregacontact;Teréga;Compte officiel de Teréga. Retrouvez toute l'actualité de l'entreprise. Follow our company news.;1784;554;1513;926;4777
valiquette_alex;Alex Valiquette;Étudiant à l’UQÀM🪐 Éco-indépendantiste💚Amoureux de la culture💙 Responsable jeunes des @ouiquebec ⚜️;345;425;416;3586;4772
JeanClaudeRaux;Jean-Claude Raux;Député écologiste des ruralités actives | Commission @AN_AfCult | Délégation @AN_CollTerr | Ancien maire de Saffré | @Territoires44 #Circo4406 #NUPES;1288;372;2057;1055;4772
ECA_SROWA;ECA West Africa;@ECA_OFFICIAL Office for West Africa /Bureau Sous-Régional pour l’Afrique de l’Ouest;2452;208;1995;114;4769
LesRencontres42;Les Rencontres de Saint Marcel;Les Rencontres de Saint-Marcel est un collectif dédié aux relations ville-campagne, avec pour ancrage premier le département de la Loire (42).;2359;185;76;2147;4767
Bruguieres31150;Ville de Bruguières;"Compte officiel de la Ville de #Bruguières en #HauteGaronne, membre de #ToulouseMétropole
Suivez-nous aussi sur Facebook : facebook.com/Bruguieres";2415;620;725;996;4756
TMA_team;Thomas Marko & Associés;Conseil en stratégie de communication et relations publics (une agence de @venisegroup) // contact@tmarkoagency.com;2222;785;798;947;4752
RHFAO2017;Rab%;;2008;717;36;1986;4747
KhondeBenjamin;Benjamin Khonde;Chercheur en Droit et communicateur national du parti ENVOL;1045;620;363;2715;4743
Blackscience9;Black_science;;993;23;8;3718;4742
khouzeifi992;KHOUZEIFI ISSAKHA Doud-bane;Représentant Principal au Siège des Nations Unies à Genève / NGO ACIEDD #Chad Youth IGF /President #United Nations Youth Section of Chad / President;540;1549;1302;1347;4738
leadvent;Leadvent Group;Leadvent Group is one of the world's leading #business to business #event management company based in #Europe;1856;1784;328;766;4734
faucon75;I love ChatGpt;#paris #politique #tv #Bitcoin #economie #lovetwitter #chatgpt;3598;746;61;324;4729
andre_gaucher;André Gaucher;Aimant la vie, le progrès et le bel avenir de libération planétaire;3663;104;616;342;4725
dubquake;azdine;;859;436;53;3374;4722
AlphalexInform1;Alphalex-Information;;4701;3;15;0;4719
Stiankr;Stiankr_đ«đ·đ»đł;#airbrushartist;2556;222;105;1836;4719
DefenseJokes;Aurélien Morel;"Former independent writer.

Jean-Michel Géopolitique.
En conférence à la MJC Darry Cowl de Montargis au mois d'août.

Sponsorisé par les pifomètres Thalère.";2977;38;47;1656;4718
CaptainScarl3t;Paul Metcalfe;...des circonstances fortuites m'ont rendu invulnérable / ...fate has made me indestructible;3691;190;51;782;4714
Inolya;Inolya;#Inolya est le premier #bailleursocial du #Calvados. Nous partageons ici les informations institutionnelles à destination de la presse et des élus.;1779;447;1001;1480;4707
FarhaneAbdel;Lassissi Abdel Farhane;âđŸđ;2010;163;252;2274;4699
ORU_fr;ORU profil en fr;Compte officiel en français de l'Organisation des Régions Unies / représente et défend les intérêts des #regionalgov sur la scène mondiale / @ORUFOGAR @ORU_esp;3827;65;240;561;4693
EDF_Hydro_SO;EDF Hydro Sud-Ouest;Compte officiel d'#EDF #hydraulique dans le #SudOuest de la ð«ð· : 65 barrages et 82 centrales sur 9 dÃ©partements des PyrÃ©nÃ©es au sud du Massif central. â¡ï¸ð;1978;211;1469;1034;4692
pappa_court;pappa_court;papa sportif et vélotaffeur.;2782;46;30;1831;4689
SICTIAM_FR;SICTIAM;Opérateur Public de Services Numériques, Télécommunications, Energies - #servicepublic #numerique #CollTerr #thd #data #innovation #energies;1789;740;1226;919;4674
CCE_Francais;Commission de coopération environnementale;"Trois pays unissent leurs efforts pour protéger notre environnement commun. 
🇨🇦🇲🇽🇺🇸

In English: @CECweb
En español: @CCA_Espanol";1676;1313;600;1079;4668
Ahmedse13568800;A1849;"Le pouvoir:
La politique n'est pas l'art de parler mais l'art du savoir faire ? La guerre est inévitable.louis XIV 1675.vivre et mourir ?? Acratie, Acratisme";803;656;35;3173;4667
4aout;Agence 4août;4août est une agence de communication citoyenne. Agence labellisée en 2022 #RSE Agences actives ⭑⭑. #conseil #digital #création;1744;1064;903;956;4667
datrevtrev;.;;692;795;437;2743;4667
NiameyTimes;Niamey Times;Toute l'actualité sur le Niger en temps réel.;4212;3;334;118;4667
TraceSenegal;TRACE Senegal;Compte Officiel de Trace Sénégal | Les Meilleurs hits du #Sénégal, du #Mali & #Guinée. Branche-toi sur 104.3 FM Dakar & TRACE Téranga 🇸🇳🇲🇱🇬🇳 | Canal +131;2139;339;2007;174;4659
SobebraBJ;SOBEBRA;Bienvenue dans l'univers de la Société Béninoise de Brasseries, filiale du groupe BGI Castel au Bénin.;2050;37;1755;816;4658
Quelqu_un_2a;φ El Leòn;;1826;162;19;2648;4655
delantagnac;F. De Lantagnac;Celui qui veut le changement doit accepter son sacrifice.;1445;154;44;3008;4651
bob2m80;Lost in twittation;Parti de rien, j’étais arrivé nulle part. Tout y est luxe, calme et volupté... car inconnu de Tripadvisor.;2173;153;6;2316;4648
DurableSenegal;Sénégal Développement Durable;Professeur de droit public, concernée par le changement climatique, je cherche des solutions juridiques et pratiques pour promouvoir un développement durable;1034;222;509;2881;4646
ImpactTank;IMPACT TANK;Le think tank européen dédié à la valorisation & la mise à l’échelle d’innovations sociales. Une interface entre chercheurs & praticiens, initié par @GroupeSOS.;1269;872;1298;1206;4645
Vincent_CAAagri;Vincent BRETHOUX;Chargé Dvlpt & Expertise AGRI CAAquitaine @caaquitaine  Agir dans votre intérêt & celui de la Sté  #InstallationByCA @BdxSciencesAgro #TRANSITIONAGROECO;1856;637;352;1798;4643
Liontiger12345;Lionel sittler;;3937;259;36;406;4638
EurogroupFR;Eurogroup Consulting;"#LeadingPositiveTransformation

Maison de #conseil en #stratégie, #management et #organisation.";1837;595;1372;834;4638
ILA_Canada;ILA Canada;Canadian branch of @ILA_official, everything #international #law. Retweets are not endorsements;1844;1070;815;904;4633
Tradilmac;Ilmac Invest & Trade;Surfeur de tendances.;1757;58;341;2470;4626
Giuliettarni;Giulietta Ranieri;Étudiante en droit et Conseillère municipale présidente du Comité Consultatif des Relations Internationales à @VincennesVille;1220;591;259;2553;4623
matthieuriff;Matthieu Riff;Juriste đ„ | Ălu local Ă  @Esseylesnancy depuis 2014 đł | DĂ©lĂ©guĂ© du comitĂ© @Horizons_Nancy đĄ | @HorizonsLeParti & @la_RDME đ«đ· |;1506;1261;485;1370;4622
JPhilippeJAL;Jean-Philippe JAL;DG de l’amf69 (asso de maires) Adjoint au maire/ VP syndicat/ Chargé de TD @univ_lyon2 #Élu #Municipal #69890 #Histoire #Politique #Vin #Voyage #territoires;1115;2047;665;794;4621
KamgaJeanne;Jeanne La Pâtissière;;2311;391;480;1437;4619
Afrimag_;Afrimag;#Afrimag - Magazine #africain mensuel d'analyse et d'information économique.;3676;401;474;68;4619
razak_oba;Razak OBA;Président Association pour la Promotion des Objectifs de Développement Durable;222;2241;927;1228;4618
M_abdel_alim;Abdel Alim 🇨🇲;"Madridiste
Ronaldo is goat";1202;183;45;3187;4617
FwambaGhyslain;KingJames Ghyslain Fwamba;"*Peinture professionnelle grandes surfaces
*Fabrication objets décoratifs au Plasma
*Montage des machines semi-industrielles
*Formation Entrepreneuriale";1827;274;36;2479;4616
NewsMantraa;NewsMantra;;4356;5;252;2;4615
Pomerleau;Pomerleau;Rethinking construction together, from idea to completion. Everywhere. All the time. Period.;2255;0;1525;819;4599
SYANE74;Syane;Syndicat des énergies et de l'aménagement numérique de la Haute-Savoie - syane.fr --- Membre de @TEARAasso, @Fnccr et du #RéseauEborn;2445;368;1223;561;4597
vinougradus;vinougradus;"Professeur de Lettres en Lycée 
#EducMediasInfos #EspritCritique
#Exégèse #Littérature";2156;971;254;1216;4597
chetam25;Dam's;;2046;180;30;2333;4589
EDDacMartinique;EDD académie de Martinique;L'EDD dans l'académie de Martinique : #EDD #E3D #EcoDélégué #TransitionEcologique #FormationEDD #FOREDD #ODD;2132;450;666;1340;4588
lionel_thual;Lionel Thual;'44=BZH' + écologie + solidarité + fédéralisme (autonomie des régions). UDB. Informatique & Télécom. Breton, citoyen français, européen...;403;936;185;3061;4585
DebatPenly;Débat nouveaux réacteurs nucléaires & projet Penly;Débat public sur les nouveaux réacteurs nucléaires (EPR2) et le projet Penly, organisé par @CNDPdebatpublic du 27 octobre 2022 au 27 février 2023.;578;462;3502;38;4580
Fin_duPCC2021;@EndPCCFrancePetition;đȘ·âšPour notre đšđ” FAIRE OBSTACLE AUX METHODES D'OPPRESSION du PCC qui s'installent đ«„ chez nous â PĂTITION đïžđđ» Endccp.com/frđđŒ;1879;1722;712;264;4577
FranceTrisser;france Trisser;"universaliste  laïque détestation toute forme d'extrémisme 
refus dictature minorités radicalisées source de violences et haine";2072;30;28;2446;4576
GynecologueLa;La_non_gynecologue;"Musicos, meuf trans, je fais des bisous aux lapins.
Des fois je raconte des trucs sur l'actu.";952;219;25;3376;4572
LouisdeRedon;ð³ Louis de Redon;IngÃ©nieur agro et MaÃ®tre de confÃ©rences HDR en droit de lâenvironnement @AgroParisTech & @SorbonneParis1 // #biodiversitÃ© // #agroÃ©cologie;1454;1431;1179;505;4569
pnc_france;Patrimoine Nucléaire & Climat;Association pour la défense du Patrimoine Nucléaire et du Climat;1357;115;1868;1226;4566
mbombo_isaac;MBOMBO Isaac;"Éducateur, libre penseur et Acteur Politique
00243 995249485";2773;403;261;1123;4560
HorizonsParisCe;Horizons Paris Centre;Compte officiel du comitĂ© local @Horizonsleparti Paris Centre | đ©ââïž@figueroa75001 #VoirLoinPourFaireBien;477;748;1179;2151;4555
LxP1210;LPX_1210;;1029;241;3;3281;4554
BouassabAbdell1;Bouassab Abdellatif;;1502;373;29;2645;4549
JGallieni;LPO GALLIENI Toulouse;Lycée Polyvalent Joseph Gallieni à Toulouse. Campus d’Excellence CMQE de la Mobilité et du Transport Intelligent.;1107;313;945;2183;4548
dusoirmagie1;🇨🇵Magie Dusoir 🇨🇵;Fidèle, ne supporte ni le mensonge ni la trahison. Je refuse de rentrer dans le moule des bien-pensants. Mes choix et ma pensée j'assume 😜🤣😋;2398;1118;589;439;4544
MillesimeCaap;Le Terroir Passionnément by CA Alpes Provence;Toute l'actualité du marché de l'agriculture du Crédit Agricole Alpes-Provence #BoucheDuRhone #Vaucluse #HautesAlpes;2105;606;558;1273;4542
apim_mr;APIM;๐ฒ๐ท ููุงูุฉ ุชุฑููุฉ ุงูุงุณุชุซูุงุฑุงุช ูู ููุฑูุชุงููุง #ุงุณุชุซูุฑ_ูู_ููุฑูุชุงููุง Agence de Promotion des Investissements en Mauritanie ๐ฒ๐ท #InvestInMauritania;1650;25;1508;1359;4542
SimonBiotteau;Biotteau Simon;;871;89;27;3550;4537
Nikou63;Domy 🇺🇦🪖🏳️‍🌈;Belge de famille mixte venant du nord comme du sud de cette Belgique que j'aime, Ucclois de naissance et fière de cette origine.;2068;251;56;2156;4531
pfresolu;PF Résolu;Produits forestiers Résolu est un important fabricant d’un large éventail de produits de bois, de pâte, de papier tissu et papier, commercialisés dans 60 pays.;2221;274;1285;748;4528
Kendu74;Ké ? Nan...;... A la recherche de bonnes nouvelles, de plus en plus rares...Las de voir notre grande maison partir en fumée;2832;107;25;1563;4527
Pcongolais89;Erick Ngandu (Patriote congolaisð¨ð©ð¨ð©ð¨ð©);Patriote engagÃ©, je suis la politique, je m'intÃ©resse Ã  la politique et je crois que par la bonne politique le Congo peut mieux.;2916;312;222;1073;4523
Dem_Prog_PDL;Groupe Démocrates et Progressistes;Groupe des élus #MajoritéPrésidentielle à la région @paysdelaloire avec @FdeRugy @SophieCascarino @Steph_Gachet44 @fremyeric1 @F_Fontenaille #PaysdelaLoire;1233;872;782;1634;4521
ThePunkHucker;℘ųŋƙ|ɧųƈƙ;Cognitive bias is a much bigger problem than disinformation. Anarcho-socialist 🏴 Fuck authority ❌ Power to the people! ✊;2863;370;68;1218;4519
f_r_pierrot;Francois Pierrot;Chercheur CNRS - VP U. Montpellier - Mes tweets n’engagent que moi …;966;62;429;3057;4514
OGE_geometres;Géomètre-expert - Garant d'un cadre de vie durable;Professionnels de l’aménagement des territoires et du cadre de vie - L'OGE régule, manage et représente la profession.;1828;304;1734;647;4513
Impact_Campus;Impact Campus;"#innovation #pedagogy @groupe_sos
Our goal: prepare students and professionals for the great challenges of the 21st century by transforming the way they learn";904;466;503;2632;4505
Placeco_Media;Placéco;Placéco, le média qui fait rayonner l'écosystème.;3040;247;1152;65;4504
88_ASPP88;vosgeshorizondurable;;3818;65;133;486;4502
AxThV;Celax;Compte personnel, pas de ligne Ă©ditoriale fixe : SHS, tweets d'humeur et sujets au hasard.đšđŸâđM2 Education (M.A.Ed.);1977;955;131;1438;4501
BawashBigne;Bawash Bigné;;2538;874;147;942;4501
francoisastorg;François Astorg;🇫🇷🇺🇦 Maire d'Annecy #UrgenceÉcologiqueClimatique #RenouveauDémocratique #JusticeSociale #ÉconomieLocale Vice-Président Grand Annecy;1004;485;2525;479;4493
_DDSIS18;Bruneau Michaël;Colonel - Chef de corps des sapeurs-pompiers du Cher et Directeur départemental - avant affecté sur emploi de Direction @CHRU_Tours @sdis37 et DDASIS @sdis58;927;518;1179;1868;4492
rayyasoyer;Rayya ✨;@NatGeoFR 🥰 #btc #startup;3879;68;311;234;4492
FiboisBretagne;Fibois Bretagne;"Fibois Bretagne, le représentant filière #foret #bois #bretagne 
Promouvoir, accompagner, structurer, former, informer #constructionbois #boisenergie #boislocal";1673;702;1373;742;4490
kofumukanda;Oméga Kawanda;"🇨🇩Ambassadeur de Jésus-Christ/ Ir en Production Industrielle/Entrepreneur dans l'agriculture; Agro- industriel/ SG ONGD NDEKO EVENTS/ PDG d KAW-SPOUDAZÓ s.a.";551;217;316;3402;4486
zitounbraghini;Zitoun;;2866;49;23;1545;4483
BiscuitsGateaux;Biscuits, Gâteaux et Panifications;"Le Syndicat des Biscuits, Gâteaux et Panifications de France 
Patrimoine, Tradition, Responsabilité et Engagement 🍪 
Membre de @LAlliance7";1472;301;1875;835;4483
JMariole;Jack_mariole;;4082;84;27;288;4481
Mat116Drouin;Mathieu Drouin;;1946;110;29;2396;4481
TheodoseT;Nakajima67;rien;3568;14;7;882;4471
GabyKoleos11;GabyđȘđđ©;;3948;130;15;376;4469
VoyantLoup;LoupVoyant;;1501;214;8;2743;4466
ValloireHabitat;VALLOIRE HABITAT;"Acteur immobilier de référence en Centre-Val de Loire et sud Île de France filiale @Actionlogement
#logement #logementsocial #accession #location";1280;1346;1276;561;4463
PhilippeMontaig;Philippe Montaigne;Professeur de réalisme;1327;83;21;3020;4451
AColliat;Antoine Colliat;Adjoint au maire de Villeurbanne à la transition énergétique. Agir avec le plus grand nombre pour freiner le réchauffement climatique.;1214;420;316;2497;4447
MarieLaureDavy;Marie-Laure Davy;Directrice Leo Lagrange Ouest #Bretagne #PaysdeLaLoire #CentreValdeLoire #vieasso #ess #fonjep;1528;553;316;2045;4442
EDF_Guadeloupe;EDF en Guadeloupe;L'actualité, les enjeux énergétiques, environnementaux et sociaux du groupe EDF en #Guadeloupe, #SXM, #SaintBarth, #MarieGalante, #LesSaintes, #LaDésirade;1011;436;2283;712;4442
6eextinction;Sixième Extinction (8$);Je bloque les crypto-facho-complotistes bootlickers d'Elon Musk qui payent pour un crochet bleu qui donne plus de visibilité à leur stupidité. #BlockTheBlue;4041;16;44;341;4442
365jeuxenfamil1;365jeuxenfamille;Bientôt sur mon blog 365-jeux-en-famille.com vous trouverez des jeux et ressources pour retrouver joie et sérénité en famille. Vers une Education positive !;4372;2;62;1;4437
EmmanuelPeller1;Emmanuel Pellerin;Député des Hauts-de-Seine - #BoulogneBillancourt - ⚖️Avocat - ⚕️Docteur en Droit de la santé - 🇫🇷 Secrétaire Com @AN_AfCultAN;382;1400;2150;505;4437
FleuvesM;Martin;"Μηδέν ἄγαν
Rien de trop
Niente di troppo
Nichts zuviel";1742;421;331;1934;4428
map_monaco;Musée d'Anthropologie préhist. de Monaco;"OFFICIEL : #Musée d'anthropologie préhistorique #Monaco #préhistoire Fondation Prince Albert Ier
#exposition #fouilles #recherches #archéologie";1198;1688;1177;363;4426
DavidBorie4;David Borie;;4363;12;18;28;4421
SachaMaunier;Sacha Maunier;"Independent climate data scientist.
Founding director of Caelyi.";2546;213;63;1591;4413
Renato88248016;Renato;N/a;3332;635;32;411;4410
RegreenSahara;MLK;Regreen Sahara;1771;382;11;2246;4410
highlife_77;highlife 🇳🇱;Libertarien. Coraniste.;1868;621;63;1855;4407
Eco_Ain;Eco-Ain;Le compte officiel du magazine l'Eco de l'Ain.;3185;161;966;94;4406
ChristopheFrega;Christrade'it;Onetake;1900;121;60;2324;4405
lulu97381969;SwiftKey;La dictature douce.;1998;1172;528;704;4402
AlliotBertrand;Bertrand Alliot;"Environnementaliste, porte-parole de l'association @ecologie_action et auteur du livre ""une histoire naturelle de l'homme""";690;396;468;2843;4397
Papis0304;El hadji Seydou;;1662;220;60;2451;4393
BraudMaurice;Maurice Braud;@partisocialiste , @lours_org;1134;201;886;2172;4393
pierrov;P-F Thaler;Sustainability dreamer and co-founder & CoCEO of EcoVadis the leader in Business Sustainability Ratings;1571;639;1351;832;4393
2BleuBlancRouge;Franck;Contre le fascisme anti-republubicain de gauche.;2743;31;36;1580;4390
JulianaNykd;Lovatiana Juliana;"Enseignement supérieur à l'Université d'Antsiranana
Consultant national en Genre @UNFPAMadagascar
Education consultant @SilverlightResearch";1636;548;137;2068;4389
Axlndsoft;Andone;No deal in absolute;1900;597;17;1875;4389
redsem5;semar redouane;;3333;96;21;938;4388
NigerJve;JVE NIGER;Jeunes Volontaires pour l'Environnement, actions citoyennes 4 Climat et le DD #Niger;588;442;986;2370;4386
ESME_Alumni;ESME Alumni;Actualités des diplômés ESME / ESME Alumni Association (Graduate School Science & Engineering since 1905, founded by Joachim Sudria) @ESMEsudria;3424;223;576;162;4385
sylvainrousse10;Sylvain Rousseau;"Quand on est dans la merde jusqu'au cou, rien ne sert de courir, il faut partir à point.
- Samuel de La Fontaine";890;74;24;3395;4383
ChROSSIGNEUX;Ch. ROSSIGNEUX;De formation technique, le commerce de solution industrielle, le management d'équipe et le pilotage d'entreprise constituent mon activité;817;328;43;3194;4382
memakemeow;chachou;Sincerely, L.Cohen;1231;541;23;2586;4381
parlafe;đ­ Maxou đ­;lisez Berserk;1519;198;21;2642;4380
Youcef__KADRI;Youcef KADRI;Pharm.D, étudiant @SciencesPo et  médecine l Vice-président @univ_paris_cite l Student Ambassador for @CircleU_eu;580;676;526;2598;4380
williamportell7;william;;1594;69;18;2698;4379
Squeeze30070899;Squeeze;This is the end;2350;47;20;1961;4378
mh_agard;Marie-Hélène Agard;"Directrice Senior @PagePersonnel.
📣 #RH #Emploi & #Recrutement. Expertise #banque #finance #fintech #assurance. Intérêts 🌎#nonprofit & #ESS. Sea lover 🌅.";3038;290;328;713;4369
Hard_RockFM;Balle Perdue;;814;1117;160;2276;4367
LCFPVPecresse;Libre-Choix de Femmes Pyrénéennes avec VPecresse;Comité de soutien à @vpecresse des femmes Midi- Pyrénées issues de la société civile. #Pecresse2022 #Pecresse2027;1056;470;242;2597;4365
b_dubreuil;Bernard Dubreuil;Professeur des universités, physicien, ancien recteur des académies de Grenoble, Lyon, Nantes, Lille et Aix-Marseille;1657;136;167;2404;4364
MukMaurice;Maurice Muk;Le monde économique, financière, politique, géopolitique et sociale vas mal. On s’en inquiète ou on s’en fiche ? J'écris sur l’économie|Finance|Politique.;3555;292;68;449;4364
_Xav31;Xavier;;2467;28;13;1855;4363
aleaxa_g;Alexandra Grech;Live your dreams, don't dream your life ðð¹ðð;1403;140;75;2736;4354
MickyMi76258238;Mike85;Sport NBA Football;3082;980;35;257;4354
Cabanedebois;Simpson Homere;;3884;35;21;405;4345
tigotigo14;tigotigo;;4308;1;36;0;4345
Chotsky;Jeanne Chotsky;"communiste rĂ©volutionnaire đ«
je milite Ă  @RevPermanente et @LePoingLeve_Ntr";1139;666;613;1927;4345
BUParis8;BU Paris 8 - Vincennes-Saint-Denis;"Les gazouillis virtuels mais non moins réels de la #BUParis8 de l'université @UnivParis8, à votre service !

#BUP8 #BUParis8 #BibliothèqueuniversitaireParis8";2325;238;1049;728;4340
Fulcrumcompact;Fulcrum Compact;;2203;64;36;2037;4340
MorosoliGabriel;Morosoli Gabriel;Ne hurle pas avec les loups;1913;303;13;2111;4340
SCivileMedia;Société Civile Médias;"Agence Société Civile Médias
Agence de presse dédiée exclusivement à la Société Civile Africaine. 
societecivilemedias.com";3117;687;474;61;4339
BOT_Touchpad;future;"Not financial advice! I believe in innovations!
YouTube is the best plateform!
Do you believe in moore's law?";898;345;30;3058;4331
jean_boneau44;Jean Boneau;Aventurier timoré et brave peureux ! Je suis opérationnel pour le nouveau monde covidien !;2149;109;36;2027;4321
GerfridVertus12;Gerfrid Vertus;secrétaire Général adjoint de NOULHA. l'un des initiateurs et promoteurs de RVTH GVU / Yon AYITI Transfòme Haïti 2054;1508;2560;148;104;4320
SimpliceAsso;Asso Simplice;le consciencisme;2179;29;39;2073;4320
Wistou;Wist;;737;357;33;3188;4315
RejeanGoodrow;Rgogoud;;3602;215;78;418;4313
giorgio_claude;Claude Giorgio;;1258;20;21;3014;4313
BeniMuwawaM;Béni Camille MUWAWA;Economist -- Digital Journalist;1051;2161;93;1007;4312
seblemire;Sébastien Lemire;Père de famille et député d’Abitibi-Témiscamingue pour le Bloc Québécois ⚜️ Porte-parole responsable de l’industrie et des sports;624;841;1604;1238;4307
DamienPadonou;Damien Zinsou Padonou đź‡§đź‡Ż;#dĂ©veloppeur |intĂ©ressĂ© par le #digital | #computer_scientist de formation | tech Educator Ă  @ImpalaEdTech Parakou;4104;57;70;74;4305
gatocabron49;Soigné78;Moi puceau ?;3312;25;22;940;4299
Regencylimcoach;Regency Limo&Coach;"#transport #Corporat #Chauffeur #minibus #autocars #événementiel #VTC #RSE #EngagéRSE
#luxe #events #freelance";726;986;107;2477;4296
WindLockwood3;Windsor Lockwood;;3230;86;3;975;4294
NewsIUTcachan;De oliveira alves;Directeur IUT de Cachan (Université Paris Saclay);1195;232;227;2640;4294
bonnotjulien1;julien bonnot;Essayiste I anc officier de marine spécialiste renseignement et relations internationales Asie |sociétaire écrivains combattants l 🇫🇷🇨🇳;2238;457;210;1389;4294
PyroGenesisCan;PyroGenesis Canada - PyroGenèse Canada;"Bienvenue sur le compte Twitter officiel de PyroGenèse.  
TSX: PYR • NASDAQ: PYR • FRA: 8PY  
Welcome to PyroGenesis' official Twitter account.";2431;151;1607;100;4289
LinkCity;Linkcity;#Linkcity, spécialiste du #multiproduits, donne vie aux projets immobiliers et urbains de demain ! Suivez l’actualité du développeur immobilier de @Bouygues_C.;1457;131;967;1730;4285
DavasseGratien;Gratien Davasse;;130;78;13;4061;4282
bugznash;Bugznash;;3633;187;24;435;4279
20_100_57;Vin100 🇮🇲🇮🇹;"92I
hf97";3047;148;18;1065;4278
BLhoumeau;Temps long temps court;"Surpopulation. Le vrai danger écologique et de nos démocraties.
Opinion, de Huxley, dans retour au meilleur des mondes, et de René Dumont, 1er ecolo français !";2997;43;13;1224;4277
___oceane__;Océane Dumont;Militante @RNational_off | @RNJAlsace 🇨🇵;754;110;151;3262;4277
cfaperso;CFA;Chef d'entreprise,  Biker, Social Démocrate, Européen;1347;130;29;2770;4276
LDiabsonGass;Latifah Diabson;"đšđ”đŹđł
""Impossible, until it's done"" N.Mandela";375;189;64;3643;4271
Lydie_ANESTAPS;LYDIΞ;"🗣️Chargée de mission Coordination des évènements à l'@ANESTAPS
🎓Diplômée licence STAPS ES  
🏋️Préparatrice physique - OxSport Team";640;368;178;3084;4270
TKapitene;Tshikoko Kapitene;I love DRC my country and I believe that we can accomplish wonders if we put love first as one people. J’aime la RDC🇨🇩;2454;383;222;1208;4267
profintv;ProFin TV;ProFin TV est la première plateforme numérique de traitement en continu d’infos sur l’économie, la finance, l’entrepreneuriat et l’investissement en Haïti.;2648;98;1250;260;4256
iverson341;iverson34;;2849;54;33;1317;4253
ClubsterNSL;Clubster NSL;Réseau de 350 membres industriels, académiques et acteurs du soin, engagés dans l'innovation en #santé et #nutrition, en #bienvieillir et en #alimentation.;1682;661;1533;371;4247
ahougnan_p;Yao Philippe Ahougnan ð¹ð¬ð¹ð¬;Environment || youths leaderships || Climate activist |  SDG advocate|| human rights Defender   .;1398;299;281;2269;4247
noslois_news;NosLois l'Actu;NosLois l'Actu relaie l'activité de l'application mobile citoyenne NosLois;3954;7;251;32;4244
JeSoutiensIRSN;Je soutiens IRSN;"l’Institut de Radioprotection et de Sûreté Nucléaire est menacé de disparition
#Recherche #Expertise #Crise #Dialogue #Transparence #Ouverture #JeSoutiensIRSN";1833;136;310;1965;4244
InstitutduQC;Institut du Québec;L'IDQ est un organisme indépendant dont la mission consiste à identifier les politiques et actions nécessaires pour améliorer la société québécoise.;1873;544;1560;265;4242
Psch_lu;Philippe SCHLUNGS;Qui ose, gagne (“Les folies sont les seules choses qu’on ne regrette jamais.” : Oscar Wilde);3429;314;83;416;4242
Jonwqt;Jonathan;"Thermicien du bâtiment. Passionné des sujets énergie-climat
Pro nucléaire, pro ENR, pro sobriété
De gauche, orphelin de parti";2931;179;260;870;4240
clem2may;the original misanthrope;laclecledeschamps.wixsite.co…;1196;148;17;2878;4239
danieltranmtl;Daniel Tran;Responsable du soutien aux élu(e)s @MTL_Ville | développement économique et #innovation | #MBA | ceinture bleue en jiu-jitsu brésilien | (il/lui-he/him);563;718;447;2507;4235
CRE04;Environnement Mauricie;En favorisant la concertation des acteurs du milieu, nous souhaitons démontrer l’importance et redorer l’#Environnement en #Mauricie, un «Tweet» à la fois...;2080;643;1317;191;4231
KadjMr;E.T.T.E 🙄;"amusant 🙂😂
charismatique 🕴🏾
camerounais🇨🇲😂❤
mignon garçon🙂";2141;515;278;1292;4226
ToineBourrat;Toine Bourrat;"Sénatrice des Yvelines

senat.fr/senateur/bourrat_to…";669;568;1016;1964;4217
Gbemani01;Mbenga linaka;"Juriste et homme politique congolais 

Traitons bien les gens , le futur reste un mystère.";3361;313;110;428;4212
Yamen99771965;Yamen Belhaj Officiel;Événements, spectacles, reportages, Arts et culture ، économie, politique, sports;3787;70;53;294;4204
CheminotsCgt;CGT CHEMINOTS MONTPELLIER;Syndicat CGT des cheminots de Montpellier- En lutte depuis 1920;1773;286;463;1680;4202
Thierry24043340;Thierry Robin;De droite comme de gauche..Français. Quand on aime son Pays, on ne le scinde pas en 2..FREXIT...Vive le vrai DIEU quel que soit le nom qu'on lui donne...;910;436;168;2687;4201
CrypTom_YT;Tom Crypto;"Créateur de contenu et rookie de l'invest 🤑

Je vulgarise et j'analyse tous les jours.
Vidéos · News · Threads #Bitcoin #crypto
Mes autres réseaux sociaux 👇";2783;179;121;1116;4199
PadreSorel;Padre Sorel;;2486;58;23;1630;4197
EuroMov;EuroMov Digital Health in Motion;Unité de Recherche, Incubation-R&D, Sport, Mouvement & Santé, Informatique-IA, Monitoring, IoT, Perception, Rythmes, Pathologies, Neurocognition, fNIRS-EEG, IMU;1064;477;570;2085;4196
LefevreRollin;Rollin-Lefevre;;1206;479;99;2407;4191
NezMerde;Le nez dans le popo;Enfant d'immigrés | Gosse des cités | Patriote | Apolitique | Extrémiste de la liberté individuelle | Anti victimaires | Libertarien;2876;141;80;1088;4185
Greenpeace_LR;GreenpeaceLaRochelle;;1373;93;303;2415;4184
Gnassssssss;Ñassssssss🇸🇳;Quiescent soul into Energy | Power | O&G | Life - Petroleum + Electromech Engineer PhD - VanVo EPT INPG - All Praises to THE MOST HIGH;348;2191;396;1245;4180
DrHonorable;DocteurbahHonorableğ¬ğ³;Biologiste, P.soignant qualifiÃ©,activiste del'OMS, @WHO ,de la paix et des droits de l'homme ,Service de @santÃ© et de l'hygiÃ¨ne publique ,Interne au CHU Donka.;405;2439;705;624;4173
CE42759642;Fair haired Greeneyes;Né sous le signe du bélier, le feu cardinal, la tendresse et la colère, le glaive et le gant de velours, invivable...;2721;118;86;1248;4173
parlevrai;G;;2070;259;66;1773;4168
abr_yann;AbrYann;#servicespublics #eau #assainissement #environnement #collterr #ssd93;1123;398;102;2545;4168
figuinha_j;Figuinha Jacques - France en licence libre;"Développeur Informatique depuis 20 ans et père au foyer.
Créateur du logiciel OpenSource RegardsViewer";3119;94;101;853;4167
Laurent56208136;Laurent Dominique;Juste un libre penseur universaliste, à mon humble échelle,même si je trouve que simplement le dire fait prétentieux tant ça devrait être naturel et généralisé!;1720;74;30;2342;4166
albiaanews;albiaanews;هو مولود إعلامي فريد من نوعه يجمع بين عالم البيئة والاقتصاد إذ يراوح بين نقل الأخبار الخاصة بالمنظومة البيئية  الوطنية أو الدولية  وإعداد الملفات والتحقيقات;3628;63;454;19;4164
AfricanYouth01;African Youth;caricature, relais d’infos, la démocratie, la liberté d’opinion, et le vivre-ensemble, c’est indiscutable.;3105;758;171;123;4157
PascaleFressoz;Pascale FRESSOZ Alliance Internationale ODD #AIODD;"Auteur de Agir pour un monde durable, 
Présidente de l'Alliance Internationale pour les Objectifs de Développement Durable (AIODD),
Directrice cabinet Millenium";542;1392;655;1562;4151
clfdmv;clfdmv;;1585;70;9;2487;4151
ecoledeconde;École de Condé 📐;"Creators. Explorers. Designers. |🇫🇷🇮🇹|

📍 Paris - Lyon - Bordeaux - Nancy - Nice - Marseille - Rennes - Toulouse";1779;505;1154;712;4150
JulienN93300;Ju' l'Éclaireur;"R&D dans le secteur nucléaire. Transition écologique. Chasseur de demi-savants et de démagogues. 
NUPES optimiste";1043;152;16;2936;4147
EgfBtp;EGF.BTP;Le syndicat des entreprises générales de France #construction #BTP #innovation #environnement #social;2431;229;666;811;4137
Gaelverchere;Gael Vrch;28y, entrepreneur, ma seule religion, c’est la science.;860;229;88;2959;4136
ruedepontoise;CergyVelo;Philippe Descola : « La nature, ça n’existe pas »;1880;254;58;1944;4136
Freculf;Stef.C;@OM_Officiel ðð¤ L3 Histoire;1181;243;20;2691;4135
nathaliemfls;n@th;;131;167;34;3802;4134
Arr_Verdun;Arrondissement de Verdun;Compte Twitter officiel de l'arrondissement de Verdun.;1472;170;2197;294;4133
PAC4822;Paul-Andre Constantin;;2768;26;27;1307;4128
AMCEIPI;AMCEIPI;Association des Masters du CEIPI à Strasbourg;2137;233;543;1214;4127
Frederi55284379;Frederic Petit;"Investor |

Business | Finance | Capital Markets
Portfolio Construction & Strategies |
Technology & Energy Sectors. 
Opinions are my own.";3615;197;69;243;4124
AlbrieuxS;Albrieux S.;...;2137;54;35;1887;4113
DonaldMeyo4;Donald Meyo;;1678;223;45;2167;4113
confkids;Confkids;;1077;953;620;1457;4107
robibataille;Loto Covid (parodique) ð´ââ ï¸ð´ââ ï¸;"Humour noir
Rit thÃ©rapie
Recherche du gros bon sens
Sans prÃ©tention
Avec respect";3142;182;89;690;4103
FDartiste;Florian Delorme;Auteur, réalisateur et photographe;3908;119;35;38;4100
Reseau_LeLierre;Le Lierre;"Le réseau écologiste des professionnels de l'action publique
Vous êtes fonctionnaires, consultants, experts, collaborateurs... rejoignez nous via notre site👇🏽";1351;477;1094;1177;4099
ahguena;Ahmed Guenaoui;Founder @ Nautilus Energy | Advisory & VC | #energytransition #climatetech #greentech;2008;341;752;994;4095
cyberjuno;Yves Juneau;PDG Association des stations de ski du Québec, amoureux des sports de glisse et de montagnes enneigées. Compte personnel.;1316;746;537;1491;4090
ShareCitations;O'Sharif;Avouons à notre adversaire que nous ne partageons pas ses idées car nous les comprenons et que lui ne partage pas les nôtres car il ne les comprend pas.;1316;362;75;2337;4090
stephEhrmann;Stéphanie Ehrmann;DRH @Dalkia Méditerranée;742;195;225;2927;4089
Food_beggar0;Edit;entrepreneur;3807;9;3;270;4089
nimamachoufnpd;Nimâ Machouf;Co-présidente de l'association locale du NPD Laurier-Sainte-Marie. Épidémiologiste. Militante féministe, écologiste et pour la justice sociale.;484;246;1878;1479;4087
FFoucart;François Foucart;;1396;153;15;2510;4074
OG7478;Olivier Guerin;;1037;74;36;2926;4073
tafarie351;Nigérian deportee;KEEP REAL;2187;62;27;1787;4063
PallezLaure;Laure Pallez;Citoyenne élue en Floride🌴 | Consultante |20 ans expat G2 🇨🇳🇺🇸| @saishopkins alumn 🌏|cofondatrice @la_commun | VP @les_doleances CNPS @Refondations1;552;1055;576;1879;4062
esaiembumbagma1;esaiembumba@gmail.co;Coordinateur national de l organisation paysanne pour le developpement durable (opdd)asbl;415;2170;351;1118;4054
Franck_LEROY_;Franck LEROY;Président de la @regiongrandest, Président Epernay Agglo Champagne, Président de l'Association des Maires de la Marne;443;263;2985;359;4050
JeanPierreDESHA;Jean-Pierre Deshayes;"Programmes européens 2021-2027. Fonds européen de défense. ""Alliance Clean Hydrogen"". Export et Accords internationaux. Financements des Collectivités locales.";2986;289;771;2;4048
jeunemoumou;George Clemenceau;;2876;198;22;948;4044
kakounewyork;KAKOU AKA;;4007;10;21;5;4043
flore_kayala;Kayala Flore;Journaliste Rédactrice et reporter,  consultante en communication et Administration. Desk Ressources naturelles  et genre.  oisillonsinfos.org;1165;111;341;2426;4043
moha08000;moha08;;1981;107;5;1949;4042
quatorziens;Quatorziens en chemin;Collectif de la #transitionécologique dans #paris14 pour favoriser l’ #engagementcitoyen 🌱;1069;779;99;2094;4041
labodk2;Labodk2;;2086;194;331;1428;4039
MVANantes;Mieux Vivre à Nantes;Compte officiel du groupe Mieux Vivre à Nantes • Républicains, Centristes et Indépendants;1659;662;1226;491;4038
NorAmbFR;Ambassadeur Niels Engelschiøn;Compte officiel de l'Ambassadeur de Norvège en France et Monaco. Suivez aussi @norvegeenfrance;883;1063;1189;903;4038
ICESCOfr;ICESCO Français;L’ICESCO est une organisation internationale spécialisée, opérant dans le cadre de l’Organisation de la Coopération islamique.;3702;6;324;5;4037
antee0five;+;Entrepreneur, prospectiviste, diplômé d'économie Internationale, Resilient;859;1344;236;1598;4037
FRT_Guillaume;Guillaume Biscotte;"Stagaire à @LaTacfi, M2 @CcstGrenoble, amateur de cassage de caillou et de soirées étoilés.
Créateur du #podcast Un·e prof, Une histoire #UPUH";307;606;114;3010;4037
savid87;David Guillon;;2491;84;19;1441;4035
Triplechuck;Chuck⛵;;1088;98;27;2821;4034
Avalon80565228;Mme StephanieClaireMarylene VOOS P DERFOUFI Avalon;"NFT certifie!
Merci Merci Merci !
La vie c est Maintenant !
BlueMindCore©!";2972;946;48;64;4030
JRD3DU;JulienR, P.Eng.đ;"Mastodon: @JRD3DU@techhub.social 
Co-Found. resyn.io, @resyn_io Empowering local, circular, & regenerative networks for
đČ#Food đż#Biomassđ§#Water âïž#Energy";2054;546;167;1262;4029
rceconomie;Regards croisés sur l'économie;"🆕 11/22 : Financer la culture
📚 Revue de sciences sociales
👉 Construire des ponts entre recherche académique & débat public
🏡 rce-revue.com";1303;185;1880;660;4028
Ocean_Orange_BS;Océan - Orange Business;"La solution de référence en 🚗 #fleetmanagement, #GestionDeFlotte, 
🍃 #Ecoconduite d'@OrangeBusiness. #innovation #business, #tech et #IoT";954;1326;1168;577;4025
SimonOrsini;Simon Orsini;;710;1495;114;1697;4016
onufemmesSN;ONU Femmes Sénégal;Nous sommes l’organisation de l’ONU consacrée à l’égalité des genres et à l’autonomisation des femmes dans le monde entier.;419;384;1304;1908;4015
mobeika;Marwan Hobeika;"Earthly wanderer, adoptive Brusseler.
Cyclist, ecologist.
Still a Twitter novice.";333;229;185;3267;4014
B_Marsigny;Brigitte MARSIGNY;Maire de Noisy-le-Grand. Premier Vice-président de Grand Paris Grand Est. Ancien Bâtonnier de la Seine-Saint-Denis.;1253;304;2064;393;4014
SantiagoB33;Fernandez Santiago;;2555;46;19;1393;4013
EnCovoitGLyon;En Covoit' GrandLyon;La plateforme de référence de la Métropole de #Lyon pour du #covoiturage au quotidien ! Inscription et mises en relation gratuites.;2436;200;763;613;4012
socotec_france;Groupe SOCOTEC;Organisme expert en maîtrise des risques, notre réseau de proximité vous accompagne en inspection et mesure, assistance et conseil, certification, formation.;2208;196;1349;256;4009
Fulby_fr;Fulby;Chasseur de clown;3609;35;8;357;4009
nbl071;Mr Retweet;2019, je découvre Twitter. Suivez moi, même si je connais pas le chemin.;3739;181;21;67;4008
KahlDrogo10;Kahl Drogo;"Timonier sur les marchés financiers / je bois des socialiste au p'tit dej
mort a la NUPESte noir";1925;149;34;1894;4002
SebaBourlet;Sébastien;Comptable;3798;58;9;133;3998
YvesTallet;Jean-Yves Tallet;Métaphysique de l' informatique. I3 .;3691;249;24;28;3992
Marakai_59;🚀 Marakai;Droitier de la main, et de l'esprit aussi;632;110;19;3228;3989
Genotoul;GENOTOUL Génopole Toulouse;Le réseau toulousain des plateformes technologiques en sciences du vivant /The network of technological platforms in life sciences #recherche #biotech #biodata;1240;285;678;1784;3987
volute10;flouette@intendance;passée du sud-ouest à Vanves sans perdre l 'accent . chocolatine for ever. Marche à Gauche....;1427;300;39;2219;3985
matblume;Matthias Blume @matblume@mastodon.social;Physicien, navigateur, urban gardener, ...;1255;389;48;2293;3985
Csouleye;CSouleye;Chargé de mission @AFD_France à NKT #Développement #Rural #Agriculture #Biodiversité.  Tweets are my own.;1205;1223;187;1369;3984
fr_pm;FR_am-pm;"ūüáęūüá∑ Ordre Juste International
D√©mocratie #Participative
#EcoSocialisme Humanisme Continentalisme
#H√©t√©roRights FemmeADN
ūüĆé Combattre la manipulation-propagande";3921;19;40;2;3982
EffetdeSerre76;ESTM-Rouen;Association rouennaise de protection de la Nature et de l'environnement;1665;431;384;1501;3981
yovani73200;yo73200;pour la paix: non au nazisme ukrainien et non à l’impérialisme américain!!!;1740;162;110;1967;3979
Dynafor_Lab;Dynafor;UMR 1201 #INRAE #INPToulouse #EIPurpan #LandscapeEcology #SocialEcologicalSystems;1519;599;878;978;3974
PhilippeTaupin_;Philippe Taupin;"Bourgeois d'intérêt général. Mammifère omnivore. 
Utilisez Olvid.io";658;1696;62;1556;3972
AdamHenning75;AdamHenning;These opinions are mine, not those of my employer | Analyst | Historian | Liberal | Humanist | Defender of Civil Liberties | Against All Forms of Extremism;3177;61;65;668;3971
yusuketadao;忠雄裕介-Full Burn;漫画家 私はフランスの漫画家です ! 日本語を勉強しています 日本でマンガを出版したい！ Mangaka, je tweet FR/JAP. Je poste mes travaux , des croquis et dessin ✍️;2217;276;475;1001;3969
Davidwrrd;David đź‡«đź‡·;AdhĂ©rant @lesrepublicains et @nouv_energie đź“š Ă‰tudiant en droit đź‘¨â€Ťđź’Ľ Stagiaire Ă  Beauvau Ď• Admirateur de philosophie;1191;313;107;2349;3960
enoradeniel;Enora Déniel;;636;361;16;2946;3959
adimi_amine;amine adimi;On peut avoir ce qu'on veut avec un sourire et un flingue que seulement avec un sourire;728;411;170;2650;3959
TogetherEnsemb;Together | Ensemble;"Canada's National Conference on the SDGs. | Conférence nationale du Canada sur les ODD. 
🍁🌎✨
#TogetherEnsemble #TogetherEnsemble2023";609;391;450;2508;3958
PatrickMonin71;Patrick Monin ✌️;Candidat aux élections législatives des 12 et 19 juin 2022 sur la 1ère circonscription de Saône-et-Loire avec @catherine_amaro | #NUPES | Maire d'Azé (EELV);683;871;2172;231;3957
SalimAlmalik;Dr. Salim Al-Malik;"الحساب الرسمي للدكتور سالم المالك. مدير عام منظمة العالم الإسلامي للتربية والعلوم والثقافة #الإيسيسكو
@ICESCO_Ar
@ICESCO_En";2254;13;1571;118;3956
DorianBianco07;Dorian Bianco;Director of @G_am_volontaire | PhD student in architectural and planning history at @Sorbonne_Univ_ & @centrechastel | Supporter of welfare planning | ð«ð· ð©ð°;844;866;493;1753;3956
christinebost;Christine Bost;Maire d'#Eysines - 1re Vice Présidente du Conseil Départemental de la @gironde et 2ème Vice-présidente de @bxmetro;1123;565;1329;932;3949
SCharles_SNCF;Sylvie Charles;Directrice de #Transilien SNCF - @Actu_Transilien - #MassTransit;622;306;2090;929;3947
CapitaineTruite;Capitaine Truite;Docteur en Paint net.  Truite géante, chef absolu de l'armée des truites.;2167;320;140;1319;3946
mariongaudin;Marion Gaudin;Journaliste @France24, ex-correspondante à Madrid @TF1, @LeParisien, @itélé;417;494;2733;302;3946
Espoir89735332;BREIZH;;1635;209;23;2075;3942
MPMarchand;Marie Pierre Marchand;Maire adjointe à la Politique de la Ville Paris 13. Conseil Politique Départemental EELV Paris. Consultante développement urbain et social.;519;134;315;2972;3940
seb92800;seb92800;"Responsable de pôle technique. 
Coureur à pied et triathlète amateur. Ancien arbitre  national de handball.";1581;218;33;2108;3940
solidarite2021;Ministère Solidarité et Lutte contre la Pauvreté;Bienvenue sur le Compte Officiel du Ministère de la Solidarité et de la Lutte contre la Pauvreté;917;112;1860;1049;3938
youneskaoudji;Jonas.YK;"ⵢⵓⵏⴻⵙ
Quand tu regardes longtemps l'abîme, l'abîme regarde aussi en toi.
#Seksu_s_tɣeddiwt
#PharmD 💊⚕️ 
ⵣ";421;347;30;3140;3938
razorXrazor;Leïla Razor;"Fintech worker, part-time troll.
Cypherpunk libertarian nihilist";3437;69;39;393;3938
BVG_OAG;Bureau du vérificateur général du Canada;Le compte officiel pour le Bureau du vérificateur général du Canada. English: @OAG_BVG. Modalités : ow.ly/dTBw3057vEV;2211;541;976;209;3937
nertenliceoff;Nicolas Ertenlice ❁ 🏫;Élu au C.A, CVL, CESC au lycée, délégué de classe #SciencesPolitiques #journalisme✍️ #sport & #jeunesse – Président de #MDL.Référent thématique @JCentristeEcolo;1493;99;92;2247;3931
shameldufour;Sophie Hamel-Dufour, Sociologue et VP;Vice-présidente chez René Villemure Éthicien - Éthique et société - Transition écologique juste - Aller au-delà des évidences - Balado Radio FSF;556;235;182;2953;3926
JeanRichardCAS1;Jean-Richard CASTELLO;Vous permet de concrétiser vos projets et solutionner vos problèmes;983;2292;596;55;3926
alainheyraud34;Alain Heyraud;citoyen engagé, ex FT/Orange, ex Dirigeant sportif. #sport#rugby#cinema..soutient de nombreuses causes #autisme#Alzheimer. Militant contre le Stade à Pérols.;1060;523;346;1994;3923
CatherineLaCite;CathSM;Passionnée de l’appui aux étudiants, de la forme physique et du bien-être!🏃🏻‍♀️🦸🏻‍♀️;340;398;146;3037;3921
Kenjasduro;eric vermeille;Je suis un fada, je ne recycle pas les bouteilles en PET.;1151;34;24;2711;3920
AncpAf;ANCP&AF;La place, le rôle, la mission des formateurs 1er Degré. Oeuvrer à la réussite d’une profession indispensable au bon fonctionnement du système éducatif.;1186;45;700;1979;3910
SowSowfallou093;SOWDIGITAL SENEGAL 馃嚫馃嚦鈫笍;MONTEUR - FORMATEUR EN PREMIER PRO - COM'DIGITAL- R脡ALISATEUR - PHOTOGRAPHER - RMC GROUPE SEEE;2139;892;472;407;3910
SwedenInBF;SwedenInBurkinaFaso;Ici twitte l'Ambassade de Suède au Burkina Faso. The official Twitter account of Embassy of Sweden in Ouagadougou. RT not to endorse, but to inform and share.;715;773;2078;338;3904
whispershoutlow;Le journal des scandales;;1205;141;25;2533;3904
CONFEMEN;CONFEMEN;Depuis sa création en 1960, la CONFEMEN oeuvre pour la promotion de l’éducation et de la formation professionnelle et technique.;1885;405;1506;104;3900
AnandKumarT11;Anand;Engineer...@Siemens;3751;78;29;41;3899
Nicolas_Louisot;Nicolas Louisot;Enseignant #SVT et formateur à mission de conseil pédagogique sur la zone Amérique du Nord pour l'#AEFE - @EEMCP2_AEFE_ZAN #FISNA @Efe3dZan - 📍@lyceeclaudel;785;479;366;2267;3897
Orpheus_SM;Orpheus🇨🇩;Simplement congolais🇨🇩;533;1003;468;1892;3896
robertomassari;Roberto Massari;«Un imprevisto è la sola speranza, ma mi dicono che è una stoltezza dirselo» (E.Montale). Aspirante giornalista collettivo. Qui a titolo personale.;1992;207;95;1601;3895
VegeanH;Hélène Vegean;;1876;254;87;1676;3893
JoAzny;Un gars bon;"PSG/Cameroun 
Espèce en voie de disparition. Heureusement, vous avez la chance que je sois encore là pour plusieurs années...";1661;1870;147;213;3891
2pkenneth;kennethalan;;3864;15;5;6;3890
TitouanLemoine;Titouan Lemoine;"Journaliste interne à @ucly

Geek et d'autres choses.

Passé par @SpecialisterneF, @F2Washington, @ladepechedumidi, @GeopolisAfrique";1352;1088;279;1170;3889
Meteoregionbrg;Météo Bourgogne;Jeune passionné de météo! ⛈️☀️                      Envoyez-nous vos plus belles photos📸;457;96;148;3188;3889
Sieml49;Siéml;Syndicat intercommunal d'énergies de Maine-et-Loire : énergique et lumineux depuis 97 ans !;1464;378;929;1111;3882
AltGreenwashing;Alerte Greenwashing;"Collectif de veille contre le #greenwashing  
ð¨ Alertez-nous avec un tag";1623;850;730;678;3881
aqme_qc;Association QC des médecins pour l'environnement;🌿🩺📢 Association québécoise des médecins pour l'environnement (AQME) • Comité @CAPE_ACME • Améliorer la santé humaine en protégeant celle de la planète;1130;763;1225;760;3878
fitzelrich;Elrich;;1976;60;15;1818;3869
UCO_Laval;UCO Laval;Suivez toute l'actualité de l'UCO Laval et de Laval 3Di (ex-Escin);1707;425;556;1176;3864
yvanc7;yvanc;;2869;217;13;762;3861
Lask92155759;Lask;;2287;174;25;1375;3861
rozgaalexandre1;Rozga Alexandre;Grand reporter France3 Occitanie. Mes tweets n engagent que moi;1206;437;116;2099;3858
6ssouK;Sixtçou Vini;;1280;48;11;2518;3857
CfePetrole;CFE-CGC Pétrole & Energies Nouvelles;La CFE-CGC Pétrole et Energies nouvelles représente les salariés de la Convention Collective des Industries Pétrolière ainsi que celle du Négoce / Distribution.;1039;1498;335;985;3857
LilahTresor;Lilah Tresor;ð¦ c'est pas la vie ð;453;85;73;3245;3856
tsarleatas;Tsarleatas;Auteur, compositeur, interprète, rédacteur en chef.;2103;275;38;1439;3855
NoKataguruma;Seyit;Head of Coconut Trading at JP Morgan;1249;64;32;2508;3853
ArnaudPraile;praile arnaud;Entrepreneur autodidacte. Amateur de politique et féru de connaissance en tout genre. Maire de ma commune vendéenne.;1879;437;136;1401;3853
COLLEGEPEIRESC;collegepeiresctoulon;EPLE du département du Var (83) Académie de Nice- Ouvert en 1867. Mobilisés pour la réussite de tous et de chacun.;1095;720;724;1313;3852
PSPPlamondon;Pierre St-Paul Plamondon Parodie⚜️;⚠️Compte parodique officiel du compte officiel du Chef du Parti Québécois officiel, Paul St-Pierre Plamondon⚠️;1296;664;830;1060;3850
Quid_1984;pilipili;;1342;165;17;2324;3848
WisdomKuzamba;Wisdom Kuzamba;Écrivain des informations en exercice, Animateur né, Poète-Slameur pratiquant, Littérateur en réflexion, Humoriste en devenir, Comédien ewisdomkuzamba@gmail.com;775;670;234;2169;3848
Vian_Marc;Marc Vian;Ingénieur génie civil, spécialiste en gestion et exploitation d’infrastructures routières.;1912;275;156;1501;3844
AdrienAmonsengo;Adrien;Bsc in Mining Engineering, Diplôme in management, drop out MBA, Entrepreneurs, homme d’affaires, apolitique. J’aime les challenges. I am straight talk, No BS;2900;416;35;489;3840
MichaelMrtl;Michael_Martial;Chargé d’études et d’analyses budgétaires| 📚finances publiques et politique| Parti Radical | MBA @iaeparis;1819;257;284;1479;3839
SKOODBE;Skood 🐝;Valorant à détruit ma vie (Vitality la reconstruit)/ #VForVictory / @TwistenVAL me manque;3180;176;53;423;3832
Ms_BookHoarder;Book Hoarder;(Photos du profil : oeuvre de Peter Wüthrich);1750;527;190;1364;3831
JosselinRennes1;Josselin KERVICHE;"Directeur DSI / IT Director
@MetropoleRennes et ville de Rennes. 
Previously @UnivRennes1. Mes tweets n'engagent que moi / Tweets are my own.

#emojibzh";1041;675;556;1555;3827
EbuweJr;Mike Jr Leader;Amoureux des valeurs;2524;230;38;1032;3824
SebGraciotti;Sébastien Graciotti 📱📷🖊️🇮🇹;Journaliste / transformation digitale @Lebienpublic à #Dijon • Alumni @EMSmediaScPo • @ESJLille • @univ_lyon2 • ex @Le_Progres  • Originaire de Lyon;2429;633;735;27;3824
IsegoriaNantes;Isegoria Audencia;Tribune Etudiante d'@Audencia : Débats et Conférences avec des Personnalités. Entrée libre & gratuite;1993;381;878;569;3821
nicolasbissaud;Nicolas Bissaud;;773;180;37;2830;3820
societeinclusiv;SociétéInclusive;Des projets intersectoriels en adaptation-réadaptation et soutien à l’inclusion sociale | Intersectorial projects in habilitation/rehab and social inclusion;1932;488;486;907;3813
Carriere34;Lino;Dame Nature était sage, mais ses enfants sont sans cervelle;1975;682;243;912;3812
Nahimarose20;Halima Hlm;;755;168;38;2849;3810
GweChap;Gwchap;"De formation technique et travaillant dans un milieu industriel fortement automatisé..
Dans mes nombreuses missions, il y a les gains en énergie 😅..";1242;336;23;2204;3805
IngeBaumgarten;Inge Baumgarten;"working for unity in diversity; passionate about equal rights; Resident Director GIZ in Togo - @giz_GmbH";1141;293;981;1389;3804
AlexPicot78;Alexandre Picot;;2506;124;78;1095;3803
NlleEnergie83;Nouvelle Énergie - Var (83);Compte officiel de #NouvelleEnergie dans le #Var @DavidLisnard | #TeamLisnard #Lisnard;896;85;371;2443;3795
M_Laigneau;Marianne Laigneau;Présidente du Directoire d’@Enedis #ServicePublic #NouvelleFranceElectrique;268;127;3152;247;3794
Fondation_GRDF;Fondation GRDF;La #Fondation #GRDF soutient et accompagne des initiatives d'intérêt général qui font progresser l'inclusion et le développement durable dans les #territoires.;715;205;449;2424;3793
Anto05073;Anto0507;Ma liberté de penser;1560;13;17;2200;3790
RhoSigma2;Rho Sigma;"Faisons une place à la nuance et la réflexion. 
Allergique aux extrémismes et à la bêtise.";2183;36;9;1561;3789
Tauren_neruaT;Tauren;Je suis là.;1710;177;12;1872;3771
HerrZed;Herr ZED;❤️: 🇫🇷,🇺🇸,🐺,🐈‍⬛,🐻,🏈,⚽️,🎸,🎲,🎮,🎰,🚙,🏞️,♋️and🏁;2693;58;27;993;3771
Bonnetbenoit1;Bonnet benoit;Le goût pour le non conventionnel;912;73;43;2739;3767
NanabozoQc;xavier;Complotiss, antisemite, revisionniss, whateveriss, je bloque les terreplateux, récentistes, madella effect, hypocrites, menteurs, trolls pervers narcissiques;3208;50;30;478;3766
JTroccaz;Julien Troccaz;Cheminot - Secrétaire fédéral SUD-Rail  - Union syndicale Solidaires;903;1277;852;734;3766
LouisNegreCSM;Louis Nègre;Maire de la @VilledeCagnes - Président délégué de la @MetropoleNCA - Ancien Sénateur des Alpes-Maritimes - Compte officiel -;912;653;2069;128;3762
zemouri4;zola40;Obersvateur du monde et flingueur à l'occasion !;2731;214;11;801;3757
IlungaPatricka;Patricka Ilunga kabund l'oeil du chef 👁️;Rechercher en science politique et jeune activités en matière politique;467;2063;443;783;3756
JMarcBlanchard;Jean-Marc Blanchard;Science, universalisme, baseball.;800;126;23;2805;3754
BureauDirection;Bureau de la Direction;N'hésitez pas à me bloquer si je dérange, hein.;347;203;23;3179;3752
Hab_Concept;Habitat Concept;Constructeur de maisons individuelles dans le Nord de la France. Habitat Concept vous propose une large gamme de modèles de maisons qui s'adaptent à vos envies.;1451;498;1786;17;3752
ShaileshTambat1;Shailesh Tambatkar;;3695;30;19;7;3751
faxm63;Pomme de pin;Écologie, consommation, société, #velotaf 🚲 et pan bagnat #StandWithUkraine 🇺🇦;1042;384;43;2281;3750
VilleDeGarches;Ville de Garches;"Compte officiel de la ville de Garches
#HautsdeSeine #ÎledeFrance";3008;77;512;147;3744
Begueimmobilier;Begue Immobilier;Begue Immobilier c'est 2 agences immobilières à Brax et Pibrac à votre disposition pour vous aider à réaliser votre projet immobilier sur l’OUEST DE TOULOUSE.;3248;4;492;0;3744
Rene_B69;ReneB;;2544;11;22;1159;3736
julien_lasq;Julien;;3292;36;36;368;3732
EolienMerSNA;Parc Eolien en Mer de Saint-Nazaire;"Compte officiel du #ParcEolienEnMerStNazaire, premier
parc éolien en mer de France, source d’énergie renouvelable. 💨
Mise en service progressive en 2022.";861;405;1577;889;3732
LEssentiel_CPAC;L'Essentiel;Une analyse en profondeur des décisions politiques d’Ottawa et leur impact sur les communautés francophones du Canada.  @EstherBgin @CPAC_TV;1245;304;2151;22;3722
Barthelemy_Mat;Polar Bart;;1139;611;287;1676;3713
BenB_crypto;ben-b.lens🇧🇪 (🌸, 🌿);"My decentralized profile : lensfrens.xyz/ben-b.lens Moderator on Nested's Discord : discord.gg/6mPcTMPbnG
@StrategProtocol Strategist";2024;127;179;1381;3711
JoeLeTaxi1971;Joe LeTaxi;Never Send a Human to Do a Machine′s Job - A. Smith;2480;46;26;1152;3704
HorstvdHarm;Harm Van Der Horst;;1905;56;23;1717;3701
Richard_Marion_;Richard Marion;"Président de la commission Culture @GrandLyon 
Conseiller municipal @VaulxenVelin69
Co-responsable de la commission Quartiers populaires @EELV";623;1478;509;1086;3696
SteampunkWinny;Kui-Où-B7;;876;251;128;2437;3692
EdmondDan_tes;Edmond Dantès;;1713;384;140;1455;3692
M_BidetDousset;M_Bidet&Dousset;Cabinet indépendant à taille humaine créé en 1898. Valeurs/idées : #ethique #deontologie #patrimoine #fiscal #transmission #humain #audit #solution #discretion;2117;943;581;50;3691
DroitScPoNice;DroitSciencePoNice;"Compte officiel de la Faculté de droit et science politique - EUR LexSociété @univ_cotedazur
🎓 + 40 formations
👨🏻‍🎓 3000 étudiants
📍 Campus Trotabas, Nice";2053;157;992;487;3689
AnnoYann_;yann;CAQu (j'ai eu ma leçon). Débat, idée, remise en Q?. Je ne crois pas en la science, on croit à la ⛪🕌🕍. Mais je crois à la démarche scientifique.💉💉 . Pas 3💉.;1673;147;36;1828;3684
Les_shifters;Les Shifters;Les Shifters est un réseau de bénévoles aux profils, expériences et compétences très variés pour la transition carbone de l’économie. #LesShifters;265;42;3196;175;3678
Sylvain21995073;Sylvain Martineau;;943;322;18;2387;3670
francine_becque;Francine BECQUE;;3461;7;12;187;3667
andrecouture5;andre couture;3 kids, process chemical engineering, R&D and pharmaceutical industries, business 43 countries - Ironman Triathlons, fantastic family &wife.;1838;188;24;1616;3666
GDHClimat;G.D.H;Nous ne voulons plus travailler au spectacle de la fin du monde, mais à la fin du monde du spectacle.;2269;130;50;1217;3666
DishMwanza;Dish'ma Mwanza Kalam;IR Électronique Industrielle / Directeur Projet Certifié PRINCE2/Employé Belge secteur privé/Marié, 4 kids/Anti-corruption compliance;1829;307;136;1383;3655
EmploisCGF;Emplois CGF;Annonces d'emplois publiées sur le site cgf.pf;3610;0;44;0;3654
lefebvre143;VINCENT LEFEBVRE;“L’obscurité ne chasse pas l’obscurité, seule la lumière peut le faire.” Martin Luther King;1117;316;31;2184;3648
JeanChr14069741;Jean-Christophe LAFORGE;"Apolitique depuis la haute trahison Hollande. Humaniste.
Collectionneur de Prises de Vies Photographiques.";541;1987;244;875;3647
nouslesvivants;nous sommes vivants;Collectif de l'innovation & transformation dans les entreprises pour accélérer la transition écologique.Animé @jeremydumont #regeneration #noussommesvivants;753;2438;430;26;3647
GaginPaoli;Vanina Paoli-Gagin;Sénateur #Aube @Senat @Indep_senat #ComFinSenat | Rapporteur #EnseignementSup #Recherche |VP Délégation #prospective|VP mission #métha |VP GAS 🇫🇷/🇨🇳 Avocat;961;353;827;1504;3645
LelearningShow;Le learning show;"9&10 octobre 2023
#learning #neuroscience #formation #EdTech";1361;397;1033;854;3645
RealGrayJedi;LoRob // ð«ð· ð³ï¸ // ðªðº â¡ï¸ â;Justice, vÃ©ritÃ© & souverainetÃ©. ProtÃ©geons nos enfants, lâavenir de lâhumanitÃ©. #VemeRepubliquePutative explications â¡ï¸ piped.video/o0EXhBI0x3k;2249;404;193;798;3644
commercedubois;Le Commerce du Bois;L'association garante d'une ressource durable #bois : importateurs, raboteurs, négociants, agents. Organisation de contrôle #RBUE @EU_commission #gestiondurable;1491;409;1074;669;3643
Maxkatre;Mireille_Mathieu;Twitch Affiliate - DMs for business inquiries;2742;89;147;664;3642
Georgelenantais;in muscadet we trust;;1206;145;32;2255;3638
CENOZO_Afrique;CENOZO;Cellule Norbert Zongo pour le Journalisme d'Investigation en Afrique de l'Ouest || Cell Norbert Zongo for Investigative Journalism in West Africa;1087;98;1858;594;3637
eric_terre;Utopia;;1185;260;62;2130;3637
EricDOURNES;Eric DOURNES;Directeur du Groupe Créa-SUD Communication. #CreaSUD #CreaFactory;1059;366;971;1238;3634
ATV_Systemes;ATV Systèmes;Fabricant français de mobilier technique et de maquettes didactiques pour l’enseignement professionnel, technique et tertiaire - Groupe Ateliers de Villetaneuse;1641;1633;268;91;3633
univMaroua;Université de Maroua;Compte Officiel de l’UMa. 4 Facultés • 3 Grandes Écoles • 6 Unités de Formation Doctorale • + 40.000 Étudiants • Science-Sagesse-Service;637;228;2368;398;3631
Trashboard1;Hal 9000;;1271;1201;48;1111;3631
TooF_31;TooF31;;949;702;51;1921;3623
PierreSerkine;Pierre Serkine;#Energy #Industry #Innovation #ClimateChange #EU #EP #GreensEFA #Utopia #Dystopia #PolicyMaking;1990;363;310;956;3619
CERIEC_ets;CERIEC;Centre d’études et de recherches intersectorielles en #économiecirculaire de @etsmtl En continuité de l’Institut EDDEC qui a complété son mandat en 2020.;1110;308;1331;870;3619
JeanHabel;Jean Habel;Directeur Québec - Canada atlantique à l’Association canadienne de l’énergie renouvelable (CanREA) | Député de Sainte-Rose 2014-2018;464;562;1696;893;3615
CERMA_UL;CERMA;Le CERMA est un centre de recherche consacré au développement et à l’étude des matériaux avancés. Il est soutenu par l’Université Laval, le CQMF et le MEIE.;600;213;211;2590;3614
GontranMain;wall°ich;"Player of sax, tuyo, computer, video, photography, video & synthesized images…

in knowknowing more about :
artitoo.free.fr";3206;119;75;211;3611
SophieBellon;Sophie Bellon;Chairwoman of the Board of Directors and CEO of @Sodexogroup, an independent French company that brings #QualityofLife services to the world;557;524;1940;589;3610
HadjMgr;Kemetic Warriors;L'Afrique doit s'unir ou périr!;2179;79;57;1290;3605
sufcaUBO;Formation Continue et Alternance - UBO;Formez-vous tout au long de la vie à l'UBO. Chaque année, nous accompagnons + de 7000 projets ! Vous en avez un ? Contactez-nous : 02 98 01 63 32;1881;355;547;819;3602
yoannesquis;ESQUIS Yoann;;2966;218;347;71;3602
kizu_tsuita;Lunaed;;3303;175;17;105;3600
SilverPLM;Silver PLM;;3137;13;33;413;3596
stephrider;Stephrider;Amusé désabusé, motardo-geeko-sportif, prêt à rire de tout et à pleurer du pire....;2729;234;33;597;3593
JFInsights;JFInsights;;2608;123;98;761;3590
Panarchisme;AUBIN Patrick;Libertarien;641;202;34;2712;3589
EmergencyOng;ONG Emergency-Africa;#DSSR, #Genre #Environnement #Entrepreneuriat, #Education #Economies numérique et verte #Culture #Développement durable.;320;1168;1050;1050;3588
AffaireBNP;L'Affaire BNP;Ensemble, contraignons BNP Paribas, la banque la plus polluante de France, à stopper ses soutiens au développement des énergies fossiles ! #AffaireBNP;305;297;2622;362;3586
LERURAL2;LE RURAL Officiel;#Média #digitale/ Groupe de #Presse spécialisée en #agriculture, #environnement #élevage. Production #audiovisuelle /#publireportage #charteGraphique #Journal;1674;274;511;1126;3585
LilianeMassala;Liliane Marat Massala;"Ambassadeur, Haut Représentant de la République gabonaise près la République française et Représentant du #Gabon auprès de l'OIF.
#diplomatie @GaboninFrance";271;165;2218;918;3572
GHalbout;Gilles Halbout;Professeur des universités en mathématiques - Recteur de la région académique Centre-Val de Loire, recteur de l'académie d'Orléans-Tours;687;475;1044;1364;3570
NainMangeable;Nain Mangeable 🫕🍳;Gamertag : Nain Mangeable;2382;148;14;1026;3570
KBouqartacha;Fun&Flow;J'aide les coachs business đ et non business đ avec Fun & Flow đ§ââïžâ€;533;601;231;2200;3565
yves_montigny;Yves Montignyð©ï¸;ð©ï¸Fier papa dâune fille de 20 ans. Fier Nord-CÃ´tier. ð DÃ©putÃ© de la CAQ dans RenÃ©-LÃ©vesque. Ancien maire de Baie-Comeau.;585;471;751;1756;3563
martinusGG38;Buttler gerard;Intéressé par la connerie des autres mais surtout par l'étude psychologique des personnes qui disent n'importe quoi.;3107;20;5;428;3560
harichemourad3;hariche mourad;"reunement abstrait autour. 
buts. Stabilité 
Échanges spécifiques. reconnaissance. connaissance. permet. appropriation. consolidation 
activités. mobilis.innova";3497;42;11;9;3559
mzouareg;ZOUAREG Mabrouk;;1029;51;50;2427;3557
HeleneCruyp;Helene Cruypenninck;Adjointe à l'Environnement et à la Nature en Ville @Angers #LaREM #Horizons #5ansdeplus Changement climatique, déchets, vélo, voyages, stargazing...;731;332;831;1656;3550
Haaaaank2;Haaaaank;;351;579;31;2589;3550
abelbxl;Eric Pauwels;mais pourquoi j'aime tant le café?;2212;120;21;1194;3547
OPEOConseil;OPEO;Par les transformations que nous accompagnons, nous promouvons une industrie compétitive, durable, humaine et résiliente.;1955;377;325;890;3547
Thibaud_F3rry;Thibaud Ferry;"Vulga scientifique des sciences cognitives et psychologiques.
La psycho politique c'est cool. Metalhead.
linktr.ee/thibaud_ferry";1470;105;111;1860;3546
JaafarHeikel;Jaafar Heikel;Professeur de Médecine et Économiste PhD Epidemiologie PhD Économie MBA management et finances;1202;78;2246;17;3543
JPLamarcade;J-Philippe Lamarcade;"Directeur RĂ©gional d'Enedis en Bretagne. đĄđ

Suivez l'actualitĂ© d'Enedis sur le compte @enedis_Bretagne. 

#ServicePublic #ElectricitĂ©";1153;386;869;1131;3539
clesdusocial;Clés du social;Être utile aux acteurs du #dialogue #social, dans l’entreprise et dans la société et apporter des éléments de culture sociale aux non spécialistes.;2092;113;335;998;3538
PineAppleJuke;Manda'Lo'Riz1;Chassé de la comté par la peste verte;226;116;9;3184;3535
BrulerJohanne;Johanne brûler;;2180;132;26;1197;3535
jeavolcy;Jean Ronald VOLCY;je suis le béni de Dieu.....;1515;1334;225;459;3533
hilelus;Hilal;"Expert in #SafeCities #SmartBuildings. Studied #SmartCities at @EcoledesPonts.
My passions? Innovations & technologies that can help people all over the world.";2026;718;131;656;3531
7_1_5_12;Modus Ponens;;2768;24;12;726;3530
Francois_GUEHI;François GUEHI;;1008;92;12;2414;3526
lindavallee30;Linda Vallée;Vielle assumée, un peu intello, amoureuse des enfants, des chiens et de l’urbanité.;558;191;41;2734;3524
JPierreColin;Jean-Pierre Colin;Vice-Président de @maregionsud en charge des finances - 1er Adjoint au Maire à #Laseynesurmer - Membre du bureau politique #LesCentristes;1082;262;983;1194;3521
Suzanne7986;Suzanne Belliard;;276;46;16;3183;3521
medi_Irathen;Mehdi;"It's time for a social paradigm shift.
ⵣ
Design, Technology & Policy

Amawtiyen, iquerεiyen Isnaṛexiyen";1366;569;143;1440;3518
Victoriadevigne;Victoria de Vigneral;Staff @GroupeID_FR | Présidente du groupe @RNational_off des @paysdelaloire;920;501;951;1145;3517
cover_michel;micov;« Si ce que tu veux me raconter n’est ni vrai, ni bien, ni utile, je ne veux rien savoir »  Socrate;737;1359;73;1343;3512
Jdbouk1;Jédbouk;nomi!! JE NE PERDS JAMAIS. SOIT JE GAGNE, SOIT J'APPRENDS.;347;1082;310;1771;3510
Le_Grand_Defi;Le Grand Défi;Une initiative participative inédite qui fédère les acteurs économiques pour mettre en place un modèle durable pour tous ! #Climat #Biodiversité #Entreprises;918;961;607;1022;3508
vidmizer_france;Vidmizer I GreenEncoder;"Réduisez le poids de vos vidéos de 70% en moyenne sans perdre en qualité !👏
Diminuons ensemble l'empreinte carbone ! 🌍

#GreenTech #greenencoder #Frenchtech";771;1288;1043;401;3503
bernard_volk;bernard.volk;"Alpipro B2B  stations ski -
Digital Montagne B2B solutions digitales marketing touristique 
#DIGI2018 #innovation #digital #montagne #digitalmountainawards";2229;338;493;440;3500
Jegard_Creatis;Cabinet Jégard Créatis;Jégard Créatis Expertise-comptable Commissariat aux comptes, pme & économie sociale et solidaire. International / Prime Global;1404;783;580;733;3500
VGbeffan;virgile gbeffan;"#Senior Technician in Crisis Management and Hydroclimatic Risks|#Water| #Climate|#Change and #Environment.
#Activist #SDG";70;2798;541;91;3500
JeanLessalle;Jean Lessalle;Turbo Libéralisme et Accélérationnisme - Contributeur @RageCultureMag;803;213;1220;1257;3493
canope_56;Atelier Canope 56;"L'Atelier Canopé de Lorient.
Réseau de #formation des #enseignants. 

#NumériqueEducatif #proximité #pédagogie #Education #Numérique #Innovation #médiation";1892;269;1028;302;3491
maxencedelardus;maxencemeunier;#agriculteur, #agroforesterie, #ACS, #perdrixgrise, élevage de pur-sang arabes, Conseiller Régional @regiongrandest;1191;216;307;1775;3489
reveil_marmotte;Le Réveil d'une Marmotte;Maman, investisseuse en herbes, qui ne dort plus assez, je partage ma prise de conscience, mes investissements et d'autres choses !;1318;354;487;1329;3488
sduhamel357;Stephanie Duhamel;Directrice des affaires publiques @RTE Hauts-de-France #servicepublic #transitionenergetique #Energie #électricité ⚡️#culture 💷 #solidarité;1173;525;303;1483;3484
edd_besancon;EDD Ac-Besançon;"Education au Développement Durable - Académie de Besançon
#EDD #ODD #reseauxEDD #education #developpementdurable";2127;316;661;380;3484
BlandeauJasmin;Jas';"22 yo | Laval / Nantes |
Business Student";610;156;26;2691;3483
lionelcml;CQFD;A chaque fois que je vois une ambulance ou un camion de pompier sortir je me dis qu'une vie va être sauvée avec mes impôts. ça fait chaud au coeur.;1163;28;11;2280;3482
Elias_Begriche;EliasBegriche;đ QUI SUIS-JE ?  J'accompagne depuis + de 15 ans les entreprises dans leur stratĂ©gie de dĂ©veloppement IT et intĂ©gration de progiciels de gestion (ERP, CRM, BI);2777;133;36;534;3480
AulagnerGuilla2;choucroutegarnie;;3050;89;15;325;3479
VilleMontigny78;Ville de Montigny-le-Bretonneux;Bienvenue sur le compte Twitter officiel de Montigny-le-Bretonneux ! Restez à jour sur les nouvelles locales, les événements et les activités dans notre ville.;1119;43;1614;696;3472
EricSe;Eric Seulliet;Président de La Fabrique du Futur;1794;680;919;74;3467
BeFC_fr;BeFC - Bioenzymatic Fuel Cells (BeFC);Réinventer la manière d’alimenter les appareils électroniques de basse puissance pour un avenir durable. Together, #PowerTheFutureWithNature 🌱♻️💡⚡️;1656;350;416;1045;3467
sthilaire1946;LOU GRAND G.G.;;1942;78;19;1427;3466
BouakeOfficiel;Bouaké Fofana;Compte officiel du Ministre de l’Hydraulique ,de l’Assainissement et de la Salubrité .Pdt  du Conseil  Régional du Worodougou Avant#DG à AGEROUTE puis à SICOGI.;382;137;2843;100;3462
JL4Kouassi;Dr. Jean-Luc Kouassi;PhD in Climatology and Environmental Management;1108;967;385;1000;3460
__Sasquatch___;Sasquatch👣🔞;;641;293;86;2439;3459
DeplanteP;Pierre DEPLANTE;;829;85;33;2511;3458
grivallain;Rivallain;Journaliste au Courrier Picard;2025;405;998;28;3456
CliffordC_FR;Clifford Chance Paris;Suivez l'actualité de Clifford Chance Paris, cabinet international d’#avocats d'affaires | #Informations, avis d’#experts et points de vue.;1928;237;756;519;3440
DominiqueLaud;Laud Dominique;"Présidente Départementale USEP 17
Vice Présidente Ligue de l'enseignement 17";479;81;73;2806;3439
PNRMartinique;PNR Martinique;Le Parc Naturel Régional de la Martinique PNRM assure la promotion et la valorisation des patrimoines naturel et culturel de Martinique.;400;557;2436;45;3438
243Top;TOP 243 NEWS TV & top 243 news.com;nous sommes un médias généraliste qui, traite des informations de la RDC et le reste du monde entier avec toute impartialité sans complaisance toute en r;1732;857;346;501;3436
AbeilleColombe;Avenir meilleur;;602;230;18;2583;3433
KerrelMbou;KERREL MBOU;"young passionate about #Green_entrepreneurship, #business #agriculture ! business and social entrepreneur 
#together_for_a_green_world ð¦";590;204;157;2480;3431
mmiklz;Mzt;;2822;89;23;497;3431
G15Plus;G15+;Leaders des domaines sociaux, syndicaux, environnementaux et d’affaires au Québec. Unis pour une société solidaire, prospère et verte.;1188;568;1015;656;3427
AFVGroupe;AFV Groupe;Groupe AFV situé à #Cannes #LaBocca #Grasse et #Peymeinade. #Assurance #Professionnels #Entreprise #Prévoyance #Retraite #MMA;1519;724;212;971;3426
PedicartEnergy;Pediacart Energy;"Renewable Energy Literacy

Solar Farm-Wind Farm-Geothermal-Hydroelectric-Biofuel
Sustainable-Company-CSR--Immersive-Diversity and Inclusion";2302;580;150;385;3417
xenothera;XENOTHERA;French biotech that develops innovative treatments such as #XAV19 against #covid19 🧪🔬 #biotechnology #immunology;929;1161;1028;298;3416
Karl_Chretien;Chretien Karl;;1989;57;48;1322;3416
JohanitoWamytan;WAMYTAN Johanito;From #Kanaky #New-Caledonia đłđš- passionnĂ© de #gĂ©opolitique et de #gĂ©ostratĂ©gie du #Pacifique Sud - #environnement #OcĂ©anie. Mes tweets n'engagent que moi.;1529;603;914;368;3414
Bosco_974;S. J-Marie đšđ”;Fier de son histoire, de sa culture, fier d'ĂȘtre FranĂ§ais !;2344;54;25;988;3411
thomas_annee;Thomas Année;🔑 Canal Telegram TA - CryptoGen 🗞️ Invest - News Économique - Crypto-actifs - Dev personnel 📩 blinq.me/eu97oIbHYPlUKl67iK4…;1089;121;352;1847;3409
Cmo351;Cmo35;Je suis un troll j'ai qu'un seul abonné 😜 (famille) tu me suis je te bloque tu me retweet et tu n'aime pas mon tweet même sanction;1999;22;1;1386;3408
Lapizza57134427;Lapizza;Mal pensant;1637;76;22;1669;3404
EVE_Transport;EVE Transport et Logistique;Porté par @ADEME, ce programme combine progrès avec la Charte et valorisation des résultats avec le Label. #transports #environnement;1618;275;1166;344;3403
le_gouv;Aubaine Mbantshi Coffre-fort d'Etat (LeGouv);Avocat, observateur et analyste politique;396;358;176;2471;3401
ami_nace;Nacime.A;Moi c’est moi;3227;85;49;38;3399
BujinHare;Hare Bujin;;1257;73;10;2058;3398
Ohmythug;Efil4zaggin;Le seul et l'unique!!!;65;52;11;3269;3397
SGeodesix;Satellix Geodesix;Un des derniers docteurs d'État;2506;31;26;834;3397
AizeLauna;AizeLauna;;1609;209;18;1556;3392
paulf_13;Paul ð«ð·âï¸;ð62/13 #politique #sport #art;295;89;19;2989;3392
dangue_sacko1;Dangué Sacko🇲🇱;Malien 💯 qui dit se qu'il pense du monde 🌍;453;821;96;2019;3389
EstawSouth;Estaw 🇲🇦🇩🇪;Ich liebe Karate und deutsche Autos;1173;140;19;2057;3389
SDE35_;SDE35;Syndicat départemental d'énergie #illeetvilaine #electricite #energie #eclairagepublic #servicepublic #EnR #TransitionEnergétique #SmartGrid #mobilité #GNV;1306;489;1094;496;3385
MurielGuidoni;Muriel Guidoni-Deregnaucourt;Membre de la team @Energy_Observer #energyobserverfoundation @EODev ms aussi @IndustrieFrance @PFDMedias. Egalt passionnée #littérature #culture- Compte privé.;1273;481;113;1516;3383
Jzero31;J031;;3070;192;19;100;3381
ENSC_Bordeaux;ENS de Cognitique;L'ENSC est une école d'ingénieurs de Bordeaux INP spécialisée dans les domaines du facteur humain et de l'intégration Homme-système #Cognitique;1910;166;1167;134;3377
REQMontreal;REQMontreal;Le REQ est un réseau d’acteurs ancrés dans le territoire montréalais à l'origine de projets de développement durable, d’implication citoyenne et d’ERE.;1645;1123;524;83;3375
aeros_wing;C.A.W;;2537;28;6;804;3375
mariecmolnar;Marie-Claude Molnar, PLY;#Paralympian interested in making sports more sustainable | Environmental sustainability | Never stop being a seeker đŠâ»ïžđ„Ÿ;2074;289;478;533;3374
Herve_Bailly_Fr;Herve Bailly Safran;"Purchaser at Safran
#Safran #Aeronautique #Casting #Fonderie #Forging #Forge #Machining #Additive #Inovation #Environnement #Rafale #Dassault #Boeing #Airbus";1690;1306;154;223;3373
BillardPaulin;Paulin;Chargé d’Affaires Agriculture au Crédit Mutuel secteur Nord Yvelines #IHEDREA;821;854;250;1444;3369
francois_granet;SOS-La vie sur terre;Le sport (vélo, marche nordique   randonnée..).;1432;63;50;1822;3367
AgmsSarl;AGMS-Consulting;#AGMS est une Startup marocaine active en Développement d'Affaires à Haute Valeur Ajoutée, Green-Tech ainsi qu'en Innovation Digitale et Fin-Tech.;603;1253;174;1332;3362
CNE_Emballage;CNE_Emballage;Autorité morale pour le meilleur de #emballage #packaging #recyclage #innovation dans le cadre de #développementdurable et protection de #environnement;1139;436;1100;686;3361
14ps02;Rodney C;;2277;209;46;828;3360
DiplomatieParl;Diplomatie Parl;Compte officiel pour des renseignements sur les activités diplomatiques des parlementaires canadiens. Avis : ow.ly/E1H030bHrk0  EN:@ParlDiplomacy;2087;35;1235;0;3357
Tremblay_Jun;Junior Tremblay;Chercheur scientifique  @environnementca #ornithologie #forêtboréale Research scientist @environmentca #ornithology #borealforest;1110;258;446;1541;3355
impact_sante;Impact Santé;Conseil, formation et #Prévention en #SantéPublique à #Bamako #ImpactSanté est un acteur de la #PromotionDeLaSanté au plus près des populations;684;636;638;1397;3355
cathy09792112;cathy;"un jour je suis née et depuis ....j improvise .
Pire que le bruit des bottes, le silence des pantoufles.";954;52;17;2330;3353
SyDEV_85;SYDEV;Syndicat Départemental d’Energie et d’équipement de la #Vendée : #Électricité #Gaz #Éclairage #MobilitéDurable #EnR #Numérique #SmartGrid #TransitionÉnergétique;1272;153;1307;619;3351
NoelYadoho;YADOHO Noël;;3017;115;66;152;3350
LumaWakan;Luma Wakan;Rechercher le Beau, le bon et le Vrai !;3156;32;49;112;3349
Ramil0ne;Ramil0ne;;1003;1980;22;341;3346
Bob05899943;Bob;;1944;21;13;1365;3343
GMarivint;Gilles Marivint;Ceux qui lisent en diagonale, répondent de travers...;1035;168;73;2067;3343
francoz95;Francoz;Fier d’être Français, fier d’être Européen (pour faire évoluer l’Europe pour les peuples), fier d’être sur cette belle terre.;3125;31;5;178;3339
AssogbaOliver;simple boyðð§ð¯;Demsðð¿, gros bÃ©bÃ© Ã  sa maman ð¥², l'enfant du bledð§ð¯â¤ï¸, amoureux de la bouffe ð¤ð¿ð¥¹, l'Ã©cologie une passion ðð;979;465;279;1614;3337
ArnCollignon;arnaud collignon;"#Energie #Climat #Logement #Territoire #Economie Ã  @Canopea_be
Mais c'est mon compte personnel. ð";1853;372;654;457;3336
NlanduJosue;josué Lelo;À Kin commentateur sportif à CPtv, ingénieur social en RDC. Journaliste sportif au média en ligne Leopard Sport Afrique et journal des 9ème de la Francophonie;443;576;172;2145;3336
PatNaturo;leroy patrick;naturopathe holistique;1734;76;23;1496;3329
LabessTN;Lab'ess;"Le Lab’ess, premier incubateur tunisien 🇹🇳 de projets à impact social et environnemental. #ESS #TunisiaImpact
Membre du @Pulse_GroupeSOS 🌍";1203;1164;618;340;3325
FrancoisVnk;François Vaneeckhoutte;"Journaliste @CheckNewsfr

En formation @ESJLille / Ingénieur @CentraleSupelec / Cycliste à mes heures perdues";181;354;218;2571;3324
KarineBoivinRoy;Karine Boivin Roy;Députée d’Anjou-Louis-Riel ⚜️ | Adjointe gouv. des ministres de l'Emploi et de la Métropole | Avocate 👩🏼‍⚖️ | Photographe 📷 | Ex-Conseillère de ville à MTL;552;349;870;1552;3323
Fondation_PGL;Fondation Paul Gérin-Lajoie;La Fondation Paul Gérin-Lajoie contribue à l’amélioration des conditions de vie des populations par une éducation de qualité.;977;724;726;891;3318
christianVASSE;christianVASSE;;3131;79;57;50;3317
CosteEmilie;Emilie Coste;Journaliste @Contexte, écrit sur l’environnement 🌱. Ex @LaLettreA.;404;1680;768;462;3314
swift_xcode;Any language we know;#nothing #crazy;1534;1210;72;485;3301
phrenel;Phrenel;Create better moments in this world. 🚀 Head of @hugmify  🎧 Podcast Huggerlife;2392;162;254;493;3301
CNO_Radio;CN'O;"Bienvenue sur CN'O...La #radio 100% Hainaut ! ð
ð Radio de #Valenciennes, #Maubeuge et #Cambrai pour la Radio NumÃ©rique Terrestre DAB+ ð";2334;385;326;255;3300
DAmoursMath;MathDAmours;Amateur d'histoire, de géopolitique, de voyages, de bon temps.;388;111;15;2786;3300
CanadaJamaique;Canada en Jamaïque;Le haut-commissariat en Jamaïque - English @CanadaJamaica - international.gc.ca/mediasso…;2338;140;723;97;3298
Afro_Comment;AfroComment;Defending Africa against Western Imperialism, FCFA, WARS, Exploitation, Propaganda, Terrorism. and Fighting for a Free, United, Respected  and Prosperous Africa;2548;164;33;551;3296
Adrien88Lambert;Adrien Lambert;"Avocat (qui aime l'objectivité)
Papa (un peu fatigué)
Social-démocrate (assumé)
Supporter du Matricule 4 (Allons Lidje)";353;103;32;2808;3296
FOUNDMYDOMONDO;MYDOMONDO FOUNDATION;Official account of the MYDOMONDO FOUNDATION;428;1919;631;316;3294
NkurunzizaMose4;Nkurunziza Moïse;Journaliste au Le Renouveau du Burundi, travaille dans les domaines #social, #politique, #coopérat,#Economie, #justice, #TIC, #médias, #VBG, #santé et #sécurité;1354;186;348;1406;3294
EpopoYanick;Epopo yanick;Tout est grĂące de Dieu đđŸ;1447;240;152;1455;3294
Sylvain68429285;Sylvain;Freelance Content Writer / I love Africa / Rwanda my roots / Tweets are all in my name;3041;151;59;42;3293
wellannnn;Wellan;"Je lis pour passer le temps donc je passe mon temps à lire.                                           
instagram.com/wellan_book";830;649;38;1776;3293
IAENancy;IAE Nancy School of Management;"L'IAE Nancy est une école supérieure de #management située au cœur de l'espace européen #administration #management #RH #international #EspritIAE
@univ_lorraine";1311;178;758;1041;3288
ctcpa_cti;CTCPA - Centre Technique Agroalimentaire;"Accompagner le modèle agroalimentaire de demain
#recherche #innovation #devdurable #industrialisation #nutrition #microbiologie #emballage #conseil #formation";1950;426;669;241;3286
indecosacgt65;Indecosacgt65;"Association de défense des consommateurs, locataires et usagers
#conso #logement #consommation #défensedesconsommateurs #oph #cgt #tarbes #lourdes #65000";410;1950;402;523;3285
VVesqueJeancard;VVesqueJeancard;Pdte Railways & Dir Airports @VINCIConcess + BM @MuseeOrsay @MuseeOrangerie @atout_france @LesCrisdeParis @OAOstinato @AmisMuseeCluny #Culture#Voyage#Humanité;1891;259;560;575;3285
DjikkeMedia;Djikké Média;"Site web d'actualité

💯 Follow back in 24h 🕛";112;1251;1112;807;3282
LeVillagebyCAAP;Le Village by CA Alpes Provence;Get news on a daily basis about international #entrepreneurs working hard for an #inclusive and #sustainable future & living the dream @thecampProvence;1022;582;829;849;3282
RCFcotedazur;RCF Nice Côte d'Azur;"RCF Nice Côte d'Azur - 
La joie se partage en DAB+ dans le 06
Mobilisez-vous pour votre radio chrétienne: radiodon.rcf.fr";2207;236;321;513;3277
RupturEcoBleue;RUPTUR;L'association RUPTUR travaille sur la création concrète d'une économie basée sur les opportunités environnementales et la transmission aux jeunes. #blueeconomy;941;580;1124;630;3275
paulineflot;Aurelie Foltz;professionnelle de la culture et de l'ESS #culture #politiqueculturelle #Ess #scop #association #cooperation #Europe #educpop;1139;394;125;1617;3275
lefttera;LE LI;;655;409;32;2178;3274
LyonDecideurs;Lyon Décideurs;Le mensuel des pouvoirs lyonnais.;1210;311;1731;21;3273
pafle_chien;paf le ouaf;Quand on voit ce qu'on voit, on a bien raison de penser ce qu'on pense !!;2193;86;42;952;3273
LaoufiSaber;Laoufi-Saber Rachida;"Maire-Adjointe Saint loup sur semouse (70800 Haute Saône)

Vice-présidente Association Maires Ruraux Haute-Saône ERRE

Conseillère communautaire CC Haute Comté";341;689;174;2068;3272
Aldo_Blast;Aldo Blast;"Dans un monde ou règne la propagande, la vérité est toujours une théorie de la ""conspiration""";1485;193;118;1476;3272
j360info;J360;"Trouvez vos futurs #appelsdoffres près de chez vous et partout dans le monde. Find #tenders near you and all over the world.

#tenderalert #tendertracking";2246;260;250;513;3269
JeanPansu;JeanP;Européen français météorologiste;1821;30;21;1395;3267
MuzuriPatient;Patient Luhembwe Muzuri;Analyste politique • Libre penseur • Cadre @PNEC_RDC • Délégué marketing @OCC_RepDemCongo • Licencié en Relations Internationales (Pô. internationale) @UPN_RDC.;1072;235;568;1390;3265
Aliens_Society_;ð½Alien's Societyð½;"ðAcadÃ©mie du web2 / web3 ð¨âð
ð£AMA le vendredi 21h FR des projets  ð«ð·
ð¤DM openð¤";613;1270;387;991;3261
Hippalectryon__;Hippalectryon;Passionné d'investissement & finance 💰 | Explorer les opportunités pour un avenir prospère 🚀 | Partage d'astuces et d'analyses pour vous aider à réussir 📈;1941;83;140;1096;3260
MassacreParis;Massacre Paris;Revue de la destruction des faubourgs et anciens villages de Paris;1153;374;168;1565;3260
BurundiOnu;Le Burundi aux Nations Unies (New York);Compte officiel de la Mission Permanente du Burundi đź‡§đź‡® auprĂ¨s des Nations Unies Ă  New York | Official account Permanent Mission of Burundi to the UN đź‡şđź‡ł;865;13;1460;918;3256
jeanmarc_bergia;Bergia Jean-Marc;"ð«ð· Maire de #Saubens, 
ð Cadre de santÃ©, DiplÃ´me Universitaire de la douleur et d'Hypnose MÃ©dicale #CHUdeToulouse #HauteGaronne #amf #ARS";822;265;240;1928;3255
CrestUmr;CREST (UMR 9194);Center for Research in Economics and Statistics, joint research unit of @ENSAEParis @Ensai35 @Polytechnique and  @CNRS;1094;252;1281;627;3254
RSEsenegal;RSE senegal;Promouvoir la Responsabilité Sociétale d'Entreprise (@RSE) au Sénégal et en Afrique de l'Ouest;1641;609;531;472;3253
anjuna2lime;Anjuna;"Salarié agricole 👨🏻‍🌾🐮🌌
Jersiaises ❤";2204;380;49;620;3253
KhalidAmg_;Kimaro 🥷🇲🇦;Rojoula mn Tofoulaa 🫡;1330;85;47;1788;3250
NoventaPatatas;Petit dictateur choupinet 🇷🇺 🇺🇦;Qui l'a élu, connasse ?;2535;90;27;598;3250
jevousemmerde13;compte second fefedemars;ne le 21/12 jour national de l orgasme;2186;173;74;816;3249
nicolasroques39;Nicolas Roques;Ingénieur Formateur indépendant. Il est possible de vivre en consommant beaucoup moins et en étant aussi heureux sinon plus.;1521;134;78;1515;3248
MondialeDes;Organisation Mondiale des Peuples Unis OMPU;"New World System
-R&D
-World Agreement Light(WAL):+8 milliards/habitants-Meilleur Avenir!
-KONBITOCRATIE,Unité,Vision,Konbit lumière,Progrès,Droit,Devoir,Paix..";1104;2075;57;9;3245
The_Betz;The Betz;;1896;334;37;977;3244
ClaireCa38;Claire Calladine;Ppale Vaillante, SMH #education #perdir #Cpeforever Mes tweets n’engagent que moi;253;507;297;2187;3244
DuteilMyriam;Duteil Myriam;;689;323;141;2086;3239
LapierreCpc;Lapierre Nathalie;#ExpertComptable diplômée de l'Eslsca associée de CPC société d'expertise comptable #création #innovation;2027;143;164;902;3236
LestonEric;Charles ERIC 🚢🧼;I'm just a one trick poney;1607;685;88;856;3236
MarcDjandjiCFA;Marc Djandji, CFA;Founder of ASEAN Strategy Group.  Follow me on @ASEAN_Insider #ASEAN #investment #frontier. #craftbeer enthusiast and partner at #pasteurstreet;1462;1018;687;61;3228
IlEtaitUneFoi1;Ilétait Unefoi...;Adepte de la remise en place de celles et ceux qui vivent dans leur bulle;3088;8;10;114;3220
essamayenezou;Essa Maye;;2529;97;21;573;3220
et_gentil;Gentil et Mignon;"Ici on respecte la fragilité de Jean Michel Droitard ! compte de secours d'un vilain Putride qui serait  bloqué par Twitter

@SgtPestilence@kolektiva.social";1695;71;22;1432;3220
xrDLP;xDLPx;croire à l`impossible;660;129;33;2397;3219
jpm_lagny;Jean-Paul MICHEL;Maire de @villedelagny. Président de l’agglo @marneetgondoire;1473;286;1140;319;3218
AB82376506;A B;rien;1428;48;4;1738;3218
sam_le_juste;Juste Sam;Taiseux, j’aime bien vous lire, surtout quand vous êtes percutants, sauf quand vous ne supportez pas les coups;1210;159;21;1827;3217
reggio_tours;je pamphle, donc je suis! ou la raison d’abord !;;1636;78;28;1471;3213
diesse_kat;Diesse Kat;Aucune patience pour les larbins du système qui défendent la corruption de l'esprit;1758;127;50;1276;3211
Ecureuil122;GNSA Bois de Vincennes;;1276;267;317;1345;3205
etoilucie;palala;biographie issue de l'AB;1586;156;44;1418;3204
Serrier192;Maître Po;J'essaye d'exprimer un semblant de pensée, dans le peu de lignes que me laisse Twitter et cela en dépit de la bien-pensance et des mouchards sans arguments !;2273;113;65;746;3197
ArchiMalakoff;Architecte Malakoff;Promeneur observant la ville et architecte dessinant projets.Ici, je tweet #Malakoff  ✌️🙂✌️;417;141;217;2414;3189
jeunedragon_;La tête dans les étoiles 🐍🌟;;1159;181;8;1839;3187
Sibirieau3;Sibiri ny đź‘€;"LONG LIVE MALI LONG LIVE PEACE IN AFRICA.
PAN-AFRICAN. ANTI-IMPERIALIST.
FREEDOM IS MORE IMPORTANT THAN LIFE.

NB: đź¦» I RESPOND TO INSULTS WITH INSULTS đź‘Ś";1980;71;64;1072;3187
Loowwh;Lowh;Géologue, Géotechnicien ⛰️ 🥷🇫🇷 @atleti;1219;165;20;1782;3186
goCPAatlantic;CPA Atlantic School | CPA Atlantique;Exercise more options. Become a CPA. | Experimentez l’embarras du choix. Devenez CPA. #CPA;1703;357;697;428;3185
eluEs_ACLT;Élu.e.s Amiens c'est l'tien;Groupe des élu.e.s Amiens c'est l'tien - Élu.e.s d'opposition - Ismaël Bara, @evelyne_becker, François Décavé, @julienpradat, @emilietherouin, Fabien Voulminot.;2562;166;329;127;3184
AllaniOmar3;Allani Omar;Persévérance;866;227;20;2070;3183
lolo_loulou12;alcide pierdeux;Plan B;1653;49;16;1464;3182
MondeEconomique;Monde Economique;;3108;6;68;0;3182
Christo0626;Christo0626;;1058;51;9;2063;3181
Chennevieres_94;Mairie de Chennevières-sur-Marne;Compte officiel de la Ville de Chennevières-sur-Marne;2191;492;411;85;3179
Du2234073338;du22;réactif,imaginatif,démocrate;2578;322;62;217;3179
Gothmog92;~ Nico ~;Jusqu'ici tout va bien...;2417;301;21;439;3178
jogmaak;Alex Stgl;Gauchiste, geek, campagnard, pêcheur, chasseur, cueilleur, jardinier rêvant à l'auto-suffisance;1578;175;40;1384;3177
FranckPettex;Franck Pettex;;2563;453;82;77;3175
Mandalore_Minh;Mandalore Partners;"Mandalore Partners │ Corporate Venture Capital-as-a-Service
#VCaaS #CorporateVC #VC #CVC #CVCaaS";2522;205;325;123;3175
FibresEnergivie;Pôle FibresEnergivie;Pôle de compétitivité des matériaux et du bâtiment durables;1316;274;1045;540;3175
the_froggy_;@The_Froggy;Tolérance et respect sont les armes pour des débats éclairés.;2551;483;52;89;3175
Gilbert63184198;Gilbert Raymond;;2724;95;18;337;3174
lamberet_sas;Lamberet SAS;Lamberet est LE carrossier Européen spécialiste des véhicules frigorifiques. De 1 à 100m3, du véhicule utilitaire à la semi-remorque.;792;932;459;987;3170
nasdaq2;JesMah;Ne pas mourir de son vivant !;1400;512;50;1208;3170
JBarnerias;Fumier;;2137;153;140;735;3165
mukudiwamukudi;Wa Mukudi;Economiste;927;1463;279;490;3159
irwin_teariki;Irwin TEARIKI;Auteur-compositeur, cinéaste, entrepreneur, découvreur des 100 chiffres universels, activiste maohi, indépendantiste et LGBT;935;475;25;1723;3158
BismuthPaul4;Bismuth Paula;"Documenté, mais je ne prétends pas savoir tout sur tout. 
Non dogmatique.
En quête de dialogue dans ce panier de crabes.
Je peux me tromper. Toi aussi.";2539;338;53;227;3157
MDesjonq;Mathilde Desjonquères;Députée de #loiretcher | Conseillère Municipale de #Blois Groupe Libre(s) | Conseillère Communautaire #Agglopolys | #parité #patrimoine #transitionécologique;1154;239;361;1402;3156
Vreue;Healing room;Spirituality | Psychology | đ§đ»ââïžđš;950;43;1218;943;3154
barrymbobo286g1;Mamadou Bobo Barry;Public Policy Intern I Multilateralism and Diplomacy I Peace and Security-MPRG to the @UN;274;1964;102;814;3154
BIO_UV_Group;BIO-UV Group;Fabricant đ«đ· de systĂšmes de traitement de l'eau par UV, Ozone, AOP & Ă©lectrolyse de sel pour #piscines #aquaculture #aquarium #eaupotable #reuse #BallastWater;1025;358;880;884;3147
Th3raphosa;Wrath;"ð¦ ð¦ð¦   ð¦      ð¦ 

Random Sapiens
De - en - dÃ©pendant du systÃ¨me, mais pas des humains";1320;404;25;1398;3147
Abdel_Sadi;Abdel Sadi;Maire de @villedebobigny Conseiller départemental délégué à la coopération internationale du conseil départemental de @seinesaintdenis;1620;313;1100;111;3144
Himmelsturmer13;Uhu;;2538;68;15;519;3140
TPoulinier;Thierry Poulinier;Soif de justice;3086;16;6;31;3139
ginpel;ginpel;;2366;119;11;642;3138
trafougne;Trafougne;ah oui... les homosexuels (hommes et femmes) ont gagné le droit de vivre comme tout le monde. Si tu n'es pas d'accord, va mourir ! je te pissaladière.;2642;37;13;442;3134
Ozion12;Ozion;;1514;50;21;1547;3132
CarinePapy;Carine Papy;Vice-Présidente Conseil Départemental Conseillère Municipale Cagnes Délégation Économie et Emploi - Vice-Présidente de la CAF 06 - Chargée de Mission  U2P06;1827;126;559;617;3129
Gripic_Celsa;GRIPIC (Celsa – Sorbonne Université);Groupe de recherches interdisciplinaires sur les processus d’information et de communication (UR1498), affilié au @CELSA_Officiel (@Sorbonne_Univ_);323;1424;1103;279;3129
MichelLeboeuf6;Michel Leboeuf;Recherche la vérité au dela de la version officielle !;1744;64;17;1304;3129
Julienderville;Julien derville;"Passion for sport, nature & innovation.
Founder of Ekip (Ecological Meal Voucher)";528;1016;282;1296;3122
wrahain;Rahain William;Chargé d’étude Stratégie et Innovation chez @Teréga. #neutralitéCarbone #P2G #H2. Mes tweets n’engagent que moi.;617;305;95;2097;3114
thomaspouilly;Thomas Pouilly;Journaliste pigiste @TETUmag - @similiqueer_ - Televidilo đ âą Genre - LGBT+ đ - MĂ©dias đș - SociĂ©tĂ© âą Poissons, ascendant maroilles. âïž;2764;125;126;99;3114
servanleguern;servan le guern;délégué concessions Sud-Est  #GRDF - Gazier;1440;406;669;589;3104
AnneTallineau;Anne Tallineau;Secrétaire Générale de @ofaj_dfjw;1011;298;940;853;3102
EDC_RDC;Compassion_for_DRC;đź‡¨đź‡©Only about Congo issues !;280;44;20;2756;3100
ademe_NA;ADEME Nouvelle-Aquitaine;Bienvenue sur le compte de l'ADEME en Nouvelle-Aquitaine, l'Agence de la Transition écologique. Actualité régionale, dispositifs, presse & retours d'expérience;992;334;434;1338;3098
CApparail;Côme Apparail;;2130;38;9;916;3093
Politika_web;Politika;Le politique à l’épreuve des sciences sociales #recherche #valorisation #actualité #entretiens #bibliographies #ateliers @LabexTepsis @EHESS_fr;643;306;1523;620;3092
Pailhes;Domaine de Pailhes;French Red Wine 2010 gold medail of Councour de Lyon domainedepailhes.fr/;690;1850;438;107;3085
Bekri922;Joyboy ☀️;🇫🇷🇲🇦;1458;60;13;1550;3081
Pierre_Labbe_;Pierre Labbé;Moteur de première main, 47 km, bone etat, pas de frais a prévoir, contrôle technique ok, boite de vitesse neuve;2970;17;13;76;3076
fredericlaurin;Frédéric Laurin;Professeur d'économie, spécialisé en développement  local, en commerce international, et économie du vin au Québec. Analyste économique.;1666;491;688;231;3076
BachirDiop18;بشير,;📩#journaliste&sportif ⚽️🏟️ 🎓#journalisme&communication. ⚽️un esprit sain dans un corps sain#🎙️;1148;251;543;1133;3075
foudulabo;Foudulabo;;1992;137;30;914;3073
jaddrdcongo;Jeunesse Acteur du Développement Durable;"La JADD est une ONG qui propose des stratégies de développement économique ; en vue d’impacter par la réduction de la pauvreté, chômage, et la corruption.";188;1627;1114;142;3071
ter_cha;Ter;Y'a ceux qui réfléchissent de l'intérieur et ceux qui ne font que refléter la doxa des merdias. Ter;1703;140;27;1201;3071
JeanneSotter;SOTTER Jeanne;Auditeur comptable @BT_STREGO. Conseillère municipale @nantesfr et membre du Bureau Métropolitain @NantesMetropole #PRG;911;185;302;1670;3068
leroyanto;Antoine LEROY;;918;193;118;1839;3068
katiatechnik;Katia Pecnik;"Journaliste généraliste, trie les déchets. Justice sociale et esprit vert
Retweets : mainly endorsement, mais parfois ironie.
alerte.kesselmedia.fr";1342;615;159;947;3063
randomie7i;Prophète Issud Sekour 🕋🏳️‍🌈🇩🇿;Nabiun.e déconstruit.e🔻• Prière éco sociale ♻️ Pour une Islam progressiste : que les voies d’Allah soient pénétrées ☪️ • Elie/they ⚧️ • 5 vaccins par jour 💉;1280;101;48;1633;3062
La_FOHM;La Fédération des OSBL d'Habitation de Montréal;La FOHM rassemble plus de 250 organismes communautaires en habitation sur l’île de Montréal. Pour des logements de qualité, abordables et sains pour tous.;1218;293;475;1076;3062
josuemuleli01;Josué Muleli;Journaliste Professionnel/Animateur RTV/Social Media Manager/Community Manager/Chercheur en communication/Blogueur et Entreprenant.⤵️🇨🇩;645;552;389;1472;3058
DauphineMost;MOST (DRM/Dauphine);Équipe de recherche critique en management, théories des organisations et comptabilité du laboratoire @DrmDauphine @Paris_Dauphine @psl_univ • UMR 7088 du @CNRS;877;368;662;1150;3057
ly67174944;KBL;;754;451;28;1816;3049
etangavelo;MDB IDF Étang-la-ville;L'antenne de l'Etang-la-Ville qui promeut le déplacement à vélo et plus (trottinettes, piéton...);580;87;58;2323;3048
entpe;ENTPE;Fil officiel de l'école de l'aménagement durable des territoires;1110;167;803;967;3047
visant_dessins;Visant;"Dessinateur de presse taquin pour le Journal Sud-Ouest et auteur BD quand ça me prend.
(Retweets encouragés, repost/modifications interdites sinon je mords.)";1128;127;1167;625;3047
AureganYves;Yves AurĂ©ganđ»;"Directeur de recherche au CNRS Ălu municipal EELV sur la liste ""Angers, Ă©cologique et solidaire""";1342;218;689;797;3046
simon_toulouse;François SIMON;"Une solution flexible pour l'amélioration de l'organisation.
Une délégation de tâches au profit de l'amélioration continue de votre entreprise";2224;407;115;298;3044
gpican;Guillaume Pican;Executive Director Europe PageOutsourcing #Recrutementsurmesure #PageOutsourcing | Ambassadeur #Essec | #KAM #MFNHLF #experienceclients #ClientExperience;831;472;348;1392;3043
ryoki56585173;Investisseur Débutant (Ruo);"investisseur débutant qui a commencé au pire moment (fin 2021) en Apprentissage
2023 : value + Small Midcaps + Chine pour ma part";1599;222;119;1103;3043
AmethSaloumNdi3;AMETH SALOUM NDIAYE;Principal Country Economist, African Development Bank Group (AfDB).;772;445;38;1784;3039
StanBreizh56;Stan;Attachiant,stressé de la vie,impulsif,grognon,très con mais tellement mignon et pas méchant 😉 (enfin ça dépend 😝) soyez asocial vous ne serez pas déçu!;940;51;90;1957;3038
estar821456002;estar;Je sais que les mots ne guérissent pas toujours les blessures profondes;513;2202;71;249;3035
Christo97328860;Woke Killer!;"Jpp de ce monde de dégénérés ou on force des gens incompatibles a vivre ensemble et
ou la cancel culture devient la norme!";753;146;12;2123;3034
CNano_national;C'Nano - CNRS;Unité du @CNRS dédiée aux Nanosciences l C’est plus de 7000 acteurs scientifiques 👩‍🔬 👨🏿‍🔧 qui font avancer la #recherche #nanosciences #nanotechnologies;937;269;926;901;3033
Piikachu_2;@Leena_Chou;;617;48;15;2353;3033
FDSavoie;Fac-droit-savoie;Faculté de droit de l'Université Savoie Mont Blanc;1743;82;461;746;3032
CharlesPokrywa;Charles Pokrywa;Salesforce - I use Twitter to be informed and to learn #Sustainability #Energy #Digital #Data #Innovation;626;66;65;2275;3032
loic_rousselle;Loic Rousselle;La nature et la prospérité pour tous !;1005;125;599;1302;3031
MyAfricaInfos1;MyAfricaInfos;Myafricainfos.com pour la promotion des #Africains. #Entrepreneurs #Artistes #Écrivains #Sportifs #CultureAfricaine #Afrique;1581;581;495;372;3029
NomadiaGroup;Nomadia;Nomadia propose des solutions dédiées à la gestion des activités commerciales CRM SFA et à l'optimisation des interventions techniques et des livraisons;1771;141;717;398;3027
Lazare2423;Lazare;ð¢ C'est en explorant les idÃ©es de chaque individu que nous trouvons l'intÃ©rÃªt qui rÃ©side en chaque Ãªtre humain ðï¸;1701;146;128;1052;3027
marguerite_NTE;marguerite de Nantes;La voiture qu'on m' partager ! Voiture autopartagée en Libre-Service 24h/24 à Nantes. D'une minute à une journée, quand je veux !;2502;83;346;94;3025
eau_tg;Ministère de l'eau et de l'hydraulique villageoise;;404;67;2091;460;3022
BouillaguetN;Bouillaguet Jean-Noël;"Chairman at France Spectacle Aérien (FSA) - French Air Display Association / European Airshow Council (EAC) Board Member 
Air Shows must go on !";620;93;67;2240;3020
fournier65;Antoine Fournier;Citoyen français. Promoteur de @laRentSociale, mes tweets engagent les générations à venir ... Adhérent @RSouveraine;1760;731;319;209;3019
bldthomass;Tot's;Master's student in Marine Biology passionnate about deep-sea ecology, especially deep-sea fish 🐟;599;54;23;2340;3016
BeachleL;Béachlé Lebon;Délégué Syndical CFE-CGC, site tertiaire et R&D Stellantis à Poissy;1629;93;119;1175;3016
NetRempart;Le Remp@rt.net;Site web d'actualités en temps réel;2722;93;47;153;3015
MaxMbe;Ngo Mbe Maximilienne;"Woman Human Rights Defender 
Executive Director REDHAC 
HUMAN RIGHTS DEFENDERS NETWORK IN CENTRAL AFRICA 
Focal Point Ong Forum 
Board of AfricanDefenders";369;1135;1325;181;3010
zoomluc_lulubec;isuma;explorer;2023;324;43;619;3009
OnusidaHaiti;ONUSIDA HAITI;L’ONUSIDA mène l’action à l’échelle mondiale pour mettre fin à l’épidémie de sida comme menace de santé publique d’ici à 2030 dans le cadre des ODD;893;495;594;1025;3007
XBeulens;Xavier Beulens;Directeur de cabinet recteur délégué ESRI RANA  • Conseiller @CESERHdF • ex @UPJV • ex président @lafaep;755;512;284;1451;3002
danet_ida;ida;;720;76;25;2181;3002
FellaMcTony;Fella Tony;#nafo;2671;32;13;281;2997
Vivien_PI;Vivien P;social worker;970;805;159;1062;2996
PhilemonNgameni;NGP Philémon 💪🌎🗺🇨🇲🤲💪;Masters 2 en logistique de transport🚚🏗🚐 B'da kwen$/&💪🙏🥳🙏h;974;69;71;1880;2994
tinokyano;Bob;Un citoyen, data analyst, data scientist.;1206;66;8;1714;2994
HMassenet;Hubert Massenet;;2729;19;21;224;2993
MTEDDMAROC;MTEDD وزارة الانتقال الطاقي والتنمية المستدامة;Ministère de la Transition Énergétique et du Développement Durable | Ministry of Energy Transition and Sustainable Development;854;29;2086;23;2992
SebastienGras;Sébastien Gras;Colonel - Directeur départemental  SDIS 28 - compte personnel;750;255;535;1451;2991
Olivier_pseudo;Olivier;;2946;18;9;18;2991
PrynsLanders;Prince Manye;Économiste de formation, Assistant à l’université, Conseiller de la clientèle entrepreneur et Analyste financier;1374;1125;424;67;2990
SoniaVerrier;Sonia Verrier;Anti antispéciste. No woke. No cancel culture. Je respecte l'Humain. sinon Macron rame dur.;2111;122;64;693;2990
ReparateurLe;Le réparateur fou;Réparation et pointage des absurdités de construction des objets du quotidiens.  Écologie, vélo, etc.;1181;84;14;1707;2986
TIESSOLT;TIESS;Organisme de liaison et de transfert en innovation sociale #ÉSS #innovationsociale #developpementterritorial;985;480;1060;460;2985
Demimolechatbi2;Demimolechatbite;;1563;110;3;1304;2980
LesPandasRoux;Les Pandas Roux;"Média qui prouve que d'autres histoires sont possibles.
#écologique #solidaire";960;443;294;1283;2980
vpxavier;Xavier Hang;CEO & co-founder @4INCH: a belgian company behind @snugr_official// Maried & father of 2 boys // Fan of new technologies // Chronicler @lesTechnos;1838;529;344;266;2977
Aema_Groupe;Aéma Groupe;Groupe authentiquement mutualiste de protection français, œuvrant auprès de +11M de personnes. @Aesiomutuelle @MacifAssurances @AbeilleAssur @Ofiinvest;587;182;1614;592;2975
johannol;JohannOL (eureux) đđđđČ;"IntĂ©ressĂ© par les sciences/ technologies, l'Ă©nergie & climat, et tous les moyens de rĂ©duire les Ă©missions de CO2
Et aussi @Johannol@mastodon.cipherbliss.com";1426;147;40;1359;2972
G_A_Servant;Gwenaël Servant, Ph.D.;"Board Member @ Abolis Biotechnologies 🧬 
Venture Partner @ Medevice Capital 🩺 
Aviator on weekends ✈️";2374;442;145;10;2971
PetfoodReviewFR;Petfood Review 🐕🐈🥫;"ASV team nutrition,
Activiste contre le bullshit marketing en petfood,
la gamelle c'est la base.
#nofakepetdiet";656;94;1228;992;2970
RMagonza;Quantum;Ceo and many other things.;584;10;13;2360;2967
SimonPaulBangbo;Simon Paul Bangbo Ndobo;professeur - observateur international - self made man;2819;1;128;18;2966
chevagui;Guillaume Chevallier;"#Teacher at French-German School, #Freiburg, Germany đź‡«đź‡·đź‡©đź‡Şđź‡¬đź‡§đź‡Şđź‡ş 
Organiser of #12at12ForThePlanet
Presentation of ESD projects at 12:00 am in 12 minutes.";1180;299;234;1252;2965
Aspiownyou;Aspio;;2358;126;29;450;2963
urbs_onb;U.R.B.S;La donnée géographique au service des transitions énergétique, climatique & sociale des territoires • observatoire-national-batime…;708;566;488;1200;2962
BeretNoir1;Beret Noir;;2001;114;12;829;2956
louevepopper;Lou-Eve Popper;French journalist //#Environment & #Economy - Back in France after 3 years in Bonnie Scotland @AlterEco_ @Reporterre @mdiplo @Vert_le_media;548;1057;557;792;2954
h2_mobile;H2-Mobile;Site d'information dédié à la mobilité #hydrogene #fuelcell;2073;49;749;82;2953
Groupeism1;Groupe ISM;Groupe d’enseignement supérieur leader et pionnier en Afrique de l'Ouest (Management, Ingénierie, Droit et Science po Relations internationales) !;616;214;1701;418;2949
dm_petit;Damien-Morvan PETIT;Startuper @BYB_Team đ / @nu_solide | engagĂ© @clubensemble1.;1217;178;142;1412;2949
BillyMargueron;Billy Margueron;"(il/lui) Dépolitiser le réel, c'est le repolitiser au profit de l'oppresseur.
Membre du CN du @PCF, sec fed du @73PCF, membre de @FieresEtRevoPCF #PCF #Lgbti+";862;1059;827;193;2941
HeliceFranck;JohnSmith;toute personne souhaitant s’abonner serait bloquée automatiquement ce qui serait dommage.;1805;429;1;706;2941
WRasayi;Wora Rasayi;;2453;1;8;478;2940
JoshMpotoyi;Josue Mpotoyi;"- Mari et père, SME advisor, Administration des Affaires; -Expert Électoral🔴⚪";1135;389;239;1175;2938
ThieroTidiani2;Mali ð²ð±;lâAfrique;848;360;140;1589;2937
vanessamilewski;Vanessa;Accompagner les entreprises dans leur transition vers un modèle durable #engagementcollectif #impact #economiedurable;1093;957;402;485;2937
DenayaMichel;DENAYA Michel;licencié en Droit de l'Université de Kinshasa . Actuellement, avocat;636;1225;629;447;2937
RangamaVirginie;Virginie Rangama;Pas de principes. Mais des valeurs.;1166;39;34;1698;2937
DesperateAmelie;non_mais_oh;;937;206;14;1778;2935
SCroisieres;Stop Croisières;Collectif de citoyen-nes qui dénoncent l’aberration écologique et sociale de l'industrie des croisières ⛴️❌;562;139;1554;678;2933
PosoccoN;Nicolas Posocco 💉💉💉;"Mes MPs sont ouverts, je ne suis pas ennemi du colloque ! Mais, me direz-vous, si on parle pour ne rien dire, de quoi allons nous parler?

Eh bien, de rien !";784;324;93;1731;2932
FaroukJazzedup;Ankh;cool;1688;262;27;951;2928
rahmani38930641;Raidan;Pour que la France reste la France.;1307;537;192;886;2922
LaurenceCristol;Laurence Cristol;Députée de l’Hérault #Renaissance  Médecin onco-gériatre ICM;829;455;1127;509;2920
agricolegilles;AGRICOLE GILLES;Chargé de cours de stratégie de patrimoine  Gérant de SARL;1812;286;323;491;2912
cegepduvieuxmtl;Cégep Vieux Montréal;Le cégep du Vieux Montréal (CVM) est un établissement d'enseignement collégial offrant 52 programmes, profils et options. #cvm #cegepduvieuxmtl;359;222;2306;25;2912
echosdedavid;David Germain;Father / Programmer / Photographer / Board game enthusiast;190;243;18;2459;2910
Mahamat_25;Mahamat 🇹🇩;Pour une Afrique unie et prospère .Panafricanisme, anti impérialisme.;557;579;69;1705;2910
AkonoPierre3;Sir Akono;"Ma morale, c'est profite, mais ne te tais pas. Je suis de droite à la base.
Ma raison est à droite, mais mon cœur est à gauche.
Cadre dans la Banque.";2644;157;76;31;2908
KambemboRoy;KAMBEMBO ROY Johnnyta;Climate Justice & SustainableDevelopment activist🇨🇩|Organizer of #FossilFreeVirunga_campaign @350.org | Project and program manager of @MjpeRdc |entrepreneur.;504;358;469;1575;2906
sophiepiard;Sophie Piard;Journaliste cellule Planète @France2 @France3 @FranceInfo. S'intéresse à la 🌍 et ses habitants en essayant de rester zen. Née en 326 ppm.;1114;309;1199;279;2901
Agate_agence;Agate Agence alpine des territoires;"Agence experte du développement et de l’aménagement territorial, de la gestion des collectivités et de l’assistance à maîtrise d’ouvrage
#collterr #savoie";1005;202;390;1302;2899
Dayto63;Dayto;;1514;195;21;1169;2899
nguene_paul;paul steve nguene;;280;1170;82;1366;2898
Amaury_Dufay;Amaury Dufay;ð°Space analyst @IESD_Lyon3 / ð° New Space technical and economic stakes, Capability dynamics, Space history, Space simulations / â Atomic propulsion advocate;640;460;194;1599;2893
UriopssOC;UriopssOccitanie;700 structures adhérentes, Représentation - Conseil - Formation - Accompagnement des Secteurs #Sanitaire, #Social, #Médico-Social;1965;191;706;29;2891
Ecoyako_;EcoYako;"Média écolo indépendant et engagé 🌍
Pour plus de climat dans les médias ➡️ bit.ly/371tOZw";1168;501;233;986;2888
j0ga_;J0ga;#Acheter au son du canon vendre au son du clairon...;2645;38;26;173;2882
no1xbt_;Nox ⏳;"Hard times create strong men
Futur Quant trader & Not the good guy.
I'm no one.";1449;59;68;1303;2879
FredJacquot75;Frédéric Jacquot;Comédien, Metteur en scène, Producteur et Diffuseur de spectacles vivants - Adjoint au Maire du 15e de Paris - Chargé de la Culture @Nouv_Energie;695;252;300;1630;2877
RavRom47;romain ravelle;;832;17;10;2017;2876
Demoniak999;Demoniak999;;1308;55;18;1493;2874
sabri_khadafi;Sabri Khadafi;;1114;107;5;1648;2874
Comm_MTL;Commissions de MTL;Les commissions permanentes ont pour mission d'éclairer la prise de décision des personnes élues et de favoriser la participation citoyenne aux débats publics.;747;539;1566;19;2871
TheWomensVoice1;The Womens’s Voices;🔈Faites entendre votre voix ! #women #5000Voices Media fondé par @Cynthiaillouz. Lauréat @GoogleNewsInit .;1121;696;315;739;2871
PresidentBOAD;Président de la BOAD;@ekuese Président de la @boad_official, Banque commune de #financement du #développement des 8 Etats de l’@UEMOA_Officiel #AfriquedelOuest -Compte pro;365;2;2473;26;2866
PatriceG_3M;Patrice Guionnet;"Chargé de mission #EnergiesRenouvelables à @Montpellier3m
#EnR #Photovoltaïque
#TransitionEnergétique #BoisEnergie #CadastreSolaire 🚲☀️";457;743;305;1361;2866
dariusRitshi28;Darius  Ritshi;"Expert en diplomatie et Stratégie
- Formateur 
- Entrepreneur
- Humanitaire
- Encadreur
- Chrétien engagé
- Conférencier";573;1747;342;203;2865
collectifHBM;Collectif HBM Paris;"Les habitants des immeubles ""briques rouges"" réclament des travaux utiles et défendent la ventilation naturelle, gratuite et écologique #VMCgate";2073;533;193;65;2864
Yessine_FAGE;Yessine Jelassi;Membre du Conseil National de la Transition Ecologie & Chargé transition écologique à @La_FAGE / Étudiant à l'EUP 🌍🌱, né à 370ppm;191;362;303;2006;2862
michael_betemps;Michael Betemps;Tweet about #programming, #agile, #startup, #technology, #innovation | Tolkien fan | Lived 8 years in China;859;456;104;1442;2861
LozTantor;Tantor;"Vert de rage, rouge de colère - Pastèque insoumise
Militant d'@attac_fr";686;175;23;1976;2860
ValBourdeau_MM;Valérie Bourdeau (on/elle/she);On jase changements climatiques et développement durable à MétéoMédia 🌎💚;547;335;95;1881;2858
MarocvWeb;Marocv Web;Retrouvez l'actualité du web, nouvelles technologies sur Marocv.Com;2839;7;6;3;2855
rezolatibonit;Rezolatibonit;Politique et sociale;899;962;985;8;2854
ag_kokouvi;KOKOUVI AGBODEKA;Retired US ARMY, Combat vet Activist fighting for justice and freedom in Republic of TOGO and Africa. Speak French and English.;879;499;450;1026;2854
ZoreilleBourse;Le Zoreille;"L'actionnaire préféré de ton actionnaire préféré. On apprend ensemble ! 
+20000€ investis en bourse";1107;24;624;1097;2852
dutot7;dutot;;2776;37;5;34;2852
VD89069134;V D;To be continued;1459;229;26;1137;2851
LIFEONGfr;LIFE ONG;Ensemble aidons les plus démunis ! Forages de puits | Distributions de repas | Plantations d’arbres | 1€ 1 REPAS | Éducation;1488;175;451;731;2845
gorjema;Jean Marc G;;2472;10;17;339;2838
MiraouiOfficiel;Abdellatif Miraoui • عبد اللطيف ميراوي;"وزير التعليم العالي و البحث العلمي و الابتكار• المملكة المغرب
Ministre de l'Enseignement Supérieur, de la Recherche Scientifique et de l'Innovation • Maroc";439;4;2383;12;2838
LE28FEVRIER;DESOBEIS;LE SOULÈVEMENT DES OBÉIS;1791;277;216;552;2836
HCP_Le_Plan;Haut-commissariat au Plan;Le HCP est chargé d’animer et de coordonner les travaux de planification et de réflexion prospective conduits pour le compte de l’Etat | @bayrou;416;267;2125;25;2833
NoCarAndre;André;Je ne troll plus les pirates. Même si j'en ai vraiment envie.;1873;67;24;868;2832
MTL_Presidence;MTL_Presidence;"La présidence du conseil est une instance neutre, impartiale, gardienne des valeurs démocratiques de l’hôtel de ville.
La présidente du conseil est : @musawu_m";880;347;816;781;2824
JDuplantain;Jean Duplantain;;1130;35;6;1652;2823
tniderlender;Thibaut NIDERLENDER;Chef de Corps-Directeur Départemental SDIS 79 / Compte personnel n'engageant pas l'administration;898;400;593;931;2822
sannibio1;sanni bio;Sanni BIO.  Coordonnateur U-report Djougou.Défenseur des droits des filles et femmes, Activiste, coordonnateur départemental du programme Acteurs de Changement.;1053;431;310;1028;2822
CamilleAkoaP;Philippe Camille AKOA;Compte officiel du Directeur Général du @FEICOM1/ Ambassadeur HE For SHE/ Ambassadeur de la Nutrition.;860;424;1288;246;2818
H4rryHaller;H4rry Haller;Si l’homme n’est pas assez raisonnable pour se diriger lui-même, il l’est encore bien moins pour diriger les autres. Émile Chapelier;1567;72;60;1116;2815
VicGranier;Victor Granier;Urbaniste OUQ - Montréal - Francoquébécois 🇨🇦🇫🇷🏳️‍🌈 - Au service de la résilience urbaine et du GeniusLoci #transitionécologique #patrimoine #mobilité;454;1249;232;880;2815
benjvanpet;Benjamin van Peteghem;Pour une société plus juste et plus humaine;903;407;79;1424;2813
Lephenix_91;Lephenix91;;1087;465;782;477;2811
dguveta;Denis guvenatam;"Écologue, universitaire, chef d'entreprise, responsable associatif
Mes twitts n'engagent que moi.";1391;531;188;701;2811
lithobird;Lithobird;Bonjour;768;286;9;1746;2809
rouault_etienne;Etienne Rouault;"Maire de #Champhol
Conseiller Départemental d'#EureEtLoir
#Chartres #CChartres";1169;355;177;1108;2809
MMoussaouiomar;O M;;65;156;23;2564;2808
endalead;Enda Lead Afrique Francophone;Member of Enda Tiers Monde network~Inspiring leadership for a sustainable world~Based in Senegal and Francophone Africa since 2001;658;436;906;806;2806
Lucas_Verhelst_;Lucas Verhelst;#Architecte-urbaniste | Fondateur du think tank LUSEA ð, un #laboratoire d'#idÃ©es sur le #sol et la #transition rÃ©unissant des experts issus de plusieurs pays.;302;1949;448;106;2805
CLGJFERRYHYERES;collegejferryhyeres;Compte officiel du collège / Communication réalisée par le chef établissement;737;440;585;1043;2805
Ahmed_Elshookey;Ahmed Elshokey | مصمم جرافيك;"Logo & Brand identity designer.

Have an awesome project?

👉Available for work
📧 elshokeya@outlook.com
📧 elshokeya@gmail.com
WhatsApp: +201006516922";204;1389;1117;91;2801
michael_dansi;Michael DANSI ð§ð¯;"Youth Mayor of DJIDJA |
U-Report Coordinator of DJIDJA |
Climate and environment activist| Youth Civic engagement |
Human Rights Lawyer |
Project Manager |";410;1236;411;743;2800
elusGsCLF;Élu·e·s Génération·s Clermont-Ferrand;Groupe des élu·e·s Génération·s de la ville de Clermont-Ferrand et à Clermont Auvergne Métropole;609;451;402;1338;2800
CarolDeschenes;carol deschenes;enjouĂ©;2484;13;6;294;2797
TerriAVivreS;Territoires à VivreS;"""Territoires à VivreS"" expérimentation interassociative pour un accès digne à une alimentation de qualité (Secours Cath, AssoVrac, Civam, Ugess, Réseau Cocagne)";669;148;290;1688;2795
YogaSamtosha;Paris Jeannie;;376;12;15;2388;2791
P_Guillemard;Philippe GUILLEMARD;Député @Renaissance de la 1ère circonscription de Meurthe-et-Moselle | Commission des Affaires étrangères @AN_AfEtr | Commissaire aux Droits de l'Homme;382;875;910;621;2788
Fah_SMS;Bo Faha 🙌🏾;On parle avec franchise tout en respectant autrui 🤌🏾.;1668;180;177;763;2788
BenjMaxime;Maxime BenJ;"Aimé ce qu'on ne verra jamais deux fois.

Loved what you'll never see twice";841;128;35;1774;2778
visintini_marco;Marco Visintini;"Siemens Industry Software - Italy 
Enterprise Sales - Senior Account Manager";2491;52;31;199;2773
Killerj0ke_;Killerj0ke;""" Il est plus facile de soulever mille hommes en s'adressant à leurs préjugés que d'en convaincre un seul à l'aide de la logique. "" Bisous ❤️";2448;60;23;234;2765
lllouness;lllounes;đŹđŹđŹ;623;245;69;1826;2763
Simon10775972;Simon;Papa de 5 merveilleux enfants et marié à une femme formidable. Je jase de tout et de rien mais toujours dans le respect.;1336;36;17;1369;2758
Maiourinature;MaiouriNature Guyane;Association de Protection de l'Environnement et de l'Homme en Guyane française.;855;270;1144;488;2757
AQICQC;Association québécoise de l’industrie du cannabis;Représenter l’industrie québécoise du cannabis et contribuer de manière constructive et responsable à son développement.;1184;462;326;779;2751
Boiscom;Bois.com;"Bois.com est le site de référence du bois.
Découvrez le bois sous un nouveau jour à la fois innovant, étonnant, durable et design.";762;192;1636;159;2749
HelloPlanet_tv;HELLO PLANET;"Plateforme gratuite et indépendante qui permet de regarder des contenus inspirants tout en finançant des projets d'#ONG 🌺 
🌍 Instagram: vu.fr/n09u";1105;156;252;1233;2746
PierreYvesLux;Pierre-Yves Lux;Député Ecolo au Parlement bruxellois et au Parlement de la Fédération Wallonie-Bruxelles;315;927;794;706;2742
HippoAwards;The Hippo Awards;“Fighting climate change one private jet ride at a time”. HIPPO is a monthly award given to the most hypocritical climate activist. Nominate your hippo-crite!;2015;344;62;321;2742
Naveen97180;Naveen;Enseignant et humaniste, allergique aux racistes, xénophobes et haineux en tout genre qui sont la crasse de l’humanité… je suis curieux du monde…;1264;118;38;1319;2739
madeleinerouze;madeleine rouzé;call me chef Madeleine;716;191;18;1811;2736
Bils1974;Bil’s;Aerodynamic engineer by education, passion for history and a business partner in a technology innovation start up in Montreal, Canada.;1032;22;19;1663;2736
InstitutClimat;Institut climatique du Canada et 440 mégatonnes;"Principal organisme de recherche sur les politiques climatiques au Canada. 

EN : @ClimateInstit - @440megatonnes";1115;385;952;281;2733
MB_Agglo;Mâconnais-Beaujolais Agglomération;"Twitter officiel de Mâconnais-Beaujolais Agglomération (39 communes).
Retrouvez toute l'actualité et les temps forts de votre territoire, en live !";1964;203;428;138;2733
RadioSuplyChain;Radio Supply Chain RSC;Webradio d’information économique Francophone dédiée au secteur de la Supply Chain diffusée 7/24 et en podcast;2095;196;256;184;2731
NourOuedi;EL OUEDI NOUR;;1381;117;42;1189;2729
MiningNewsMag;Mining News Magazine;Magazine créé en 2007 pour les informations minières en français et anglais;1306;276;628;513;2723
Phototangoo;Photo Tango;;639;97;25;1959;2720
xirgonium;Caesar;I twitt, therefore I am;518;226;10;1965;2719
negroscopy;Negroscopy;Negro/BlackWorld - Scopy/Observation — Bilingual/Bilingue Series — Spreading of Sapiens - Ancient People — Diffusion de Sapiens - Peuples Anciens — Panafrican;1211;532;174;802;2719
steve_lehany;Steve Lehany;Politician, musician, singer, model, young leader from Dr congo and business analyst;1895;204;94;525;2718
ecoleiet;IET;L'IET, l'Institut des métiers de l'Environnement, propose des formations de Bac à Bac+5 répondant aux enjeux du développement durable et de l’économie verte;1307;85;935;388;2715
agathe_le_b;Agathe Le Berder;"Membre de la @cgt_tefp et de la direction de la @CGTCadresTechs
Porte-parole du collectif @nosretraites avec @regnosretraites !
lvsl.fr/tribune-jai-28…";861;506;747;599;2713
Eluscecplemans;Elu-e-s communiste et humaniste Le Mans Métropole;"Groupe des élu-e-s de sensibilité communiste et humaniste Ville du Mans - Le Mans Métropole
#LeMans #LeMansMétropole #PCF
Facebook : sensibilitecommunistelemans";946;487;259;1019;2711
btdvalentin;Valentin BERTRAND;"ðï¸  Journaliste radio Ã  @franceculture & @francebleuparis 
ð  Auteur du podcast ""Trafic"" pour @Mobilettre";117;2019;373;197;2706
MUSICBIZ_media;MUSICBIZ;"Business, économie, musique. 

#musicbusiness #musicindustry";1676;22;1003;4;2705
ExcellencyRach1;Excellency R. MAYANA 馃嚦馃嚜 馃嚬馃嚛 馃嚥馃嚤 馃嚝馃嚪;#Etudes_Expertise_Comptable #Collaboratrice cabinet d鈥檈xpertise #Ancienne SGA France Alzheimer 68 #Engagement_politique, #Eveil_collectif, #Developpement_local;1027;152;152;1374;2705
DieulefitMike;Ben Mouloud;;393;662;33;1616;2704
frame_tape;Frame;"Rewinding...
piped.video/watch?v=ArLX_5…                                                       
artist 2D/3D : instagram.com/p/CkYrdTEtHYY/";1581;76;15;1030;2702
van_alek6;Crypt'Alex;"Amoureux du Bitcoin, de la blockchain et de la décentralisation, je combat les idées reçues. Trading 💰 / Mining ⛏
npub12z6v34gqrwvrmwsutyshlgdnfg8y4a5f2z472pcf";1244;167;109;1182;2702
Officiel_SDIS28;SDIS28_Officiel;Compte officiel du SDIS 28, destiné à l'échange de contenus professionnels. En cas de besoin de secours d'urgence, composez le 18 ou le 112 sur votre téléphone.;538;30;1968;164;2700
CabinetGsell;Cabinet Christian GSELL;Votre cabinet d’expertise comptable à Haguenau est à votre service pour vous accompagner dans votre gestion comptable.;2515;52;128;1;2696
AN_CollTerr;Délégation aux collectivités territoriales;Compte officiel de la délégation aux collectivités territoriales et à la décentralisation de @AssembleeNat. #DirectAN #CollTerr #Territoires;209;62;2407;17;2695
kamel5962;Kamel⭐⭐;Conneries et critiques selon l'humeur...;1629;218;18;830;2695
FGlaziou;Franck Glaziou;;2583;19;3;90;2695
LocFranois10;Loïc François;;175;10;1;2509;2695
vendycien;l'architecte d'un Congo nouveau;Le courage saute parfois une génération, jeunes ! ramenons la splendeur et la grandeur à notre nation !;647;294;117;1631;2689
Inddigo_Durable;Inddigo;"Cabinet de conseil & d'ingénierie en #DéveloppementDurable 🌍 - Avançons plus inventifs !
#Déchets #Energie #Bâtiment #Mobilité #Biodiversité #EconomieCirculaire";1200;583;759;147;2689
theokwelians;The Okwelians;The Okwelians est un Think Do Tank de femmes et d’hommes désireux de promouvoir, par le leadership éthique, une culture d’innovation sociale au #Cameroun.;1521;90;829;246;2686
AuditeursGroupe;Auditeurs Associés;Cabinet d'expertise-comptable et d'audit - #conseil aux #entreprises et aux dirigeants Spécialiste du domaine #médical 💉💊;2048;415;192;30;2685
maria_maitere;MAITERE Maria;;2555;60;7;61;2683
SophiePrian;Sophie Prian;Hyperactive Mam auto entrepreneur trilingue ðâ®ï¸ððplus de site web;803;611;151;1117;2682
hocquard2;hocquard;;2556;40;11;73;2680
Bonventure65;Bonaventure Bondo;Climate activistð¨ð©|Founder and Coordinator of @MjpeRdc|Advocate|Organizer  #FossilFreeDRC Campaign| #AFRIKAVUKA @350Africa;716;323;511;1128;2678
sergemartin4;serge martin;;586;439;276;1376;2677
IlambwetsiP;Ilambwetsi Christian Pascal;Environnementaliste : Conservateur et protecteur de la nature, forestier , Homme politique de mon pays;651;680;207;1138;2676
pritpourdescons;onnousprendpourdescons;;496;1427;434;318;2675
ecosyndicat;Printemps Ecologique ✊🌱;Accélérer la conversion écologique par les élections professionnelles et les négociations collectives. Bâtissons le premier #écosyndicat de l'histoire !;605;352;1216;501;2674
ThomasChatelard;Thomas Chatelard;Reconcile #Humanitarians with #HR | now @HI_Federation | Octopodi_Conseil | tweets are my own | tweet also about IPCC and resources issues;572;350;93;1654;2669
HaegJ73710;Haeg jean;;1302;34;9;1323;2668
appelkivu;LAC KIVU (APPEL KIVU) asbl;"Association pour la Protection de l'Environnement du lac Kivu. Et les amphibiens

NOTRE LAC EST UN JOYAUX INESTIMABLE, PRENONS EN SOIN

appelkivulac@gmail.com,";1064;697;518;389;2668
RColaisseau;Olivier Colaisseau ن;Mairie de Chanteloup-en-Brie (77);668;238;320;1438;2664
WillBugya;Laurent DEMENE;;601;171;20;1872;2664
fxaimelecantal;fx m;;1066;132;103;1362;2663
CNEmbLuxembourg;Chinese Embassy in Luxembourg;Welcome to the official page of the Embassy of the People’s Republic of China in the Grand-Duchy of Luxembourg!;1823;31;560;239;2653
jbgagnoux;Jean-Baptiste Gagnoux;Maire @LesRepublicains de Dole , Vice président du Conseil Départemental du Jura;587;1061;484;520;2652
cdeacf;CDÉACF - Officiel;Centre de documentation sur l'éducation des adultes et la condition des femmes qui rend accessible les savoirs et savoir-faire du milieu communautaire.;563;776;437;876;2652
WacUtilityWater;WACSA;WASH  | Water Quality  | Food&Water | AgWater| WaterTech | Training |Consulting | Water Utilities;434;1043;210;965;2652
SchekinahE;Schekinah Ekuba;A étudié à l'institut facultaire de science de l'information et de la communication ( IFASIC Kinshasa/ Gombe);984;698;131;839;2652
lucas_mikaelian;Lucas Mikaelian;- Etudiant en Droit - Sportif - Politique - Adepte des tribunaux - ð«ð·ð¦ð²;56;1275;57;1262;2650
Masson5Francis;Francis Masson;J’aime la compétition, Mozart, Wagner, l’art italien, la voile, l’océan;2238;106;17;288;2649
Bellanca7;Bllc#14 ðŸ‡¨ðŸ‡µ;;1148;106;12;1382;2648
claudeval;Claude Vallières;;1484;407;133;621;2645
ulyssesjourney;ULIS;UI Designer Contractor;87;683;88;1785;2643
EEMCP2_AEFE_ZAN;Formation AEFE ZAN ð¨ð¦ðºð¸;Se tenir informÃ© des actions animÃ©es par les formatrices et les formateurs #AEFE dans le rÃ©seau d'Ã©tablissements franÃ§ais d'AmÃ©rique du Nord.;893;111;733;901;2638
wissmeryll;Wissmeryll;;2327;159;14;136;2636
BenjaminMendou;Benjamin Mendou;PhD Biotechnologie végétale : efficience, humilité et responsabilité;272;83;45;2233;2633
PACOLLOT;Pierre-Alain Collot;Enseignant-chercheur - Institut Champollion - Institut  Maurice Hauriou/ Université Toulouse Capitole;1196;293;243;897;2629
MoukalaUnesco;Edmond Moukala;Head of UNESCO Bamako Office;841;212;449;1126;2628
CioNord;CIO NORD ATLANTIQUE - MARTINIQUE;Centre d’Information et d’Orientation qui croit en sa jeunesse MARTINIQUAISE et crée des ÉVÈNEMENTS pour DIVERSIFIER ses CIBLES PROFESSIONNELLES.;1306;107;78;1137;2628
Oceans24cd;Oceans24.cd;Oceans24.cd est un média d'informations générales qui vous propose  la primeur de toute l'actualité en  RDC;508;712;1049;352;2621
ADECC_reseau;ADECC;Association pour le développement de #economiecirculaire et #collaborative @CCI49 @cci49_RSE @PLOHEZIC #mutualisation #entreprise #simple #collectif #performant;996;243;513;868;2620
Bratzindaclub;πΎππ§ππππππ£ π½ππ§πππ π;17;78;59;4;2478;2619
PatAmNocq;pɔoͶmAƚɒꟼ 🧪🔭☕ 🏳️‍🌈;"#TeamPhysique #TeamChimie
                            Espace,  frontière de l'infini...🪐                                   Mes (re)tweets n'engagent que moi.";1092;226;36;1260;2614
financialtime15;Préparer demain;"investisseur, entrepreneur, libéral, toujours en recherche de nouvelles connaissances en matière de marché et finance
#finance #investissement #bourse #marché";1727;464;260;162;2613
kara_moustra;Kara Moustra 🇫🇷🇷🇺;;1441;92;20;1058;2611
IGNES_FR;IGNES;"Alliance des industriels des solutions électriques et numériques du bâtiment présidée par @BenoitCoquart
#TransitionEnergétique #THD #SilverEco #sécurité";822;610;317;861;2610
VAUDOISAlexandr;VAUDOIS Alexandre;;1066;238;81;1222;2607
7Low__;7Low;"Ecosocialiste :-)

Eteigneur de télés polutantes du CROUS

Terroriste intellectuel";734;318;15;1538;2605
scout_ascci;Scouts Catholiques de Côte d'Ivoire - ASCCI 🇨🇮;l'Association des Scouts Catholiques de Côte d'Ivoire (ASCCI) couvre les 15 diocèses de l'Eglise Catholique de Côte d'Ivoire avec plus de 25 000 scouts.;845;375;1073;309;2602
EmmanuelCombet;Dr. Emmanuel Combet;PhD economics, chercheur, conciliation des défis écologiques, sociaux et économiques, coordinateur du programme de prospective @ademe;318;407;1394;483;2602
ROMAINCINTRAT;CINTRAT Romain;"Agriculteur02#Betteraves#SCOP#Lin#Fécule #Pdtconsommation#ventelocale #méthanisation
#bonsenspayan#agricultureraisonnée
ConseillerRégionTereos,  CETA de France.";438;367;1058;739;2602
cubag77;Cuba Presidency | G-77 + China;Cuenta Oficial Presidencia de #Cuba ð¨ðº del G77+China | Unity & Cooperation, driving force in the interests of the South;364;81;2086;70;2601
ZeroDechetRouen;Zéro Déchet Rouen;"• Association membre de @ZeroWasteFR • 🌱 • Pour une société #ZeroDechet #ZeroGaspillage • Tous nos liens ici:
linktr.ee/zerodechetrouen";1741;148;647;62;2598
Fred2476;Frédérick;"Climat, énergie  : il est urgent de créer une autre société plus équitable et plus durable.
Je bloque les covidiots et covido-flippés";1497;38;5;1057;2597
ThinkAndWrite03;NoOne 🇱🇧 🇵🇸 🇫🇷 ✈️☀️💕;"""Que celui qui veut faire bouger le monde se déplace d’abord lui-même.""Socrate. Je plébiscite aussi Alicia Keys, Damso, SCH et Kant. Paix sur nous.🕋🤍";681;142;58;1716;2597
RecamierP;Philomène Récamier;Coprésidente groupe @ElusEcolosLyon Adjointe @mairie3Lyon #culture #MJC #VieAsso;441;113;399;1642;2595
AfricFree;AfricForotto;"♦GÉNÉRATION TIC-TAC ✊🏿♦
Une GÉNÉRATION DÉCOMPLEXÉE. 
A cette minorité, nous leur promettons qu'ils feront face à des millions d'Assimi Goita.";2141;71;65;318;2595
Folgabgeo;Gabriel;Libéral et souverainiste car on ne peut pas être libre sans être souverain. Pour que les hommes politiques foutent la paient aux français;865;125;25;1579;2594
JacquesDally;Jacques Dally;;1473;22;8;1086;2589
m4wch;M.ð»;Ã chercher la vÃ©ritÃ© dans l'ombre du monde.;2240;153;16;176;2585
ousmane_madiba;Ousmane Madiba Guirassy;Juriste, Prépa Barreau, Paris2 Assas, Responsable idées jam75 zone Sud-Est, enfant de la République 🇫🇷🇬🇳;318;1166;246;850;2580
BouayeAvance;Bouaye Avance;Association citoyenne qui participe à la vie locale, et soutient la majorité municipale;1069;311;204;995;2579
JUAN_SNZ;Juan SANCHEZ Ⓜ️;● Délégué Départemental @RNJ_AIN;660;320;571;1026;2577
sebgrem;TalkTime App by Cabriio !;TalkTime l’appli des appels à durée déterminée, avec recommandation de contacts par IA intégrée ! Timing - Gaming - Green ! Let’s Talk, I’ve Time ! #sobriete;786;875;63;852;2576
Flashonline237;Flash_online;"Flash_online est un média web qui vous fournit les informations fiables et crédible, chez nous, c'est ""l'information d'abord""";249;1600;315;411;2575
DL_Niger;Délégation permanente du Niger;Compte Twitter de la Délégation permanente du Niger.;1573;58;293;649;2573
Laforet_Lyon4;LaforetLyon4;Une agence #immobilière forte de près de 20 ans d'expérience sur le secteur de la #CroixRousse dans le domaine de #Transaction, #Location, #Gestion. #Lyon;2385;102;80;0;2567
afederau;Alexander Federau;Conseiller en mobilité. Conseiller communal à Nyon. Dr en Philosophie et en Sciences de l'environnement.;984;860;247;469;2560
SDEEGironde;SDEEG33;Syndicat Départemental Énergies et Environnement de la Gironde #énergies #électricité #éclairagepublic #bornes #urbanisme #photovoltaïque #deci #pcaet;774;92;416;1278;2560
ghrmsa;GHRMSA;Groupe Hospitalier de la Région de Mulhouse et Sud-Alsace, principal acteur de santé publique dans le Sud-Alsace.  #ghrmsa #santé #alsace #hôpital;823;261;893;583;2560
KamondKissinger;Kamond Kissinger;Entrepreneur - Géopolitique - Trumpiste;2081;212;144;110;2547
enchencha2;enchencha;IHECE/JARÂ/;1498;281;167;600;2546
DaveMaydi;Dave Malcolm Jr 👑;Human rights activist 📚;1085;948;266;238;2537
The_S18_;The_S18;"Étudiant 
#TeamN26";2121;288;21;105;2535
RevolutionEnerg;Révolution Énergétique;Nous informons un large public sur les questions liées aux énergies renouvelables et bas-carbone. 📺 Nos reportages au cœur de la transition ⚡→ urlz.fr/k2qU;1318;16;1144;56;2534
BdT_AntGuyane;Christophe Laurent;Directeur régional de la Banque des Territoires Antilles-Guyane;251;280;1823;179;2533
Yanou020;Yannick 🇲🇨;Abonné à l’AS Monaco depuis 1990. Collectionneur de maillots portés (collection dans bio). Club Med Kemer Addict. Nouveau compte de @YannickEnzo06;725;754;478;576;2533
cajust_sn;Citoyens Actifs;Citoyens Actifs pour la Justice Sociale est une organisation citoyenne regroupant divers Mouvements Sociaux engagés pour la Justice Sociale;88;1816;564;65;2533
KadraKhaty;kadra Khayrbadan;Founder/CEO of Dwo'AGRO product🏭 Women entrepreneure, Committed to Djibouti Economically #Agricultural #Transformation #Djibouti #DamerjogFARM🌿;483;274;496;1272;2525
SanamaYves;Yves Sanama;;1802;215;19;487;2523
Luciferio124;Luciferio;Twitch Affiliate;1445;93;184;801;2523
MaccaArthur;Arthur Macca;;2266;115;2;137;2520
Arleneantoine14;1ère Dauphine Miss Burundi 2022;"1ère Dauphine de la Miss_Burundi_2022
C.E.O de Burundi-Nové
Auteur du livre Briser la culture du silence";278;41;1680;520;2519
bearnetpn;UCEPIERIC;Contre la fabrique du malheur. Soucieux de l’avenir de la France et de la planète.Horreur des extrêmes . Casier judiciaire : boomer, ingenieur🇫🇷🇺🇦;1276;228;39;974;2517
cabinetjacef;Julien Acard - Cabinet Jacef;Cabinet de coaching, de formation et d'accompagnement VAE créé en 2013, spécialisé en Management et Ventes-relation client. Nous sommes certifiés #QUALIOPI.;1098;406;91;920;2515
ENSIACET;Toulouse INP-ENSIACET;L'école d'#ingénieur de la transformation de la #matière et #énergie : 1000 #élèves, 4 #laboratoires, #Environnement #Santé #Transport #Ecoindustrie;1007;310;894;302;2513
RenaissanceUE13;Renaissance européenne Bouches-du-Rhône - 13;"Aux côtés d'@EmmanuelMacron, nous sommes engagés, dans les Bouches-du-Rhône, pour réformer et défendre une souveraineté européenne. 
Rejoignez-nous !";495;977;489;551;2512
agglo2b;Agglo Bocage Bressuirais;Compte officiel de la Communauté d'Agglomération du Bocage Bressuirais (33 communes / 75 000 habitants) en Nouvelle-Aquitaine, aux portes des Pays de La Loire.;1660;118;511;223;2512
ArthurimmoBearn;Arthurimmo.com Pau & Nay;Notre équipe d'#experts vous accompagne dans vos projets #immobilier: #achat #vente #location #expertise;2473;16;23;0;2512
LaMadeleine_49;Collège La Madeleine;Collège Européen, E3D engagement, Euroscol, Etwinning, Erasmus+, LCE anglais espagnol, bilangue angl-all, LCAlatin, section sportive excellence Hockey Natation;1588;72;578;269;2507
KAZEMBEJacques1;Laval;Licencié en Planification de Développement, spécialiste en veille humanitaire, chercheur en planification des urgences humanitaires. Animateur du MLS.;963;801;589;154;2507
DPalmer06597033;Arnold Ilanga;Ingénieur et Économiste en Pétrole, Gaz et Énergies Renouvelables de l’ unikin. Chercheur en Politiques Énergétiques des États. stratège et Consultant.;489;594;92;1331;2506
lfidublin;Lycée français d’Irlande;Eurocampus Dublin;1008;22;649;825;2504
chut78;Chris H;;2314;39;17;134;2504
AlexandreRos69;Rossier;Politique;1269;152;157;921;2499
Anton_pxt;Antonpxt;;531;829;7;1131;2498
LiliMar40109162;Lili Marlen;"Petit dans mon Peuple.
Grand avec lui.";2341;22;20;113;2496
StFeMarseille;Eglise Saint-Ferréol;;1607;43;133;711;2494
MarcMadec;Marc Madec;;1811;44;53;584;2492
JR11465512;JR;Rien. Un français comme des millions d'autres.;1931;68;9;483;2491
ClaireSchio;Schio Claire;đ© #communication #presse Ă  l'@Ademe #bretagne, â¶coordinatrice du pĂŽle Cibles professionnelles;391;1376;502;222;2491
YVRaeroport;aéroport YVR;"Compte Twitter français de YVR.
Pour assistance immédiate, appelez le 604.207.7077.
YVR est sur le territoire non cédé du peuple xʷməθkʷəy̓əm (Musqueam)";1954;114;225;198;2491
oumarsondelor;Oumar Abba;Biochimiste;484;50;30;1924;2488
Stephmi04;Sophie;;1129;54;31;1267;2481
mikarnage;Michael;"Currently moving to @mikarnage@mamot.fr
Staying here only to see twitter sink";1132;307;66;973;2478
pompiers_56;Sapeurs-Pompiers du Morbihan - SDIS 56;"Compte officiel des #SapeursPompiers du #Morbihan đ
En cas d'urgence : đ18 ou đ112";222;134;1809;312;2477
ManchotSG;Manchot Spectre Génie;Soyez Pas$$ioné ➖$ETH ✊🏻;1538;330;259;347;2474
GnahoreJohn;john gnahore;Caring;1783;30;48;613;2474
attoelie;Elie Kouamé;"🌍 Citoyen dans le monde.
Mes sujets de prédilection la #Culture, le #Design et l'#Innovation";867;765;251;590;2473
RENEMPINDA;René Xavier MPINDA;Homme politique, Entrepreneur dans l'agroalimentaire, Juriste et militant des droits de l'Homme, Chercheur & Enseignant d'Université, Humanitaire...;1003;267;48;1154;2472
EpiterFlorian;Florian Epiter;"Vice-Président étudiant à l'Université Paris Nanterre
Formateur ANESTAPS
Formateur FAGE";65;544;249;1613;2471
QNA_French;Qatar News Agency - French;Instagram: qnaphoto Twitter English: @QNAEnglish Twitter Sports: @QNA_Sports @qatarnewsagency;2324;4;142;0;2470
BonJeanSys;Bon Jean;"LV2 Sarcasme,
Chasseur de bot macroniste à temps perdu";1920;98;9;442;2469
TMohamedSoilihi;Thani Mohamed-Soilihi;Sénateur de #Mayotte | Membre du groupe RDPI @senateursRDPI | Membres de la Délégation sénatoriale aux #OutreMer | Vice-président de la Commission des lois;521;474;845;629;2469
EmmanuelYoRDC;Observateur;Congolais d'ici et d'ailleurs ð¨ð©;316;383;58;1711;2468
Arrow80780703;Anubis;;1416;48;7;996;2467
fatshimetrie;Fatshimetrie;Parce que le congo nous appartient tous, alors ensemble surveillons les activités de notre pays grâce à la plateforme Fatshimetrie !;2302;4;82;79;2467
adovox;Marion Gillot;Responsable du pôle Éditions & Numérique @Dijon et @DijonMetropole_ //Ex rédac’ cheffe @mondeadosmag//@IPJdauphine// toujours à l’écoute des #ados et de #EMI;556;389;352;1169;2466
Yo78495328;Yo;Pourquoi nous retirer et abandonner la partie , quand il nous reste tant d êtres à décevoir ?;1771;211;25;453;2460
AndreasRudinger;Andreas Rüdinger;"Coordinateur Transition Energétique France à l'IDDRI
Passionné de montagne et d'escalade";618;523;1117;199;2457
barz;barz;;1954;417;60;25;2456
LucasPetit92;Lucas Petit;;222;94;5;2135;2456
pbi34lmr;Pierre Bastide d'Izard;"Président #LMR (CPNT) Hérault #Ruralité
Candidat 2022 Législatives Circo0434 Hérault
@Nouv_Energie @GroupeCVE";982;630;299;545;2456
ElOuardiAdil3;El Ouardi Adil;Écologiste engagé dans le milieu populaire pour la jeunesse ! @eelv🌻 | Membre @JE_Lille | Ref @JeunesetJadot 62 @ArrasEcologie #EcologiePopulaire #Européen;572;1272;311;299;2454
melahalk;melahalk;"Analyste  Politique  Economique Financier   Social
Activiste  1 grand Canada pour tous et tous pour 1 grand Canada.
Activiste  1 transition climatique réaliste.";2285;125;12;32;2454
NHaitichannel;HaitiChannel Network;la fiabilité de nos informations, notre force !;817;59;1330;244;2450
EricNeumar;Neumar Eric;;1808;125;13;504;2450
KAKOCED;Cédric;Je donne mon avis sur ce dont j'ai envie. Si vous n'êtes pas d'accord, merci d'argumenter, sinon allez vous faire f....;1936;168;34;309;2447
DimitriCarbo;Dimitri Carbonnelle;Entrepreneur #adaptation #changementclimatique #économiecirculaire - TEDx Speaker - Auteur de 2050, Crash ou Renaissance ? - #Shifter, The Shift Project;768;1213;298;159;2438
DavidAtchoarena;DavidAtchoarena;Executive Director of the World Health Organization (WHO) Academy;514;145;537;1242;2438
BenaliK25591093;Benali Karim;"Authenticité
Déconcertante";880;286;49;1223;2438
LaurencePalais;Laurence Palais;"Les mots ne soignent pas les maux, mais ils font ma vie, pour eux je vis...
Sinon j'aime bien Keen'V, David Hallyday, Renaud Hantson...";1818;259;75;286;2438
basdor5;baba63;đșđČđ·đ»đ;1147;37;14;1239;2437
nathaliealexa19;Nathalie ALEXANDRE;"Directrice territoriale ENEDIS Var
Présidente FACE VAR";793;238;286;1116;2433
madiya_dorothee;Dorothee Madiya;Avocate d'affaires passionnée par son pays, la RDC. SGA en charge des questions politiques, administratives, stratégiques et électorales d'AREP.;85;242;1808;295;2430
GabianeManuella;Manuella Gabiane;;2390;10;7;21;2428
simon_insecable;simon;;2201;115;16;89;2421
lesafricaines;Lesafricaines.net;Site  d'information dédié à la promotion de la femme africaine;1406;692;277;42;2417
Escom_Chimie;ESCOM Chimie;Compte officiel de l'ESCOM, Ecole Supérieure de Chimie Organique et Minérale.;515;416;856;625;2412
HermineDelfen;Hermine;"Anarcho-marxiste joyeusement réac
Contre tous les fascismes: gauche, droite, centre
Eco passionaria contre l'écologie progressiste
Walden - Music is everything";919;547;213;732;2411
tropheesddbzh;Tropheesddbzh;Les Trophées bretons des transitions font émerger les innovations et encouragent les bonnes pratiques du #developpementdurable en #Bretagne 🏆  #tropheesddbzh;1187;438;600;186;2411
IlungaMathy;Ilunga Matala Jean Mathy;Chef de travaux au département de R.I UPN,General Manager de l'entreprise des services DJS sarl,Nationaliste Patriote congolais Libre de penser et d'expression.;1652;248;259;251;2410
Barry81733151;Barry;;583;8;7;1811;2409
Francis_Pinat;FRANCIS PINAT;"Consultant en restauration, j'accompagne le développement organisationnel & fonctionnel de ton resto. Optimise les coûts 
AUDIT/PMS/ACHAT/CONSEILS CULINAIRE";1020;646;288;454;2408
IronKyle38;IronKyle38;Étudiant, grand fan du jeu vidéo @OverwatchFR et des @LEGO_Group. 😊 Créateur de @DisneyPlusBOT 🧡 Suppression automatique des vieux tweets. ♻️;139;290;146;1827;2402
BielecPaul;Paul Bielec;Marketing & Bid Manager in public transportation;1093;128;32;1147;2400
Ubuntu_RDC;UBUNTU;"Nous appartenons à quelque chose de plus grand

Culture/Blog

#UbuntuRDC";1396;98;72;832;2398
OudjaniRadhia;Radhia Oudjani;Directrice de l’agence de l’AFD en Haïti @AFD;268;249;484;1396;2397
MajidZiraoui;Majid Ziraoui;#Nord #servicepublic #transitionenergetique #smartgrids #bigdata #IOT #hautsdefrance | Alumni @SciencesPo;419;570;150;1257;2396
Normaundfr;Normaund;"E-boutique de produits Normands fabriqués en Normandie
#normaund #normand #normandie #fabriqueennormandie #fabriqueenfrance #normandy #madeinnormandie";568;59;792;976;2395
SortonsNsLesDoi;Sortons Nous Les Doigts;Issu du rapport du GIEC + IPBES;758;492;36;1108;2394
GreenpeaceTours;Greenpeace Groupe local de Tours;;702;207;261;1224;2394
Thousandhill50;N.Aimable;"Rwanda is beautiful country that God given to his sons and daughters.the country of
Thousand hills and thousand solutions.";914;1038;99;342;2393
vizigo_ie;Vizigo-IE;#Veille et #analyse - Intelligence économique - #IE -  #Risques & #International - Grands événements sportifs;1489;248;192;459;2388
khady_camara1;Khady Camara;Promotrice des vacances vertes. Consultante en #Environnement et #développement #Durable. #Ecologie #PolitiquesPubliques #Communication;205;410;337;1436;2388
tomj63;BarilSplit;Expert en expert. Ni de droite, ni de gauche, t’as capté. Avoir un avis est vital. Vive le plastok !;965;329;15;1079;2388
NtahangwaMairie;Commune Ntahangwa;Compte officiel de la Commune Ntahangwa de la Mairie de Bujumbura, #Burundi;389;51;1777;170;2387
steve_albani;Le Conservateur 2.0;"Ex-woke avant l'heure devenu conservateur après s'etre cogné contre le réel.
''Celui qui ne sait pas d'où il vient ne peut savoir où il va'' (Bismarck)";1333;493;24;534;2384
cyrilrenault;Cyril Renault;energy specialist @AFD_france;1012;344;318;707;2381
ClubMerignac;Club Mérignac;Toute l'actualité du Club des Entreprises de Mérignac et de ses adhérents.;803;426;637;504;2370
_D_o_L_L_y__;Dolly;;353;214;11;1789;2367
khaoulaerraoui;Khaoula Erraoui;Social entrepreneur, Consultant & Global citizen;765;749;128;722;2364
lbloud_caminare;Laurence BloudJaffré;Partner @CaminareConseil #ChangeManagement #Consulting #Coaching #Facilitation #Training #SOLfrance #Intelligencecollective #innovation #digitalRH #softskills;1469;173;149;571;2362
julienhervoche;Julien Hervoche;;2065;24;8;264;2361
EmmanuelOTSHIN3;Emmanuel OTSHINGA;;897;448;54;962;2361
libraae_media;Libraae ð«ð·;Plongez dans un Ã©cosystÃ¨me sans frontiÃ¨re ð² Libraae.com ð.â¢ Formations / Ebook / CrÃ©ation et DÃ©veloppement site en ligne / ModÃ©lisation Logo â¦ â¬ï¸ð;2059;78;146;78;2361
FranckLeroy19;Leroy Franck;Maire adjoint en charge de la culture, des anciens combattants et du patrimoine historique @Montgeron91.;871;352;333;804;2360
ManciniIsabelle;Isabelle Mancini;;561;44;15;1739;2359
mamy_tshibangu;Mamy Tshibangu;Chargée de communication du P-DDRCS;844;238;544;731;2357
JomaSilva88;Jose Manuel 🏖️;Great market Timing. I Buy Expensive & Sell Cheap 😆;492;354;44;1463;2353
herber_michel;HERBER Michel;Aime la vie et la bourse;960;5;6;1382;2353
ErrajimSheitan;Maleficam;;1140;96;19;1098;2353
farinderin;En quête de sens 📢;"Les boomers sont aussi faits de poussières d'étoiles. 
En manque de progrès social et environnemental, #JusticeSociale #JusticeFiscale #JusticeClimatique";1704;305;58;282;2349
Tommecpe;Thomas Besnehard;#iOS enthusiast, #Swift developer, #UX evangelist;657;640;205;841;2343
GroupeAF;Groupe AF;Cabinet #comptable #ExpertComptable #Social #juridique #fiscal #Audit #Conseil;2299;25;18;0;2342
ElusGsRennes;Élu·e·s Génération·s Rennes;Groupe des élu·e·s @GenerationsMvt à la Ville et Métropole de Rennes, engagé·e·s à Gauche pour la justice sociale, l'écologie et la démocratie #NUPES;1536;283;353;167;2339
climatquestions;Le Climat en Questions;Podcast indépendant et #faitmaison sur le #climat avec @celineramstein (host), Gilles Ramstein et @HuetSylvestre. Compte et opinions perso.;602;354;753;630;2339
lcapdeville1;Béatrice Lecourt-Capdeville;IA IPR de SVT NICE, cheffe de mission académique Éducation au développement durable #EDD @edd_nice;390;171;324;1452;2337
ecoplastinnov;Ecoplast INNOV;ECOPLAST INNOV est une start-up dans le secteur de l’industrie et de l'économie circulaire (énergies renouvelables). Fondée le 25 octobre 2019.;36;2008;184;99;2327
JM_Verchere;Jean-Marc Verchère;Maire d'@Angers et Président d'@AngersMetropole;236;327;1366;396;2325
geronim60958919;geronimo;Liberdadi pa nos povos;341;1130;149;704;2324
jumeau3566;NO.C.E BOURSE;NO.C.E BOURSE est une société spécialisée dans les analyses des marchés d'actions, d'indices boursiers, de matière première, de devises, de cryptomonnaies,...;1777;10;33;503;2323
madi_constant;MADI Constant;"Historien et Muséologue, Unilu 2009.
Engagé dans les mouvements associatifs des Jeunes. Le changement climatique, la conservation du patrimoines; nos objectifs";399;319;47;1552;2317
CdeMaisonneuve;Collège Maisonneuve;"• 11 programmes préuniversitaires
• 14 programmes techniques
• 3 centres et 1 laboratoire de recherche (CCTT+LRIMA)
#collegemaisonneuve #montreal";1003;160;923;228;2314
kaburugutufabr2;kaburugutu fabrice;Bachelor in Architecture and Urbanism/Founder and CEO at leadersburundi.wordpress.com… Youth delegate at UNCTAD15 Youth forum and #BiennaleLuanda;566;916;183;647;2312
GasTonduRang;Presque nous;Bio;2085;75;13;139;2312
_T_BJ;_T_;MD, papa, de droite, capitaliste, carnivore, anti-sobriété 🐟🚙✈️🥩💵💳🛥4x💉💉💉💉, 67 ans pour toutes et tous;902;97;16;1297;2312
ChLaTourlandry;Château de La Tourlandry Site touristique;#Second Empire #Napoléon III  : Site Touristique - Séminaires - Coworking - Réceptions & Mariages - Chambre&Table d'hôtes - Visite & Expositions;808;394;227;881;2310
Universite_JKZ;Université Joseph KI-ZERBO;Créée le 19 avril 1974, l’Université Joseph KI-ZERBO est la doyenne et la plus grande des Universités du Burkina Faso.;760;180;1171;198;2309
Hoffmann_Green;Hoffmann Green Cement Technologies;Hoffmann Green conçoit et produit des ciments décarbonés 0% clinker : HP2A - H-EVA - H-UKR - H-IONA retrouvez nos solutions sur ciments-Hoffmann.fr;877;381;759;290;2307
CX_laurent;Laurent ð´ð»ð±ððºðï¸;;1273;546;188;295;2302
59fiftyniners;Anonymous;¿ Que miras bobo ?;766;306;26;1202;2300
MbuyBey;Mr Bey;Avocat à la Cour, hoē politique, conférencier, SN CDER et SP DU+/KIN;363;1139;629;164;2295
PierreXyze46960;Pierre Xyze;;1414;252;69;560;2295
JackHicham75;Jacques Hicham;Tout ce qui ne vous tue pas, vous fait néanmoins très mal...;1584;10;25;675;2294
MP2by1001salles;MP2;"Market Place for Meeting Planner - Les rencontres du MICE.
MP2 est une solution du Groupe 1001Salles.";697;774;272;550;2293
ValkyriesNRC;Valkyries Normandie RC;👉🏼 Compte officiel du VALKYRIES NORMANDIE RUGBY CLUBS, toute l’actualité concernant l’équipe féminine Élite 2;972;275;640;406;2293
Re_de_Chatillon;Renaud de Châtillon;Da pacem, Domine.;1507;85;15;685;2292
PoupSmokeTrader;Black Buffet Invest 💰;Le comptable préféré de ton dealer préféré;645;525;75;1045;2290
Nhood_Corporate;NHOOD;Nous c'est Nhood. Opérateur immobilier mixte à triple impact positif (people -  planet - profit);1038;296;349;604;2287
Yulitoyu;Sensei Yulan;;145;345;32;1765;2287
LHeydelGrillere;Laurence Heydel Grillere;đ«đ· DĂ©putĂ©e du Nord-ArdĂšche | Commission DĂ©veloppement Durable et AmĂ©nagement du Territoire / ConseillĂšre municipale communautaire | PrĂ©sidente Renaissance07;320;213;669;1082;2284
FredBeauchemin;Frédéric Beauchemin;Député de Marguerite-Bourgeoys | Resp. des dossiers Finances, Économie, et Innovation @assnatplq | Ancien DG et chef des marchés des capitaux à la @scotiabank;467;545;872;397;2281
BArtisanal;Bâtiment Artisanal;Magazine mensuel de la Confédération de l'artisanat et des petites entreprises du bâtiment (Capeb);153;308;1792;27;2280
DeleonBertrand;Bertrand Deléon;;1228;103;75;871;2277
MoDem_Paris5;MoDem Paris 5e #AvecVous;Compte officiel de la section du @MoDem_Paris dans le 5e arrondissement de #Paris. Conseiller de Paris @CasanovaPierre1;770;148;171;1188;2277
justineloizeau;Justine Loizeau;Phd Candidate in Organisation Studies | born 360ppm | @psl_univ @Paris_Dauphine @DauphineMost | #commons #alternative;201;806;355;914;2276
johan_laurent;Johan Laurent;;1556;201;17;501;2275
ARELIEmergence;Emergence, programme d'ARELI;Emergence accompagne des jeunes talents de milieux modestes dans leur parcours académique et professionnel #égalitedeschances #parrainage #tutorat #bourse;965;263;539;507;2274
pc_supremacy;pc supremacy;algerbe hate account;509;368;257;1140;2274
SPeuchere;Salique & Peuchère;N'appartient à aucune commu, si ce n'est la mienne et je n'accepte aucun membre.;2212;2;2;57;2273
myombouno;Mme B. Maimouna YOMBOUNO 1ere Vice Pdte du CNT;Militante des droits économiques des femmes, Manager des Projets de Développement International (MPDI) et Présidente de la Fondation Solidarité Féminine;1302;455;341;174;2272
Abouismail93;Souleymane;☝🏾;854;205;10;1203;2272
dodzikokoroko;Dodzi Kokoroko;Professeur des UniversitĂ©s | Ministre des Enseignements primaire, secondaire, technique et de l'artisanat | MEPSTA | @EducationTg | @GouvTg | #educationTogođź‡ąđź‡¬;142;84;1827;217;2270
VPawlotsky;Vladimir Pawlotsky;Phd in Geography and in Geopolitics, ATER @IFGeopolitique, Local Geopolitics, Urban Geography, Metropolitan governance and Transport Infrastructures;192;429;413;1233;2267
AusoniusEdit;AusoniusEditions;Service d'édition du laboratoire de recherche Ausonius. Publications spécialisées en #histoire, #archéologie et #moyenâge pour chercheur.euse.s et étudiant.e.s.;468;442;685;669;2264
EntendezvousEco;Entendez-vous l'éco ?;La quotidienne d'économie de @franceculture présentée par @tiphainederock (lun-ven, 14h-15h);265;294;1461;244;2264
TumaMikson;Mikson Mgh;;1258;208;50;747;2263
CMDH12;CMDH;Organisation socioprofessionnelle évoluant dans  la formation professionnelle, la promotion,  l'évolution et  la valorisation des métiers  en Haïti.;287;595;1161;220;2263
iae_bordeaux;IAE Bordeaux;"Twitter officiel de l'IAE Bordeaux, l'Ã©cole de management d'@univbordeaux
linktr.ee/iaebordeaux

ð·Â©@gdphotosbdx";885;173;793;411;2262
GimenezFabrice;Fabrice Gimenez;;1696;38;13;514;2261
Paul1Bill;Paul1_Bill;MD.Clinical Cardiology , Researcher:  Sino-Congolese Hospital ( Hasc )ð¨ð©ð¨ð³ - Dalian Medical University ( 2nd Hospital);784;247;20;1208;2259
LorberSacha;Sacha Lorber;ð«ð· French Student in Australia ð¦ðº Master in Disaster Resilience & Sustainable Dev. BA in Peace and Conflict Studies. Iâm also on a tractor sometimesâ¦;927;451;25;855;2258
geoc888;RM;"""On matters of style, swim with the current, on matters of principle, stand like a rock.""";1798;36;12;412;2258
MarioUnivRsalis;Mario Universalis;Du contenu régulier sur #SuperMario, ses jeux, ses personnages et son univers.;1390;12;214;640;2256
habzgo;Eugene Dumais;"La v1e est 1 pure m3rvei!!e.
Scientifique biomédical=biochimiste+maîtrise en microbiologie (virologie)
Humour Clarté Vérité Conscience Altruisme Équité Bon sens";1631;34;7;582;2254
nouvelles_CIFAR;nouvelles_CIFAR;"Les plus brillants cerveaux se penchent sur les questions les plus importantes. 
EN : @CIFAR_News";1206;413;270;364;2253
AmbassdeurI;Ambassdeur Sirajo Issa;Ambassadeur itinéraire de la commission Internationale des droits humains IHCR.;739;980;218;312;2249
chekanaart;CHEKANAART AIDE SANS FRONTIERES;.CHEKANAART AIDES SANS FRONTIÈRES Organisation Humanitaire À but Non lucratif. À travers sa marque @chekanaart aide. •1erPrix @actionrdc +243970385325;517;464;131;1135;2247
CitywireFrance;Citywire France;Des informations sur les fonds pour les conseillers financiers et les banquiers privés en France et l'analyse exclusive de plus de 15000 gérants de fonds.;977;686;524;60;2247
StopTERRA2;Stop TERRA 2;Collectif constitué en opposition à l'installation de la plateforme logistique géante TERRA 2 sur la ZAC des Portes Du Tarn | 🕊vs.🚚 | 👉 stopterra2.org;1421;71;404;349;2245
MEIJIcom;MEIJI COMMUNICATION;"Agence de #Communication
#RP #Presse #RelationsMedias #Blog #Digital #Evenementiel #SocialMedia #Copywriting #Influenceur #Innovation";1385;287;255;318;2245
ongroikcesimple;Degui;;576;356;18;1295;2245
VMatillon;Véronique Matillon;Maire de @Rambouillet_78. Vice-présidente de @Agglo_RT78 en charge de l'Action sociale et de la Santé. Infirmière coordinatrice.;1075;267;858;43;2243
MBretonOrford;Michel Breton;Ex-Candidat du Parti Québécois qui croit à l'urgence de faire du Québec un pays.;671;373;247;951;2242
udemedef971;UDE MEDEF Guadeloupe;"L’Union des Entreprises est le représentant du MEDEF en Guadeloupe. 
Suivez l'actualité de l'Union Des Entreprises (UDE) MEDEF Guadeloupe";536;250;1030;422;2238
energiesded;territoire d’énergie Drôme-SDED;Le SDED territoire d'énergie Drôme est l’autorité organisatrice de la distribution des énergies dans la Drôme. Acteur opérationnel de la transition énergétique.;1167;180;765;126;2238
Ecrat2;Ecrat;;1807;31;8;391;2237
antoinejacques1;antoine jacques;sans emploi, adore jouer au pc, célibataire.;780;571;45;841;2237
InesNjonpang;Inès Njonpang;"Experte en aménagement et gestion des ressources naturelles. 

Responsable  agroecologie à JVE Cameroun .";153;1248;379;454;2234
UnescoBamako;UNESCO MALI;Compte Twitter officiel du bureau de l'UNESCO au Mali ð²ð± #ððð¨ððð§ðð¢ð¡ #ð¦ðððð¡ðð #ðð¨ðð§ð¨ð¥ð #ðð¡ðð¢ð¥ð ðð§ðð¢ð¡;595;86;1146;404;2231
ConseilPauvrete;CNLE;Conseil national des politiques de lutte contre la pauvreté et l'exclusion sociale. Le CNLE est composé de 65 membres dont 32 personnes concernées.;269;443;1286;231;2229
autoestrada1;autoestrada;Sito specializzato in mobilità, politica dei trasporti, presentazione e test di vetture e moto. Tutto quello che volete sapere sul mondo dell'auto;1696;420;71;42;2229
EsportInsights;EIN;Une nouvelle exploration des mondes vidéoludiques • Média indépendant • Demande pro : contact@esport-insights.com;548;234;1072;374;2228
BaptistePeupleF;Lanté Baptiste;;897;43;19;1264;2223
Lecoresponsabl1;Eco-Responsablesð§ð¯;Association engagÃ©e pour la protection et la prÃ©servation de l'environnement ðð¿ðð¦ð PassionnÃ©s et dÃ©terminÃ©s Ã  agir pour un avenir durable et inclusif ð¤ð±;844;295;340;742;2221
inquietude_l;L’inquiétude;;1390;21;5;804;2220
Bessancourt95;Ville de Bessancourt;Compte officiel de la Ville de Bessancourt;1350;207;570;86;2213
HamidouKarembe3;Hamidou Karembe;Juriste/Président de la République;24;660;46;1481;2211
LysyGeorges;Georges Lysy;;903;81;15;1212;2211
Cevennes75;Larco;;1895;132;18;164;2209
Clumervo;Clumervo;;1153;137;9;905;2204
Bjorn_Stavsen;Bjorn Stavsen;De retour sur le réseau;997;209;181;815;2202
Pouvoirsdafriq1;Pouvoirs d'Afrique;Magazine trimestriel panafricain des décideurs.;1992;98;112;0;2202
MagmaEnergyRen;MAGMA Energy®;Première centrale d'achats qui vous accompagne dans la production des #energies #renouvelables #biogaz #biomethane #agroecologie #vertlavenir 🌱🍀🌾🐄♻️;462;1041;376;321;2200
hitbenoit;Amani Networker;Bachelor/Fiscality of superior commerce institute to management of organisation.;344;1318;75;463;2200
5gLinky;Stop Linky-5G Montpellier;;2001;69;71;57;2198
LeFrancaoui;Le Francaoui;La république c’est nous !;1434;73;9;681;2197
oenodia_eurodia;Oenodia;Procédés soustractifs au service du monde vinicole : stab tartrique, contrôle PH, filtration tangentielle, désalcoolisation partielle #oenologie #vin #wine;231;1268;159;535;2193
ADelaborne;Armand DeLaBorne;La politique dirige le monde, mais qui dirige la politique ? Citizen politics supporter & sea lover.;1261;672;173;84;2190
isabelleroy73;Isabelle Roy;Prof d'histoire géo, DNL anglais, EMC;247;435;44;1464;2190
Arnauld3d;Arnauld3d;"Je cherche l’or du temps. 
Ahi! pentirommi, e spesso,
ma sconsolato, volgerommi indietro.";1424;92;18;652;2186
JeRouleEnElec;Je Roule En Electrique ð;Site d'information pÃ©dagogique sur la #MobilitÃ©Electrique, alimentÃ© par le programme CEE #AdvenirFormations & pilotÃ© par l'@AvereFrance. #JeRouleEnElectrique â¡ï¸;405;445;360;975;2185
mon_toulouse;Mal à mon toulouse;Toute les vérités sont bonnes à dire même si elle vous dérange;1749;127;20;289;2185
Anonycarpes;MagicarpesElus;Amoureux de la France ( et de ma chérie, pas taper... non non pas taper ... );267;14;9;1893;2183
albarran_33;Christophe ALBARRAN;"Ambassadeur du développement soutenable. Auteur  du livre ""Le Développement Durable : mythe ou nécessité ?"" @HarmattanParis #biodiversité #RSE #communication";382;393;110;1297;2182
SevesAlexi;Limenn;Quand on me dit que je suis sur la Lune, je leur réponds que je vise bien plus haut. 🚀🚀;1097;282;49;751;2179
_ClaireFABRE;Claire FABRE - Recrutement;"#recrutement approche directe
#industrie #transformation #matériaux #construction #fonderie #usinage #plasturgie #metallurgie #emploi";1729;199;246;4;2178
TontonThierry56;tontonthierry;Crypto enthusiast since my bro-in-law opened my eyes ð / No privacy ? Then, no better future, even with blockchains & cryptos / Support xx network, David Chaum;783;158;42;1193;2176
EChantier;Equipement-chantier;Spécialiste de la vente en ligne d'équipements et matériel de chantier pour les professionnels du bâtiment et des travaux publics. Ventes flash à prix cassés.;212;1501;449;9;2171
ED31moD;Pasc31#E#VDM;;653;71;6;1440;2170
ConfigsPC;ConfigsPC;ConfigsPC.com est un site crée en 2004 qui propose des actus, configs, guides d'achat... Demandez sur le forum pour une config PC sur mesure. 😀;1042;935;75;112;2164
DeclicProjet;Déclic Projet;Think & Do Tank d’étudiant.e.s engagé.e.s 💡 Solutions politiques concrètes pour un avenir écologique et solidaire 🌱 ♻️ Né confiné, créé pour durer ♻️;498;747;635;284;2164
EnerkemQC;Enerkem;Nous bâtissons l'économie circulaire en transformant les déchets en biocarburants et produits chimiques renouvelables.  English: @Enerkem;600;245;795;522;2162
Antiath;Antiath;;637;17;11;1496;2161
DeoBiakitaga;Deo Biakitaga,l’Elu des pauvres.;Économiste de dévt.( finances et dévt.).Passionné du dévt écque des ETD en 🇨🇩. ntre souci:léguer à nos enfants un Congo plus viable et vivable. Epoux et père;1263;315;92;490;2160
Ayra_lou;AYRA;;1277;82;26;774;2159
gonzales94290;Didier GONZALES;Maire de Villeneuve-le-Roi. Ancien député de la 3e circonscription du Val-de-Marne.;526;403;665;564;2158
thomas_bouquet;bouquet thomas;Acteur engagé et citoyen;1113;639;387;18;2157
JOURNALECO1;JOURNALECO;Support media digital d'actualité économique et financiére marocaine;1867;50;17;222;2156
PositiveProd;Positive Production;#PositiveProduction : Décrypter, Défendre, Divertir ! 🙂;644;244;1083;185;2156
Charlibar1;Charlibar;;988;73;5;1087;2153
HGaridel;Hélène Garidel;Secrétaire Générale du groupe des Maires de Provence et élus municipaux pour l’intérêt communal - Métropole Aix Marseille Provence;682;268;417;785;2152
regisbro1;Regis Brault;Homme de terrain culturel;446;55;146;1504;2151
alainlenoir5;alainlenoir;;1809;129;16;197;2151
VignyMarie;vigny marie;La vie n'a de sens dans ce monde si  on est capable de critique le politiquement correct. Bienveillance empathie sont mes maîtres mots la critique aussi;1606;62;17;464;2149
AlainProvist17;Alain Provist;Chasseur de complotistes;1197;14;11;926;2148
DjamelTh;🎩 DjamTh 🎩;🎩 Gold Ticket Member at MNPL 🎩;656;133;48;1311;2148
HubertAteba1;ASUS RELUC NGO;"Leadership social, altermondialiste et Militant de droits de l'homme,spécialiste du développement social et durable;l'économie propre,Justice du Genre,Jeunesse";1091;523;119;414;2147
johndur52053919;vinceđx5 booster x2;"si on veut passer l hiver , il faut reconfiner .
mon meilleur acte de rĂ©sistance pour 2023 , fermeture de ma boulangerie pour terrasser Poutine";1316;254;89;488;2147
FluxysBelgiumFR;Fluxys en Belgique;Shaping together a bright energy future. Visitez nos autres pages @FluxysBelgiumNL - @FluxysGroup;773;328;492;552;2145
SilasNaindouba;Silas NAINDOUBA 馃實;脡tudiant en communication pour le d茅veloppement. Jeune Activiste engag茅 pour la lutte contre les changements climatiques;409;116;94;1522;2141
isonomia_pure;isonomia_pure;⎮ ISONOMIA ⎮ Pour Une Révolution Egalitaire ⎮;1011;107;358;663;2139
JCE_NMSL;JCE Nantes Métropole;JCE Nantes Métropole Sud Loire, jeunes citoyens entreprenants, impacter son territoire, se former par l'action, agir pour l'avenir...;364;528;931;313;2136
alexandreschla2;alexandre schlatter;;1636;73;5;420;2134
csti_AM;CSTI de l’académie d’Aix-Marseille;Cellule académique de pilotage de la culture scientifique, technique et de l’innovation;1466;212;254;202;2134
ADANOVA_;ADANOVA;Association de Défense des Actionnaires de l'entreprise Claranova;653;49;510;922;2134
streetfurin;Fūrin;;461;309;21;1342;2133
CMergault;Lalo&Co;webmarketing đ¶Â #graphic design, #SEO, #inbound & content marketing;178;274;86;1585;2123
quentinmaternat;Quentin 🇫🇷;"@kardomance
discord.gg/Xhc3jgcb
#TeamN26";1437;360;76;250;2123
Noone34306451;It was sarcasm;;489;118;4;1511;2122
TabarakaBio;Tabaraka BIO BANGANA;Activiste climat | Communicateur Environnement | Green Community Manager | Graphiste Designer| Responsable de public | Geomaticien | Coach Sportif | Phonographe;836;98;292;896;2122
nrhartmann;Nick Hartmann;Resident Representative @UNDP Haïti #SDGs #Agenda2030. Africa, Middle East, Asia-Pacific, Caribbean: Development, Humanitarian, Peacebuilding. Views are my own.;875;375;767;99;2116
wshchocolatine1;marin;!;156;257;82;1618;2113
PreaZyFX;Kev' PreaZy / #LEGALHAZE;"Mieux vaut être enfumé qu'en fumée.
Je fume et pourtant, je raisonne mieux que le gouvernement.
Sarcasme et Dérision.";1636;125;47;304;2112
DeschampsLaur19;Laurence Deschamps;❤LaMayenne #Maire2014-2020 #européenne 🇪🇺 Solidarité 🇺🇦;784;144;96;1087;2111
FrBillerey;François Billerey;;1590;29;30;457;2106
Mrbob96356203;Jeff Lessard;;462;34;24;1581;2101
GadegLaety;Laetitia Gadegbeku OUATTARA;Views are my owns. RTs are not endorsements.;897;189;455;560;2101
AaciComptable;AACI expertise comptable;#expertcomptable #comptabilité #finance #commissaireauxcomptes #fiscalité;1806;70;138;86;2100
jonareff;Jonareff ð¦;J'aime le sarcasme;1043;77;9;971;2100
archeofuturisme;Dexter ðŸ†”;;513;19;9;1559;2100
tapbaron;TBaron#TouchePasÀMonMenhir#JusticePourLesSuspendus;"Mon âme à dieu, mon corps à la liberté, mon honneur à moi.
Un individu censé peut-il être défavorable à des injections inutiles et potentiellement dangereuses ?";1304;459;178;157;2098
IgorStojkovic12;Nejbosha Stamenic;"authentique IA gestion de bitcoin
programme de langue française et italienne";1789;48;3;256;2096
gauche64;Gauche64;Les élu-es du Groupe de la Gauche du Département des Pyrénées-Atlantiques #gauche64;520;216;308;1051;2095
GONDOMartin;Consultant GONDO Goueu Martin;AFRIQUE par  AFRIQUE. j'y crois. Si chacun Y contribue là où il se trouve, mon AFRIQUE sera meilleure !;601;1121;124;248;2094
Isumaeru22;Isumaeru;;1451;204;21;416;2092
JslnRbd;Lesfachosjvouspissealaraie;;1533;51;6;500;2090
GGambierThurot;Gaëtane Gambier-Thurot;cofondatrice ESCAET #tourisme #voyage #businesstravel #event #leisure #travelmanagement #strategos #forumdespionniers #PTI #incubateur;816;391;396;487;2090
_Audrey_Leclerc;Audrey Leclerc;ð»ð«ð·ð©ðª ConseillÃ¨re des franÃ§aisâ¢es de lâÃ©tranger et Ã  lâ#AFE, membre @collectifecas â¨, @Eco_Sol_AFE, @EELVHorsFrance, @Die_Gruenen ð± #BaWÃ¼ #Bayern;259;602;225;1003;2089
BerdotMair;Esther Mair;;1104;81;7;891;2083
NMenika2;Ben Kameni;#GarçonBantou🇨🇲 natif du 237 prône le panafricanisme💚, l'amour♥️, le partage💛 et l'érudition 📖pour mettre fin à la discrimination⛔,la misère et l'ignorance;829;319;21;913;2082
Cuixbi2;Cuixbi2;Ingénieur génie nucléaire;631;70;14;1367;2082
MegValereSossou;Megan Valère Sossou;Journaliste d'investigation, Directeur de rédaction du @JournalSantEnvi et Directeur Exécutif de l'ONG Save Our Planet;637;1034;135;276;2082
kalombobonheuro;Bonheur kalombo;I'm ingeneer, prophet and entrepreneur;1435;555;49;42;2081
stephane_audh;saudh;;959;49;3;1062;2073
grandmore1;Rwina;;337;159;18;1556;2070
RDuchmol;Raoul Duchmol;"Fait partie des 7% qui y croient toujours, contre toute attente.
Non-vax, covid*2, lachez-moi avec la 4e dose.";879;101;47;1042;2069
MonctonImpact;Moncton Impact;"City of Moncton's Economic Development Dept.┃Dépt. du Développement économique de la Ville de Moncton
#MakeYourMarkInMoncton┃#FaitesVotreMarqueÀMoncton";1206;47;322;492;2067
ltnmiles;Lt Miles;My armor is contempt. My shield is disgust. My sword is hatred. Let none survive.;1062;81;30;892;2065
DohmFrance;Dohm France;Bénéficiez de l'accompagnement de l'un de nos agents dans votre région. Contactez-nous;2041;10;10;0;2061
Primexis;Primexis;"Conseil Opérationnel & Expertise Comptable Spécialisée
contact@primexis.fr";611;870;490;88;2059
GillesDrouin7;Gilles Drouin;Père de 3 ados |Professionnel de l’industrie agroalimentaire |📍Paris | #transition écologique | #axefrancoallemand #urbanisme #agriculture #singapour;717;296;123;922;2058
HadrienLondiche;Londiche Hadrien;;2051;1;4;0;2056
VTriaille;Veronique Triaille;profHGEMC collège H.Matisse /formatrice PSC1/ formatrice EMI/ etwinning/ ERAEI/ Laïcité;917;302;248;589;2056
ERTDesnos;École Robert Desnos;École primaire #AEFE accueillant 1120 élèves de la PS au CM2;509;163;154;1230;2056
GereGuyauramses;Guyot;"Ingénieur en informaticien et télécommunication.
CEO de start-up See Change Engineering consulting (SCE)";249;315;77;1406;2047
Milieugids;De Milieugids;groene partners uit de milieu- en industriesector verzameld in een handig jaarboek, op milieugids.be en in een e-book.;1329;136;144;438;2047
helitair;Corberand Thierry-Pierre;comité Horizons Doubs Besançon;305;46;26;1667;2044
EricMuraille;Eric Muraille;Biologiste, Immunologiste. Mes tweets sont personnels.;932;196;271;644;2043
oceane0424;SYLVAIN ROY;;1773;68;7;195;2043
RErgosum13245;Rigolo Ergo Sum;« Je me presse de rire de tout, de peur d’être obligé d’en pleurer » (Beaumarché) - Tu aimes rire des rigolos qui nous gouvernent ? Suis-moi ! #TeamFollowBack;484;1189;363;6;2042
KalejiMatamba;Kaleji Matamba;Environnementaliste;790;542;637;71;2040
CHANCE_5G;Chance_5G;Die Schweiz fortschrittlich verbunden. | La Suisse connectée à l’avenir. | La Svizzera progressivamente collegata.;783;144;437;676;2040
Foulfoul8;Foul foul;;457;161;9;1413;2040
topoaime;Dr Topo Aimé;Président du Collectif des Leaders pour le Développement durable de l'Afrique, je choisi le bénévolat comme arme de développement.;636;580;164;659;2039
ValStramgram;Val Stramgram;;130;824;32;1053;2039
ATLASSIANBRO;Mhamed Barradouane;;1191;334;33;481;2039
mim_esso;Mireille Essono E.;Didacticienne du français;147;120;30;1741;2038
tcoiffeurjustes;thierry gras;Président de l’association COIFFEURS JUSTES et créateur de la licence de marque Hairdresser Fair For Family.;1413;373;159;92;2037
AMED_JDD;ONG AMED MAROC;Association Marocaine pour un Environnement Durable - compte officiel . Un éco-acteur national pour un Maroc Durable ! contact Président @lotfi_chraibi;546;457;375;654;2032
NathalieSincla3;Nathalie Sinclair-Desgagné;Députée fédérale de #Terrebonne pour le @BlocQuebecois | Nouvelle maman | Économiste de l’environnement formée à Oxford | Gazouillis = opinions personnelles.;174;314;1286;257;2031
ReseauAMAPaura;Réseau AMAP Auvergne-Rhône-Alpes;"Réseau des Associations pour le Maintien d'une Agriculture Paysanne 👩‍🌾👨‍🌾 
On est aussi sur Mastodon : mamot.fr/@reseauamapaura";667;214;223;927;2031
sin4_m;MD 🏴‍☠️;Anti Woke;252;67;8;1701;2028
CdpmeG;Centre de Développement de la PME;Unité spécialisée du @legicam en charge de l’accompagnement des PME et du soutien à l'Entrepreneuriat.;553;41;334;1099;2027
TrublionDuMot;Believe;;688;322;16;1000;2026
IAEAngers;IAE Angers;"IAE Angers, école universitaire de #management @UnivAngers. Membre du réseau @IAEFrance
""Les atouts d'une école, les valeurs de l'université""";843;145;333;704;2025
B66Franck;Franck;;1175;224;9;617;2025
ATARDC;Agenda de la Transformation Agricole - RDC;Programme Gouvernemental visant l'autosuffisance alimentaire en RDC par le renforcement des chaines de valeurs des produits agricoles de première nécessité.;52;33;1756;182;2023
CAPEcouteClient;CAAP  Service Client;Service du #CréditAgricole Alpes Provence, pour répondre à vos questions du quotidien. Pour des questions personnelles suivez-nous et échangeons en DM !;1399;89;430;104;2022
media_est;EST MÉDIA MONTRÉAL;EST MÉDIA MONTRÉAL est un média d'actualité dont la mission est d'informer, développer, soutenir et promouvoir l'Est de Montréal.;739;750;354;179;2022
OwlsDuc_Gold59;BASTOS;Pirate đŽââ ïž 23 ans Investisseurs Bourse Investisseurs Cryptomonnaie CrĂ©ateur du site ecoworldlife comment rouler Ă©colo;1748;166;50;57;2021
MmeMelaniee;Mélanie Talbot;Enseignante en maternelle et jardin,🍎;890;67;179;885;2021
FloCortier;Flo Cortier;;1867;110;2;42;2021
BrigittHagemann;Brigitte Hagemann;Correspondante économique de l’Agence France-Presse à Milan, après Nairobi, Buenos Aires, Lisbonne et Paris. Mes éventuels tweets n'engagent que moi;485;618;909;8;2020
BaduelMoldes;Baduel Moldes k CPGE St Louis /Mines Paristech;CPGE Espagnol/professeur associé   MINES Paristech-;700;193;72;1054;2019
nonlgv33;Non LGV 33;"Non au GPSO (LGV/AFSB/AFNT)
Oui aux trains du quotidien
Oui à la rénovation de la voie existante";1289;113;78;538;2018
orishas_finance;Orishas Finance;Orishas Finance financial and economic information, Online Brokerage in Africa #Banks, #StockExchange , #AssetManagement ,  #Energy, #Insurance, #TIC #News.;1752;24;19;223;2018
RIVIEREBenot1;RIVIERE Benoît;Un peu intello, passionné par la géopolitique;1736;199;16;66;2017
ALTAO_VENDEE;MANU_VENDEE;Au fil des années, j'ai pris la décision de me concentrer sur l'amélioration et l'enrichissement de mes compétences en tant que rédacteur.;1949;29;25;13;2016
TabouleAAAAAAAH;TabouléAAAAAAAAAAAAAH;He/him;254;89;6;1666;2015
INRAE_ECOTOX;ECOTOX;The network of terrestrial and aquatic ecotoxicology @INRAE_France, @CNRS, @Le_Museum, @Anses_fr, #environment;1149;227;617;20;2013
Cornely235;Guevara le Combat Permanent;Croire en soi-même;1837;91;23;59;2010
just_juliao;Julião;Data enthusiast & risk manager.;722;137;106;1044;2009
DarkTarbal;DarkTarbal;"Comme vous je suis expert et j'ai la solution à tout.
 
Je n'ai pas besoin de followers : mon égo est  déjà au TOP";1846;68;10;84;2008
coutal00711;coutal007;;1715;2;2;288;2007
Anneclaudeo;oillaux anne;;955;89;9;952;2005
ALEC_PaysMessin;ALEC du Pays Messin;Conseil neutre et indépendant en #énergie à #Metz - Association à but non lucratif;746;573;374;312;2005
lily_ANESTAPS;Lily Rogier;Vice présidente en charge des Affaires Académiques à l’@anestaps 💙 Stapsienne à temps pleins 🏊🏼‍♀️;457;289;236;1018;2000
Stephdemonaco75;stéphanie;Ben voyons !;1341;109;46;502;1998
LabisPortoNovo;LABIS Porto Novo;"Centre d'innovations, de renforcement de capacités et d'actions des jeunes sur l'Employabilité et Engagement Citoyen. 

LABORATOIRE D'INNOVATIONS SOCIALES. #CPD";469;559;481;487;1996
mjf4c3;Olivier;Responsable SI et Qualité dans une PME;775;354;68;797;1994
ClaireLigne;Ligne Claire;#ligneclaireetassocies #comptabilite #expertcomptable #expertise #limoges;1904;5;83;0;1992
ProLogium;ProLogium Technology 輝能科技;Solid-State Battery Maker;127;88;1611;165;1991
Yaokouassisain4;All might;Je suis le produit d’une famille, d’une nation, d’un continent. Je  crois fermement à l’UNION, la DISCIPLINE et le TRAVAIL. ensemble on ira plus loin 🤝;742;615;129;498;1984
HMamaluk;habadi mamaluk;;1479;5;9;491;1984
JeanMalandala;Jean Bertrand MALANDALA;;627;188;99;1067;1981
Fackear09;Dct Thomas ð¢;Prend de la hauteur, reste calme mon ami;966;184;14;817;1981
BerquerPhilippe;Philippe Berquer;"Responsable de 2 maroquineries ; Président de chambre au Tribunal de Commerce ; Trésorier de la Fédération Nationale des Détaillants en maroquinerie & voyage.";577;67;220;1117;1981
LaurentJoulain;Laurent Joulain ðŸ‡«ðŸ‡·ðŸ‡§ðŸ‡ªðŸ‡¬ðŸ‡§;Artiste engagÃ©.;1760;187;30;4;1981
remybeauchamp;Rémy Beauchamp;"Courtier immobilier résidentiel dans le Grand Montréal.
J'ajoute de la magie à vos transactions!";1855;48;76;2;1981
HubertMongon;Hubert Mongon;"Délégué général de l'@UIMM.
🇫🇷 Pas de société forte ni d’économie forte sans #industrie forte.
#DialogueSocial #Emploi #Apprentissage #IndustrielsEngagés";439;101;1276;162;1978
brief_science;brief.science;Chaque vendredi, Brief.science fait le tri dans l'actualité scientifique et vous explique ce qui est important, par mail et sur l'app. @briefmenews @BriefEco;460;378;983;156;1977
_UNEAP;UNEAP;Représenter et défendre les étudiants en architecture et paysage auprès des pouvoirs publics et des instances nationales . #teamArchi #TeamPaysage;543;313;726;395;1977
angopascal;Ango Pascal;External Relations and Communications Manager #Conservation #Gabon;926;646;122;282;1976
Deusmeus_omnia;TauRDC;;306;459;120;1091;1976
SefacSma;SefacSma;;1964;0;10;0;1974
FerreAssocies;Ferré & associés;Cabinet Ferré & associés #expertise #comptable;1880;45;48;1;1974
chupitof1;chupitof;"Ni Macron ni Phillipe non a l'extrême centre  pour la vrai démocratie le peuple decide
 les politiques appliques";1399;11;2;561;1973
guidehabitation;GuideHabitation.ca;Le plus important portail consacré à l'habitation neuve au Québec depuis 2005/The most important portal dedicated to new homes in Quebec since 2005 🏘;598;119;1256;0;1973
DunkerquePromo;Dunkerque Promotion;Agence conseil, nous accompagnons votre entreprise dans son projet d'#Implantation ou de #Developpement #Industrie #Energies #Logistique;923;298;653;99;1973
CentrePasteur;Centre Pasteur du Cameroun;Laboratoire de Référence et de Santé Publique, le Centre Pasteur du Cameroun est un établissement public qui vise l'amélioration de la santé de la population.;499;191;649;631;1970
NewsTodayNS;nayeamseikhh;All about international news.;1315;395;150;109;1969
E_LACRESSE;Emmanuel LACRESSE;đ«đ· đ DĂ©putĂ© de Meurthe-et-Moselle | VP @DeputesRE | Commissaire aux Finances | #Nancy #Vandoeuvre #Laxou #Heillecourt #Houdemont #Jarville #Ludres #Villers;521;589;617;242;1969
Alexchretien74;CHRETIEN Alexandre;cofondateur de la Convention des Entreprises pour le Climat et DG de Astrakhan;624;297;138;909;1968
NoManicheisme;Pas De Manichéisme;;1544;23;7;394;1968
Marie24056481;Marie;;1954;5;1;8;1968
PEGE_french;Mösl Roland;"Founder of PEGE.org - Planetary Engineering Group Earth -  
Founder+CEO GEMINI-next-Generation.House…
piped.video/@pegefounder";1181;380;400;5;1966
TopTSMF;TopTSMF;Système de notation et de remises de prix dans le domaine du patrimoine organisé par @Toutsur : Assurance vie  - PER - SCPI - Fonds Eco-responsables #Awards;1342;14;563;44;1963
BlondelO2;Blondel O;;1699;67;105;91;1962
malomofa;Malo Mofakhami;"Ph.D. - Researcher in Economics at @univ_spn @LeCnam
☀️🌡️⬆️🌎🌏🌍⛰🌳🐧🌊✊🏽
(bien entendu, mes tweets n'engagent que moi)";724;414;436;387;1961
Paris_OnMyWay;Sur Le Pouce;Nous n’entrerons pas dans la nuit sans combattre;784;14;7;1156;1961
Galianove1;Galianove;;910;124;16;911;1961
Babapolitique;Baptiste Spalonyđ«đ·đȘđș;;702;501;137;620;1960
C2A_audit;C2A Audit;C2A Audit est un cabinet parisien d'#ExpertiseComptable et d'#Audit;1947;2;10;0;1959
jeunesueua;Organisation des Jeunes-UE-UA;Official bilingual (FR/EN) account of the Youth Organization for the European Union and African Union;1248;122;284;305;1959
SDFinisherrr;Simon Desserprit;;688;192;16;1062;1958
IEB_Bruxelles;Inter-Environnement Bruxelles (IEB);IEB fédère 80 comités de quartier et groupes d’habitants bruxellois actifs sur des questions urbaines, écologiques et sociales.;628;369;278;680;1955
Cefico_62;Cefico;Nous vous accompagnons au quotidien dans la gestion de vos entreprises.;1773;81;96;1;1951
jeanbokoto;Jean Baptiste Bokoto;Entrepreneur, philanthrope, écrivain, Chef de file d'un mouvement citoyen.;516;844;551;39;1950
TInvestisseur;Tous Investisseur - Gold 🪙;"Je partage ici mes investissements, mes réflexions.
Un esprit sain dans un corps sain avec les proches pleines";1022;248;212;466;1948
lesamisdAyiti;LES AMIS D'HAÏTI;Les Amis d’Haïti est une organisation sans but lucratif, fondée le 11 novembre 2013 en vue de promouvoir l’éducation, la culture et le développement durable.;337;886;242;483;1948
LeRobotKiTweet;Le Robot Ki Tweet ð¤;RoboKiTweet, petit robot dÃ©couvrant votre monde aprÃ¨s un long voyage intergalactique. J'explore, j'apprends et je tweete des anecdotes rigolotes de mon pÃ©riple.;1688;59;20;179;1946
tontonS74;TontonS;;562;256;9;1119;1946
15_Renaissance;Renaissance Cantal ð15;MajoritÃ© prÃ©sidentielle (ex En Marche) dans le #Cantal ðRÃ©publicains de gauche et de droite, rejoignez-nous ! ð«ð·ðªðºParti politique @Renaissance;927;258;27;732;1944
AmineMehdiOff;Amine Mehdi;"Maire-adjoint d'#Annemasse en charge du Commerce, de l'Artisanat, de la dynamique et de l'attractivité du Cœur de ville

fb.com/AmineMehdiOff";328;261;207;1142;1938
GACTechnology;GAC Technology;Leader des logiciels de gestion de parc auto en France, 447 000 véhicules gérés. Mais aussi parc télécom, bâtiment et gestion des infractions. #Gestiondeflotte;904;549;296;189;1938
UnivDroit_EDD;Droit de l'Environnement et de l'urbanisme;Droit de l'environnement et de l'urbanisme. Un compte @univ_droit;612;1;1322;1;1936
KuroroLucilfer;Kuroro ⵣ;"Freedom
Ingénieur
Three day Graces";834;181;30;891;1936
sidibemacisse;Macissé;Parole d’homme.;172;806;254;704;1936
campagne_cpvi;C'EST PAS VERSAILLES ICI !;đĄ Campagne nationale de dĂ©sobĂ©issance civile pour l'extinction de la publicitĂ© lumineuse. đïž #ExtinctionRebellion #CestPasVersaillesIci @xrfrance;113;1153;614;54;1934
addor_doh;Doh Koffi ADDOR ­čç╣­čçČ­čöĘ­čöş­čôí­čÜÇ;"Geologist and amateur in Astronomy.
Explore and discover the mysteries of the Universe.
Science educator.

Geology and Astronomy Outreach Coordinator.";70;451;97;1310;1928
5starsbrokers;Five Stars® - Brokers;"𝗙𝗶𝗻𝗱𝗶𝗻𝗴 𝘆𝗼𝘂𝗿 𝗱𝗿𝗲𝗮𝗺 𝗵𝗼𝗺𝗲, 𝘁𝗼𝗴𝗲𝘁𝗵𝗲𝗿. We are a global platform for real estate services. 
🇵🇹 🇬🇧 🇫🇷";797;701;143;286;1927
JeffDarga;Darga Jeff Aristide;jeunes activiste pour la cause de la jeunesse sur le plan de la santé sexuelle et réproductive, sur l'entrepreneuriat, et dialogeur pour la paix sociale;164;527;459;776;1926
DogTheraphie;Raphaël.S;"T.D.A.H avec co-morbidité..🐕💓😘🐶🐶🏡 récompenses immédiates, régulateur d'humeur et Fidel jusqu'à la mort
Les chiens sont une force et un outil très fort 💓";85;1100;218;516;1919
experts_audit;Experts Audit;#finance #expertcomptable #audit #comptabilité #fiscalité #conseil #retraite;1702;56;119;41;1918
HachaniNaima;Cours Gestion PDF;;1900;0;16;1;1917
MoniaBarkat;Monia Barkat;Chargée de développement territorial - investissement @BdT_PACA @BanqueDesTerr @CaissedesDepots;361;346;145;1064;1916
BLB_Vignobles;Bruno Le Breton;Propriétaire œnologue passionné par nature à vinifier un monde meilleur #ISO26000 #RSE aux domaines @delajasse & @montlobre;867;327;391;329;1914
Cabinet_Safir;Safir;À un champ des possibles variant sur 360°, #SAFIR propose une solution adaptée à chaque situation, en fonction de vos spécificités.;1869;1;42;0;1912
TshitendeSteve;Tshitende Steve;;670;134;37;1069;1910
__Y_P__;wyπ;Linux, *BSD, cyberstuff, 3D design and printing, hamradio, photography and women :P;793;138;8;969;1908
AstraAries;Astra Aries;;1238;130;48;492;1908
GNWT_ENR;GNWT ENR / MERN;GNWT ENR latest updates // Dernières informations concernant le MERN;1574;3;326;4;1907
DuhamelLycee;Lycée Duhamel du Monceau (45);Compte officiel du lycée Duhamel du Monceau (45) @duhamelLycee;541;469;434;462;1906
maniglierp;Patrice Maniglier;;174;907;749;69;1899
Mairie9Lyon;Mairie du 9e Lyon;Bienvenue sur le compte officiel de la Mairie du 9e arrondissement de #Lyon. Retrouvez toute l'actualité de votre mairie et de votre arrondissement.;728;138;796;234;1896
000kiwi17;000Ki. Wi17;;1892;2;0;2;1896
lisse_ane;Âne lisse;Bref...;436;75;13;1369;1893
CEC_impact;Convention Entreprises Climat;La Convention des Entreprises pour le Climat existe pour rendre irrésistible la bascule de l’économie extractive vers l’économie régénérative avant 2030.;423;142;989;333;1887
LaetitiaTriO;Lætitia TRILLEAU;"Coaching, Mentoring, Supervision
Accompagnement Authentique de l'Être
Être - S'aimer - S'éveiller - Donner du sens
Vivre mieux & libre simplement";1563;43;58;222;1886
zertsaf;Zertsaf;juste là...;835;58;9;983;1885
Yuzbirokok;A;;1766;23;3;93;1885
RADIOPFMArras;Radio PFM 99.9;"Radio PFM est une radio associative, locale, libre et sans pub à Arras.
PFM émet sur le 99.9 FM à Arras et aux environs.

Téléphone : 03 21 50 99 99";1598;91;140;52;1881
La_JusteBalance;Caro C;;566;23;1;1290;1880
PeupleRdc;Peuple Rdc;Agrégé des facultés de Droit, University lecturer. Avocat. Expert en Didactique des Sciences Juridiques. Doctorant-chercheur en Économie africaine à l'UPN-SFAX;710;110;66;994;1880
EmilieGaub;Emilie GAUB;Passionnée d'actualités et de politique, amoureuse de son pays, de #paris, du #Brazil et surtout de la #capoeira!;774;590;172;344;1880
Traveler7Time;Hunting Times;"Patriots
Are
Now 
In
Control";816;358;124;581;1879
Equitom1;Equitom;Clinique Equine spécialisée en chirurgie, médecine interne, orthopédie, imagerie médicale et revalidation.;188;2;1613;75;1878
situphen;Situphen;Corruptible avec des crêpes au sirop d'érable • Lobby de @ZesteDeSavoir • Citoyen de la procrastination • Étudiant en Énergie • Débordant de gayté • il/lui;423;55;39;1359;1876
AnisseTross;Anisse Tross;;292;156;13;1412;1873
PhLeveilley;Philippe Leveilley;;328;119;4;1421;1872
Sylvianne1804;Sylvianne Solo;;1821;14;5;32;1872
the_captain_IA;Captain IA ð´ââ ï¸ Business Online;J'aide les corsaires du numÃ©rique Ã  dompter l'IA pour dÃ©cupler X10 leur productivitÃ© â­ï¸ Astuces avant-gardistes, prompts inÃ©dits et workflows inexploitÃ©s...;727;297;107;740;1871
ProjetEole;Eole project;"Eole project #innovant and #renouvelable
Wind #français #kickstarter launch 25.01.2023
Eole project is online now";142;505;289;934;1870
2Chomey;Chamy Duchesne;Chasseur de Wokes intersidéral;1235;116;24;494;1869
Le_Bon_Ours;le_bon_ours;;42;152;4;1668;1866
GoxSunu;SUNU GOX;;1844;12;3;5;1864
SlimTopic2010;Topic;Engagé, pragmatique et  précurseur !;1803;29;2;29;1863
ESSF_francais;ESSF_francais;;1755;26;15;67;1863
Q_deBremond;Quentin de Bremond d'Ars;"Directeur territorial Maine-et-Loire, Sarthe et Mayenne @GRDF
Président @GLEAMPimms
#ESS #Energie #GazVert #biogaz #bioGNV #méthanisation #mediationsociale";194;515;211;941;1861
AdrenalineLilie;Lilie;Projets #culturels - #FLE - #Communication - #Audiovisuel - #Environnement - #Développementdurable;1089;182;72;516;1859
LaCMTQ;Coalition montréalaise des Tables de quartier;La CMTQ rassemble les 32 Tables de quartier de Montréal. Pour des quartiers solidaires où il fait bon vivre!;828;344;410;277;1859
QCirculaire;Québec Circulaire;Québec Circulaire est une plateforme collaborative d'information sur l'économie circulaire au Québec.;826;194;484;354;1858
AlpiniGiuseppe;Giuseppe Alpini;;1794;47;10;6;1857
AkeOfoumou;AKE OFOUMOU ELIE;"L'honnêteté est une grâce en ce monde-ci.
Pour l'équilibre de notre planète, privilégions le multiculturalisme saint !
Non au néocolonialisme !
Tous égaux !";394;285;28;1150;1857
1001sallesPRO;1001 Salles PRO;"đ„ Les meilleurs prestataires pour vos Ă©vĂ©nements pro !
#MICE";885;500;277;193;1855
maccannister;Shub-Niggurath;2+2=5;1294;45;21;486;1846
0xSkiz;Skiz • Road to 1k/month 🚀;20 ans | Investisseur crypto depuis mi-2021, Robot de trading, Crowdfunding et move2earn | Objectif 1000€ de revenus passifs mensuels.;794;89;293;670;1846
SecondWindEsca;Faith;"Père au foyer
Escalade Bloc
Mangas & JV";1201;100;11;530;1842
AnnieBatier;Annie BATIER;Conseiller entreprises @CCI_93 mes intérêts : #TransitionEcologique #Numérique 💻 #Commerce 9⃣3⃣ DM ouverts;1286;118;35;396;1835
MabweniHeritier;Mabweni Héritier;"Économiste de  formation 
Leader, Chrétien et  SG de l' AJDP, Cadre @uncrdc";293;951;362;225;1831
StepLefebvre;Stéphane Lefebvre;Conseiller municipal de Cugnaux délégué à la mobilité. Groupe Cugnaux OSE. Soutien de la #Nupes.;520;129;127;1054;1830
El_Governor_nac;Mr. NAC;Juriste d'affaires, Manager en RH, Artiviste #DRH ET DAF ALSABA-GROUP;650;183;106;890;1829
investirpourtoi;Nicolas 📈;Investissement 🎯 | Walken 👀;453;189;686;499;1827
lapersobalcon;Ali Ababoua;Faites place, le prince arrive.;454;477;27;863;1821
ArnaudDevisme;Arnaud Devisme;;1237;270;52;261;1820
kalyo38;Merci;;1636;92;54;38;1820
EnerJmeeting;EnerJ-meeting;EnerJ-meeting c'est LA journée de l'efficacité énergétique et environnementale du bâtiment ! Prochaine édition le 19 SEPTEMBRE à la Cité des Congrès de NANTES !;470;59;413;877;1819
33AC64;AFT33;;1203;38;5;571;1817
NamaSellam1;Naïma Sellam;Conseillère municipale à @villeclichy Conseillère territorial Boucle Nord de Seine  Veille stratégique et veille de crise 📰👀;412;600;137;667;1816
Azar750;🌓;french 🇫🇷;1473;23;6;314;1816
RaphalAubert3;Raphaël Aubert;Time will tell, Patience will pay.;1442;34;20;319;1815
Numericommunism;NumeriCommunisme;Sur ce compte je répond au adepte du neoliberalisme. De manière + ou - véhémente;746;70;7;986;1809
JeanMabudi;jean pierre MABUDI;Né dans un village, la capitale du Royaume kuba mushenge, Territoire de Mweka, province du Kasaï. Licencié en Management, Gestion des RF, ISES Kananga;116;1063;186;444;1809
Mickaek10;Mickaël🇮🇹;je suis gentil;316;188;78;1226;1808
Imp_styx;Hyacine H.;;216;234;4;1353;1807
damien77000;Damien GUER;"Membre CDAPH/MDPH 
Seine et Marne
Politiques du handicap & de l'autonomie
Membre CCA SNCF Ile de France";562;317;157;769;1805
jacques_rocca;jacques Rocca;Première circonscription- Haute-Garonne, Pdt dept Alliance Centriste https://#31premiere;829;251;175;549;1804
Percypamler;Percy;;869;165;58;711;1803
FavrePh;Ph. Favre;J'adore me contredire pour réfléchir;1484;18;24;276;1802
jn_guerre;Jean-Noël Guerre;Directeur régional ADEME Bretagne Actualités, communiqués, publications #transitionenergetique #economiecirculaire #mobilite #ademebretagne;441;639;509;211;1800
Sichalain;SICHER Alain;"#NONAUPACTEENSEIGNANT
#OUIAU10%SANSCONDITION";1185;113;21;478;1797
jouassin_melie;Mélie Jouassin;Professeur d'Arts Pla et d'Hist des arts, @Langevinlycee et @Lakanal92, Chargée de mission d'Inspection Hist des arts @HdaVersailles, Formatrice disciplinaire;402;359;143;893;1797
prefpeaulisse;Sucre des Fesses;;855;259;75;606;1795
TOMJM11;TOM JM;;473;49;6;1267;1795
ChedelFund;Marco - CF;"10y as IT analyst in Wealth Management.
Investing in EMEA, Americas and Switzerland.
Learning about portfolio management, my tweets are not advices";821;168;62;743;1794
ArkaonGP;Arkaon;;323;454;37;977;1791
CFinalteri;Christian Finalteri Avocats;15, bd De GAULLE - 20200 BASTIA | T. 04 95 34 86 36 - F. 04 95 54 07 91 | cabinet-finalteri@orange.fr;1375;212;122;81;1790
iamsacha;Sacha Brasseur;Si Jesus revenait il serait crucifié sur Twitter;1137;172;79;395;1783
namkalinzamane1;Naïm-Kaélin ZAMANE;Spécialiste chargé de la coordination de la communication et plaidoyer chez Bureau du Coordonnateur résident du système des Nations Unies en Centrafrique;159;851;517;254;1781
bulbizar007;tomkat;;512;221;8;1039;1780
DijonMetropole_;Dijon Métropole;;373;37;1324;44;1778
PortdeToronto;PortsToronto;PortsToronto possède et exploite l'@AeroportBBishop, la @MarinaAPToronto, ainsi que le Port de Toronto | English: @PortsToronto;1609;9;66;94;1778
Nouv_Energie84;Nouvelle Énergie Vaucluse;"Compte officiel de soutien @DavidLisnard dans le Vaucluse
Pour une #NouvelleEspérance pour la France avec #NouvelleÉnergie
Pour adhérer payasso.fr/n";507;131;200;939;1777
FLallemant;florence lallemant;"Anesthésiste reanimateur urgences #ChruLille
#SfarGreen
#développementdurable";473;441;157;705;1776
BambizAltrui;Bambiz;La vie, voyez-vous, ça n'est jamais si bon ni si mauvais qu'on croit.;710;81;11;972;1774
BoussalemMahmo4;blm - mhd.;Vacant;1756;10;4;3;1773
Discord_GZ;Discord Génération Z;"Compte du serveur Discord Officiel de Génération Z

Retrouvez nous sur les Réseaux Sociaux:
linktr.ee/discordgz";702;60;493;518;1773
ChristopheDress;christophe75;"All Science, physics PhD 
Facts, order of magnitude";300;105;5;1362;1772
LPVal_de_cher;Lycée Val de Cher;Lycée des Métiers de l'Énergie et des Services;462;199;200;909;1770
Haiti1Dev;DevHaiti;Le Magazine du Développement Durable d'Haïti;795;104;323;544;1766
f_alabrune;Alabrune François;"Ambassadeur de France aux Pays-Bas @FranceinNL 
Représentant permanent de la 🇫🇷  auprès de @OPCW et @PCA_CPA";310;318;807;331;1766
Chrisca60966096;Chris can;;1137;104;7;517;1765
AVIVIANT;VIV;;510;190;52;1012;1764
PolarPodExpe;Polar POD Expédition;Suivez la nouvelle expédition polaire de @jletienne à bord du vaisseau Polar Pod dans l'océan austral #science #environnement #recherche #exploration #PolarPOD;561;134;943;124;1762
KankanSimbon;Simbon Kankan;;1079;41;15;626;1761
1554mito;1554mito;'Un grand penseur a dit que l'ignorance était au deux bout de la science. Peut-être eut-il été plus vrai d'y placer les convictions profondes' Tocqueville.;1710;25;7;19;1761
Kulski2;Kulskiđšđ”đ·đș;;771;336;21;632;1760
ROZOU;ROSE;;1668;22;9;60;1759
Thegoodfr;Thegood.fr;"Média B2B de la transformation écologique, sociale et solidaire des marques et des entreprises 
👉 Inscrivez-vous à ""The Good Newsletter"" ⤵";704;132;695;225;1756
AngenotP;Angenot patrick;;1143;49;24;540;1756
Aupa_Hormadi;Aupa_Hormadi;"Partisans de l'Hormadi - Passionnés de Hockey 🥅🏒🏟 
🟢🔴Anglet Hormadi Pays Basque🔴🟢 🏆Ligue Magnus🏆
🇫🇷Equipe de France🇫🇷";1631;41;19;65;1756
Hippolythe_FAGE;Hippolythe Mispelaere;L2 Droit ⚖️/ Vice-président étudiant @Crous_Normandie /Élu @Cnous_LesCrous @La_FAGE / Membre désigné au CAEN @ac_normandie;334;677;329;414;1754
fourchettenulle;Nfofifnn doing fork;male. Y’a des gens qui ont des problèmes de tempérament je suis là pour toi;541;216;14;978;1749
logis_t;Logis-T Africa;Logis-T Africa est un média dédié aux secteurs de la Logistique, du Transport et du Commerce en Afrique. Nous œuvrons pour valoriser le travail des différents a;863;304;132;447;1746
l_didelot;Patrick Didelot l'empereur;;1679;13;12;42;1746
CSinsens;Camille Sinsens;"5BCEFA
F5A9B8
FFFFFF
F5A9B8
5BCEFA

""Ce compte est un compte parodique, tout ce qui est posté par ce compte relève de l'humour, de l'ironie ou de la parodie""";1360;16;9;359;1744
abelainfo;Abelainfo;Abelainfo est un site d'informations bilingue qui traite essentiellement des questions de santé, d'éducation et de Collectivités Décentralisées.;1014;527;176;27;1744
zisimo21;simo zougari;“If you weren’t happy yesterday, you won’t be happy tomorrow. It’s money. It’s not happiness.”;1369;199;29;146;1743
AaCibang;Anaclet Musas Tshibang Jolinom Officiel;Diplômé en FLA, Breveté en journalisme,Droits de l'Homme,Entreprenariat,gestion des Entreprises,project management,Mbr Fondateur et Pdt Nat de l'Ajerd,une asbl.;93;1492;151;3;1739
Kurokasenseii;Kuroka;;1281;43;15;399;1738
Gensjoh;Johannes Gens;;1592;20;7;119;1738
presmatokeyo;Jeune président matokeyo futur président RDC🇨🇩;né à 2001/2/2 butembo /le futur président de la RDC diplômée à 2019-2020 sciences économiques leader en politique international 🇨🇩🇺🇸🇨🇦🇪🇺;584;551;83;518;1736
QuimperleVille;Ville de Quimperlé, Kêr Kemperle;L'actualité de la ville de #Quimperlé.;1120;179;279;158;1736
jeanguymatona;Jean Guy Matona;;73;184;10;1466;1733
Lyceefdegrace;Lycée Françoise de Grâce;Un lycée européen qui propose les formations des métiers des services aux personnes et aux entreprises;822;36;128;745;1731
DABENHAIM;DAVID ABENHAIM;Président @pharmabest_corp réseau de 116 officines en métropole, #Corse, #Antilles & à la #Reunion. Co-titulaire de la pharmacie Prado Mermoz #Marseille #Santé;526;614;248;343;1731
Rhode_Ruby;Pied de Biche;T’as gagné un ticket direction Fhlostone Paradise, c’est green !;977;158;8;587;1730
JLExpertise;JL Expertise & Conseil;Société d'expertise comptable implantée à Fort-de-France #Comptabilité #Expertise #Audit #Conseil;1553;51;126;0;1730
Lucxverf;Lucx;;1607;1;4;116;1728
tientegadimitr;Tientega Dimitri;Ingénieur en Génie des systèmes énergétiques et énergies renouvelables | Associé Gérant à PIC ÉNERGIE SARL | Directeur Exécutif à Jeunes Acteurs de l'Énergie;162;847;568;151;1728
dgatel;David Gatel;;209;502;133;877;1721
Likofata;Likofata Jean-Robert;Médecin spécialiste en Sante Publique, Gestionnaire de Programme et Chercheur en Sante mondiale. Travaille dans le domaine humanitaire depuis + 2 décennies.;1106;193;202;219;1720
AmbCanClimat;Ambassadrice du Canada des changements climatiques;Catherine Stewart, Ambassadrice du Canada pour les changements climatiques. Bio: ow.ly/p2Fg30klBvj Avis: ow.ly/YvsR30kPRRg English: @CanAmbClimate;764;43;850;60;1717
Tom_Wirion;Tom Wirion;Directeur général de la Chambre des Métiers Luxembourg;468;211;521;517;1717
Alexand77134791;Gandalf;Reflechi;1164;32;5;516;1717
ONGRGEDD;RGEDD;Le Réseau Gabonais pour l'Environnement et le Développement Durable est une ONG qui oeuvre pour la protection de l'environnement et le Développement Durable.;781;214;228;494;1717
olivierparibrun;Olivier Burnichon;;881;160;27;643;1711
CisseIs82385588;Cisse Issa;Amour du prochain;19;642;27;1022;1710
CanCaraibes;CanadaCaraibes;Missions diplomatiques du Canada aux Caraïbes l Anglais: @CanCaribbean;1393;39;189;87;1708
TRANSITIONVEGE1;CATS FOR FUTURE FRANCE;Une initiative de PLA EUROPE qui regroupe des associations, collectivités, fabricants, pour favoriser la transition végétale en matière de litières pour chats.;518;501;71;614;1704
TestaEfficity;Guillaume Testa - effiCity Lyon;;1288;131;43;241;1703
tiastgroupci;TIAST Cote D'Ivoire;Nous concevons, installons et fabriquons des machines agricoles.;393;55;38;1216;1702
JacquesGhisgant;Jacques Ghisgant;Business Dev. / Innovation MyOwnOpinion Curieux et Engagé born in 322ppm @EDFofficiel Low-fossil energies for sure !;544;574;152;432;1702
climat_montreal;Partenariat Climat Montréal;Le Partenariat Climat Montréal rassemble des acteurs institutionnels, économiques, communautaires et philanthropiques pour des actions concrètes liées au climat;593;97;552;457;1699
LissangaAfrika;Lissanga Afrika;Espace de collaboration des jeunes sur les projets impactants. Communauté des adeptes de l'intelligence collective. Adhésion : lissangaafrika.org/preinscri…;672;163;464;396;1695
Pascal_Orleans;Pascal d'Orléans;"Moi je m'en fous
j'ai un biclou";327;172;140;1054;1693
dom_dom_06;dom dom;nouveau compte après une suspension de l’ancien sans raison 🤷🏻;821;207;22;643;1693
yatinvest;Investisseur Lambda;đŻPetit Ă  Grand Patrimoine, suis moi pour dĂ©velopper tes finances đagis pour grossir ton patrimoine je partage mon expĂ©rience dans lâinvestissement;843;48;105;693;1689
OBVCapitale;OBV de la Capitale;Veiller à la pérennité de l'eau et de ses usages pour les BV des rivières Saint-Charles, Cap Rouge, Beauport, du ruisseau du Moulin et du lac Saint-Augustin.;314;679;229;466;1688
monpetitdz;Monpetitdz 🇩🇿;Monpetitdz permet de partager des photos magnifique et insolite à travers l'Algérie par sa diversité. #Algérie #Algeria #DZ #TeamDZ #Eldjazaïr #الجزائر  🇩🇿;618;106;41;922;1687
El_Quintus;El_Quintus;"Breton amateur de science, d'histoire et de sport - Chargé de mission Environnement et Biodiversité           

🔴⚫";396;112;161;1018;1687
GUILLER10460984;GUILLERMO ARANCIBIA;;983;367;165;170;1685
SebStanBono;Sebastien MATHERON;DÉLÉGUÉ TERRITORIAL Alpes du Sud chez @enedis_prov_alp ex : @lessupelec @centralesupelec;711;153;265;556;1685
baptistejouveb;Baptiste Jouve;;105;236;21;1321;1683
diegohidalgodem;Diego Hidalgo;"Entrepreneur, founder @amovens, Pontejos, Ballensworth, etc.
Author of ANESTHÉSIÉS (FYP) & ANESTESIADOS (Catarata).
Diplomat @OrderOfMalta
bio.site/diegohidalgo";918;180;266;319;1683
CrecDu;CREC Centre de recherche et d'étude du centrisme;Le CREC (Centre de recherche et d'étude du Centrisme) a pour but d'informer sur le Centre, le Centrisme et les centristes;1678;0;4;0;1682
ChrisDaudignon;✨ Chris ✨;;178;482;27;994;1681
davidvicente50;David Vicente;Basket-ball Fan đđđ ancien joueur amateur (vĂ©tĂ©ranđŽ et Ă§a piqueâŠ);353;68;2;1257;1680
arda_africa;African Refiners & Distributors Association;African Refiners & Distributors Association // Association des Raffineurs & Distributeurs Africains // جمعية المكررين الأفارقة;566;251;643;217;1677
jpz160685;jpz;"Salut à toi.
L'ouverture d'esprit ne se limite pas toujours à une fracture du crâne.";965;155;4;553;1677
rouaine04;berard;;1640;1;1;35;1677
Stylenew971;Stylenew971;;1654;9;5;6;1674
MahaBenGadha;Maha Ben Gadha;;353;557;329;433;1672
BenoitGirardet1;Benoit Girardet;(entrepreneur et) supporter nantais;1089;50;21;510;1670
orelnienergie;Orelni Energie;Ici, nous sommes passionnés par la préservation de notre #planète. #forêts #biodiversité #climat #transitionécologique;652;460;472;83;1667
OraneSorel;Sorel Orane;Acteur Politique congolais , Communicateur efficace de Force des patriotes/ @HonoreMvula1 Notre Président National;715;429;250;269;1663
hugostruna;Hugo Struna;Journaliste agriculture/alimentation @EURACTIV / @EURACTIV_FR;423;530;463;245;1661
CDeboos276;Christophe Deboos;#Normand, Entrepreneur social et environnemental, un de ceux qui sert parmi vous.;450;602;105;504;1661
VIVANT32738150;VIVANT;HORS NORME CAR BAPTISé et confirmé;951;38;3;669;1661
TribunalTroyes;Tribunal Troyes;Compte officiel du tribunal de Troyes. - Ouvert du lundi au vendredi de 8h30 à 12h00 et de 13h30 à 17h00 - Tel : 03 25 43 55 70 -;228;173;945;315;1661
CampagneSWEDD;Campagne Stronger Together;La campagne vise à assurer l’autonomisation des filles et des femmes à travers la scolarisation, l’accès aux opportunités économiques et aux soins de santé.;396;217;537;507;1657
chrisblanchet44;Christine Blanchet;Maire de @Loireauxence_44. Ingénieure divisionnaire de l'agriculture et de l'environnement @Agri_Gouv. Passionnée de🎻 et de 🏸, 🏃🏼‍♀️ , 🪂;445;240;249;721;1655
BrodyHood54;CryptoCashFlowššµ;crypto hunter #zilliqa $zil $xcad $vra $sand $floki;193;195;42;1221;1651
BenBulambo;Ben Bulambo;Je suis un congolais (RDC) qui parle 3 langues internationales (anglais, espagnol et français).;255;1012;164;218;1649
notjerome74;Jerome T;;1431;17;25;175;1648
spherelabmtl;SphereLab;"SPatial HEalth REsearch Lab, CReSP, Montréal, Canada            
Notre compte est géré par les membres du labo, tweets en français/ in English.";573;414;370;289;1646
SoubeyreJean;jean-philippe Soubeyre;;1395;42;5;204;1646
Rickornichon3;Bon Vivant (ɹɐq ǝp ɹǝıןıd);J’aime bien les GIFS Bon Vivant Fan de ⚽️🚗✈️🚜🕹🪐⭐️🍺🥃🔧🔭🎮;938;122;18;567;1645
PanssMama;PANSS;;692;30;20;903;1645
EffervescenceV;EFFERVESCENCE MTL;"EFFERVESCENCE 2023 se tiendra les 3 et 4 mai prochains!

Pour acheter votre billet → inscription.effervescencemtl…";821;94;417;310;1642
MPolymathe;musashi_polymathe;;539;90;4;1009;1642
Adama_Adama33;ادم بن ادم;;52;12;30;1548;1642
CIndustrielles;Collectif Startups Industrielles France;"Mettre en lumière & favoriser le dvpt de startups industrielles circulaires.
#Industrialisation #MadeInFrance #Territoires #IndustrieCirculaire #Souveraineté";644;83;304;611;1642
76deathrow;76DeathRow;La France, vous ne l’aimez pas ? Quittez-la !;717;44;14;867;1642
bendim_maya;Maya Zerrouki Bendimerad;Communication, médias, relations publiques;133;368;547;591;1639
veToker;veToker.eth;"Trader & DeFi Operator 💰
@CrossTheAges - Brinhold dady🐉 
@yadeck_off - Early 🏴‍☠️
₿ by nature - 🇫🇷";567;63;63;946;1639
ACXIAS;ACXIAS, l’agence Digital Achats;ACXIAS est une agence spécialisée dans l’optimisation et la transformation digitale des achats, des approvisionnements et de la comptabilité fournisseurs.;1150;72;352;63;1637
eericw;eric walter;;1019;570;45;2;1636
FrancoisYanda;yanda Jean François;;96;895;113;531;1635
olivier4363;Olivier;Avant j’étais au top, mais j’ai appris à être humble, maintenant je suis parfait !😇;502;232;12;889;1635
Pistismbala7;Pistismbala;"Doctorant en SPA, Enseignant aux Universités, Politologue, SG de la CONACAT, Président National du MRC et
Coordonnateur du Front des nationalistes Engagés, FNE";909;528;184;13;1634
Noxazer;Ben ð«ð·;"Developper. Crypto, Price Action, Fibonacci's Son.
Blockchain, IT, Nature before all
Vive la France, refaire lâÃ©tat franÃ§ais pour en Ãªtre fier ! #Revolution2023";462;197;16;959;1634
Pressefranco;UPF;Union internationale de la presse francophone;452;256;508;415;1631
GildasNgingo;Gildas NGINGO;;289;515;190;636;1630
AgicomEC;Agicom;;1540;40;28;19;1627
17Sciences;Sciences & EDD 17;Mission départementale Sciences & EDD pour la Charente Maritime (17) - Education nationale;281;229;131;984;1625
ebuildy;Thomas Decaux;Aime le vin français, le ping-pong, les challenges dans la tech (data & devop) et mes 2 enfants !;1180;45;88;311;1624
katon_wikii;Kyuro;.;728;0;5;891;1624
gignacclement;Hon. Clément Gignac, ASC, Économiste;Sénateur du Québec./ Senator for Quebec.;234;223;914;253;1624
Stonks_Corp;Stonks Corp;Juste un passionné d’économie et plus particulièrement des crypto;1391;100;11;122;1624
Chelilo5;Chelilo5;;1312;162;4;144;1622
MaireConstantin;Constantin Maire;"Passeur de talents - 11 ans en cabinet de recrutement
@Fyte_FR,@MorganPhilipsFR, @Acompetencegale, #staffing, #emploi, #job, #careers,#MarqueEmployeur,#i4Emploi";1486;77;54;4;1621
aue_corsica;AUE;L’AUE à fiancu à voi pe a transizione eculugica ! Nos équipes mettent leur expertise au service de vos projets d'#Amenagement et de maitrise d'#energie en Corse;779;94;603;145;1621
TeitelbaumAlej1;Teitelbaum Alejandro;Juriste international. Ancien représentant de la FIDH et de l'Association Américaine  de Juristes auprès de l'ONU. 93 ans.;1459;53;33;74;1619
NiafunkeyFadel;mohamed fadel sakho;;1454;123;21;19;1617
MDHALLEINE;Matthieu DHALLEINE;;209;178;56;1172;1615
naomi_morel5;Naomi Nya;Passionnée de medias, société et cinéma je fais des vidéos sur yt après avoir démissionnée. Je rêves de réaliser un film/documentaire en Afrique. J’y travailles;905;272;58;377;1612
KouassiNdaAmen1;Édith Kouassi;consultante en management de projets et développement durable.;80;1190;207;129;1606
FakeOff75;PđCk đđ;đ;1316;17;3;269;1605
Chronique_s;Biennale Chroniques;"CHRONIQUES - Biennale des Imaginaires NumĂ©riques
đź‘‰#CHRONIQUES2022
đź“† 10 nov 22 au 19 jan 23 
đź’ˇ ThĂ¨me : La Nuit
đź“Ť Marseille / Aix / Avignon";622;238;533;208;1601
BeaupreOlivier;De Beaupré Olivier;;1059;67;5;470;1601
VroniqueMai;Véronique De Mai 🇨🇵🇨🇵🇨🇵;;1218;88;46;244;1596
f_miranville;Frédéric Miranville;Président de @Univ_Reunion;218;544;462;370;1594
ForceDetal;DESTIN D'AFRIQUE;;249;1193;116;36;1594
PPuydarrieux;Philippe Puydarrieux;Directeur du Parc national de forêts @parc_nat_forets #parcnationaldeforets;288;502;342;461;1593
cecile_crichton;Cécile Crichton;Doctorante droit & IA;447;285;196;665;1593
AboubakarDiawa8;Aboubakar Diawara;Je suis un jeune actif;83;534;64;910;1591
ClgGace61;Clg J. Moulin Gacé;Collège Jean Moulin - Gacé, Orne, #CollègeRural labellisé #Génération2024,#E3D #Euroscol section excellence football, projets interdisciplinaires,  internat;800;96;365;329;1590
Negnegju;Neg38;Aimez vous les uns les autres, mais surtout aimez moi. đ€ en vĂ©ritĂ© je vous le dis, faites comme vous voulez, je m'en t'emponne le coquillard.;1314;105;19;151;1589
fnadac;FNADAC;Compte officiel de la Fédération nationale des associations de Directeurs des Affaires Culturelles des collectivités territoriales. #FNADAC 🌈#AssisesDAC🌈;763;302;300;221;1586
VivaCatalona;cequoicetruc;;1331;8;5;242;1586
NucEnQuestions;Nucleaire En Questions;"Une grande marche citoyenne de Beaumont Hague à Paris en 31 étapes du 24 juillet au 25 août 2021.
31 conférences-débats et de la musique.";756;114;194;521;1585
Lejeune_paris;Lejeune Christophe;;366;45;19;1155;1585
SeizhRuzHaDu;Seizh Ruz Ha Du 6⃣⭐ 3️⃣🥇 3️⃣🏆 #emojibzh;Breizh depuis toujours et Handballeur depuis 1989;545;119;4;915;1583
longinchris1;Chris Longin;;1513;8;16;44;1581
phi_citizen;Phi Citizen;"Être libre ce n’est pas seulement se débarrasser de ses chaines, c’est vivre d’une façon qui respecte et renforce la liberté des autres.
Nelson Mandela.";652;211;31;685;1579
ByLisio;LISIO;Découvrez les solutions LISIO et optimisez l'expérience utilisateur de votre site web : un affichage inclusif adapté à chaque visiteur et éco-responsable !;340;447;121;670;1578
chatallin;seb chatallin;;987;34;4;553;1578
romgromgromg;geronimo;"juste pour le plaisir 
aucun avis a donner
juste mes convictions";289;231;64;993;1577
ba_news_yacongo;Banewsyacongo;Média en ligne de toute information de la RDC voire même du Monde.;1278;4;47;247;1576
DahGbemavo;Grand Maître et Guide Spirituel Dah Gbemavo;Marabout sur Paris Récupérer son EX - Grand service garanti +229 62 01 78 96. Ouvert 24 heures par jour. Appelle de suite et obtiens 20% de réduction 7Jours/7.;455;825;196;97;1573
VergatiS;Samanta Vergati;Économiste du développement durable et de l’environnement, entrepreneuse sociale, développeuse de nouveaux modèles socio-alimentaires, consultante anti-gaspi;397;383;88;705;1573
Th_Guimbaud;Thierry Guimbaud;Directeur général de @vnf_officiel, engagé pour une #logistique fluviale durable, au service de tous les #territoires, acteur de la #gestiondeleau;385;411;557;212;1565
fvankote;fabrice van kote;Secrétaire général ANRH #emploi #handicap #RSE #biencommun #innovation #inclusion #ESS #transformation #digital @CometEntreprise @CelsaAlumni @UNEA_France;600;443;287;234;1564
FrensaUg;French Students Association of University of Ghana;Official Twitter account for University of Ghana French students  2021/2022;670;8;39;846;1563
TournanSamuel;Samuel Tournan;ð¸Photographe sur Paris. Argentique+numÃ©rique | ð¹Producer (R&B, rap, pop) | âï¸ Chanteur Gospel;681;93;42;743;1559
charlielie007;charlie lie ð§ðª;"ce qui est Ã©crit n'est pas qui je suis
discrÃ¨te je resterais sinon encore b Ã  n n i e je serais...";753;86;61;658;1558
Hendrix88995113;Hendrix;;799;16;5;737;1557
PierreMoninIDF;Pierre MONIN;Délégué Ile de France Engie;404;407;240;506;1557
DavidKonopnicki;David Konopnicki;Vice-Président du département des Alpes-Maritimes Délégué LR de la 8eme circonscription du 06;186;347;532;492;1557
NGORETRAORE;NGORE TRAORE;;931;38;25;562;1556
BenoitLemercier;Benoît LEMERCIER;Délégué Syndical Central CFDT de l’Etablissement Français du Sang;121;32;28;1373;1554
elhadj_fofana;Elh Abdoulaye FOFANA ð¬ð³;"Sociologue - Acteur de dÃ©veloppement
GÃ©rant de Rambany Services
ExResponsable Administratif de la VDP
SecrÃ©taire Administratif du Parlement des Jeunes de GuinÃ©e";239;534;331;448;1552
VilledeChenove;Chenôve;Compte officiel de la ville de Chenôve #chenove #dijonmetropole ville-chenove.fr;429;301;375;445;1550
Air_Day_10;Air Day;;1360;120;3;65;1548
SNIPFofficiel;Les Ingénieurs Professionnels de France;Fondée en 1936, la Société Nationale des Ingénieurs Professionnels de France (SNIPF) certifie vos compétences d'#ingénieur & rassemble 2000 ingénieurs certifiés;177;912;277;181;1547
BeghuinR;Beghuin Roger;;949;61;7;527;1544
AfricaBizLaw;ABLC;The African Business Lawyers' Club (#ABLC) brings together young #legal practitioners of various backgrounds to foster #Business development in #Africa.;722;312;309;201;1544
AssoEF;ExpressionsDeFrance;Vous avez des projets ? Vous souhaitez faire entendre votre voix ? Vous souhaitez prendre part aux débats citoyens ? Rejoignez-nous !;815;82;198;448;1543
BMbaudry;Marie Baudry;Head of Smart City and Innovation - Smart by Design #SmartUses #SmartCity #DigitalStrategy, #VR, #MobileApps, #IoT, #EcoCitizen #SmartByDesign;1028;197;94;224;1543
chomker;elwood blues;;1162;111;14;253;1540
AgneauNdjoku;ndjoku agneau;;685;319;26;509;1539
hugankills;Religion of peace;;1125;33;10;371;1539
ryan_clara25304;Clara Ryan;;427;549;202;360;1538
Horizons_SB22;Horizons Saint-Brieuc Baie;Compte des comités @HorizonsLeParti de @StBrieucAgglo : Saint-Brieuc, Plérin, Plédran et Saint-Quay-Portrieux #22 Rejoignez-nous !;232;427;349;529;1537
Esbi_Sport;EsbiMedia;esbimedia.com/cm/;623;99;216;596;1534
GH_Feurs;Guy Hoquet Feurs;Agence immobilière sur #Feurs #GuyHoquet #vente #achat #immobilier #location;1502;2;29;0;1533
AssociationApcm;Association de Promotion du Concept Mamp;"Promouvoir le concept Mon Anniversaire Ma Patrie et l'engagement citoyen.

Fondée par @ramasseudordure";662;9;157;703;1531
kardam82;Kar La Rage;Real eyes realize real lies;430;170;12;919;1531
cayracGerard57;cayrac Gérard;Ils ont torpillés mon compte chez tweeter abonnés et abonnements !?;961;111;15;440;1527
kabadjashi;Mbiya Kabadjashi;L'eau c'est la vie;537;448;475;67;1527
BennaniGhizlan1;eloise d'argent;curiosité insatiable;1006;114;33;373;1526
iamrayanhcn_;Rayan;"• Co-animateur des jeunes LFI-NUPES 91-10
• Pôle com' @jnupes91 |
langues étrangères + politique ✌️🌿🌏";387;203;50;883;1523
EmmanuelGouguec;Emmanuel Le Gouguec;"too old to die young
Strategy, Product innovation & Cost Killing
ENSTA 95, IHEDN AED 57";122;1092;29;279;1522
GwenPETILLAT;Gwennael PETILLAT;conseiller pédagogique 1er degré AEFE zone Amérique du Nord #Magistere #defimaths #defitechnosciences#fouleesolympiques#Rugbyalecole #Ludovia #quotichess;268;323;326;604;1521
rmlecutier;Lecutier Rose marie;;582;30;6;900;1518
SidiKIDA;Kobara Tweets;Combattant Infatigable, Militant Engagé pour la Démocratie Représentative, la Bonne Gouvernance et le Développement Intégré Durable;615;509;391;3;1518
ClimateSenators;Senators For Climate Solutions;We bring together, inform and support Canadian Senators who want to address the critical issue of climate change.;574;202;431;311;1518
bergy_300;Charley Bergy⛳️🏴‍☠️;;801;201;41;475;1518
RefeedG;Refeed Guinée;;176;243;68;1029;1516
TribuneEco;Tribune Eco;Tribune Eco est un magazine économique et entrepreneurial, qui vise notamment à informer, décrypter et analyser l’actualité nationale et internationale.;154;1003;207;152;1516
Coolspotte;coolspot;Quelqu'un de cool;1389;18;9;99;1515
MvanRigzel;M van R.;Pour se trouver, il faut d'abord accepter de se perdre.;295;19;10;1191;1515
taton_eric;eric taton 🇺🇦 🇫🇷;;549;21;2;943;1515
PastequePravda;daj;;58;325;13;1116;1512
tdldp;tdldp;"Digital Advisor, Cloud, IT, Digital transformation et accessoirement Chef d'entreprise. 
 
Ce compte n’est que le reflet de mes opinions personnelles #jve";1275;175;41;21;1512
RtsMonaco;RTS MONACO;Société de transport en autocar et minibus pour vos événements à Monaco et sur la Côte d'Azur.;31;1113;352;12;1508
chterrussot;Christine Terrussot;aimertoutle monde;1209;47;10;241;1507
GipsyWold;Gipsy Wold🌍🕊️♥️;Prenez soin de vous 🙏💖🌍piped.video/Qn0z-kS3E4E;827;26;24;630;1507
Adamniel11;Adam dam deo;tu crois quoi;1074;61;12;359;1506
stperret;Stéphane Perret;Elu local et enseignant #Histoire #Littérature #Culture #Italie  🇫🇷🇪🇺🏳️‍🌈;670;165;648;21;1504
masterHCPupjv;Master HCP UPJV;Compte du Master Histoire, Civilisations et Patrimoine de l’@UPJV_Univ.  Archéologie, Métiers des archives, Pouvoir et Sociétés, Phénomène guerrier.;665;552;211;75;1503
carolflore_undp;Carol Flore;Resident Representative UNDP Côte d'Ivoire;492;35;874;100;1501
ccvusp;Com Com Vallée de l'Ubaye Serre-Ponçon;☀ Compte officiel ❄ Communauté de Communes Vallée de l'Ubaye Serre-Ponçon 🌲 #CCVUSP #Ubaye #SerrePoncon #AlpesdeHauteProvence #RégionSud;261;109;184;945;1499
LouisaPaulin;Collège Louisa Paulin;Collège Louisa Paulin de Muret, académie de Toulouse @actoulouse @HauteGaronne @Occitanie;440;128;279;652;1499
adama_douk;BOUSSOUGOU Adama Doukouré;"Master en Analyse de Projets et Développement durable.

Secrétaire Général du Festival International du Livre Gabonais et des Arts (FILIGA) & Clean École.";203;400;93;802;1498
Rlespritlibre;Revue L'Esprit libre;Revue d'analyse politique et sociale sur l'actualité québécoise et internationale.;521;385;553;34;1493
Gilles39360;Gilles;;940;4;2;545;1491
groff_patrick;Patrick Groff;#Innovation #Renouvelable #EnR #TransitionEnergétique #Digital #Startup #Ettoitufaisquoi? @accelren Accelren.com @olenergies;814;176;136;360;1486
TMitth;Thrawn Mitth đ«đ·;;1023;65;1;394;1483
AlexB55170823;Alex.B đšđ”;Au lieu de gesticuler derriĂšre ton Ă©cran, engage toi localement pour faire avancer le Schmilblick, les politiques de canapĂ© et d'Ă©cran n'avance Ă  rien....;742;111;11;617;1481
cgamartinique;Centre de Gestion Agréé de Martinique;Le CGAM apporte une assistance à la gestion et une sécurité fiscale.;1451;11;17;0;1479
HSI_CanadaFR;HSI/Canada FR;HSI/Canada est un chef de file en matière de protection animale au Canada et fait partie de @HSIGlobal. Pour les mises à jour en anglais: @HSI_Canada.;478;731;194;76;1479
SagaPretreJean;Vespasien;La richesse est dans la différence*;1197;84;4;193;1478
malikaseguineau;Malika Seguineau;"Directrice générale du @PRODISS
Premier syndicat patronal du spectacle vivant privé en France - 400 adhérents #SpectacleVivant #Culture #Producteurs #Diffuseurs";390;460;442;186;1478
CafeGratiss;café douteux;une idée n a ni visage, ni nom ou aucune identité. Une idée n est pas la vérité elle se doit d être remis en question. bienvenue sur la page d une idée.;805;42;7;622;1476
fabien_bazin;Fabien BAZIN, Président de @nievre;Président du Conseil départemental de @nievre et de Nièvre Numérique. Concepteur du #BouclierRural et acteur des #VillagesDuFutur;584;400;475;17;1476
DrNu007;Fred No;Insatiable;1355;15;5;100;1475
GaramaSaratou;M. Garama Saratou Rabiou Inoussa;Ministre de l'Environnement et de la Lutte Contre la Désertification Niger.;164;78;1123;108;1473
jemilaaaa;jemmmmmm;;1239;75;11;147;1472
teomazepaMPG;Mazépa Téo;Le groupe Morgan Philips réinvente les codes du recrutement, de la chasse de têtes et du conseil en gestion des talents;1450;16;1;5;1472
Cambray96434098;Cambray;;1095;294;29;51;1469
Victor_Wied;Victor Wiedemann;"#JTGE 2019, 21 ans déjà..., vétéran du monde noir de l'accueil et de l'écoute psychologique. TPST/TDAH ?/TSA ?/TDI ?
Who Dares Wins. British Special Air Service";556;100;32;781;1469
sofiouest;Sofiouest;"Humain et Capital
Services d'investissement";1008;157;139;165;1469
EPuteaux;EELV Puteaux;Compte twitter des écologistes de Puteaux.;548;351;287;280;1466
TerangaNature;TerangaNature;@TérangaNature est un site d’information sénégalais, spécialisé dans le développement durable.;768;424;179;94;1465
SINGSAGabon;SING SA;#Innovation #Numérique #Digital #Gabon #Afrique;488;67;631;277;1463
gillesh38;Gilles Henri;stick REALLY on science;1291;67;9;95;1462
Potus31109614;Potus;;783;143;29;506;1461
SUD_TELEVISION;SUD TELEVISION;Canal d'informations sur et pour la Région Sud Provence. Culture, Economie, Sports, Tourisme, Patrimoine.;1450;4;6;0;1460
GradassiK;KOSSI GRADASSI;KOSSI GRADASSI, #courtier en #assurances à vos côtés, la proximité d'un service dédié aux professionnels et très petites entreprises (TPE). DEVIS personnalisé;1065;228;32;133;1458
TrendSourcing;Trend Sourcing;Un regard transversal sur le mieux-être de la personne : santé, beauté, alimentation, habitat, éthique, retail, sport, spa, médecines, work, health tech, design;890;274;287;3;1454
JoelMandono;Joel Mandono;;497;132;172;653;1454
romainpoulles;romain poulles;;875;208;268;103;1454
MaldororX;xxx;"Nos besoins sont à la base de nos valeurs, du sens et de l’ordonnance de notre vie

Social value=0";689;81;2;679;1451
StphaneLenorma1;Stéphane Lenormand;Député de #SaintPierreEtMiquelon;545;113;214;578;1450
ChEureSeine;CH Eure-Seine;CH eure seine;522;234;339;354;1449
mysublimecandle;โจ๏ธ ๐๐ฎ ๐๐ช๐๐ก๐๐ข๐ ๐พ๐๐ฃ๐๐ก๐ โจ๏ธ;"fondants parfumรฉs ๐ 
Gamme de musc intime ๐ฆ
Bougies Gourmandes ๐ธ

instagram.com/mysublimecandlโฆ";431;371;323;321;1446
brahima03605822;İbrahim;كل نفس ذاءقة الموت🇳🇪;256;269;58;863;1446
DurabiliteComm;Groupe DURABILITÉ|COMMUNICATION;Pôle d’expertise sur les enjeux de la communication, du DD, de la RSO et de l'éthique en communication. Établi au Québec, actif à l'échelle internationale.;227;671;197;350;1445
ValmontEdgar;valmont edgar;"anarchiste libertin confit au rhum et bronzé au bbq.
minimaliste anti gaspillage et surconsommation.";1432;0;6;5;1443
TSXV_NGC;NORTHERN GRAPHITE CORP.;Northern Graphite Corporation is an Ottawa-based Canadian mine development company in battery grade graphite.  TSX-V: NGC and OTCQB: NGPHF;833;65;486;57;1441
peged_pnud;PEGED PNUD;Le Programme Environnement (PEGED-CN) vise à renforcer les capacités nationales de la Guinée pour une gestion durable du capital naturel.;275;244;200;722;1441
basse01513093;basse;;414;32;4;990;1440
PLentisque;prele lentisque;;1078;111;2;248;1439
TriplePerforma1;Triple Performance;tripleperformance.fr la plateforme de connaissance en agro-écologie, pour les agris en transition.;279;788;325;46;1438
Costavictor8;Costa victor;;484;57;17;880;1438
RhoneVallee;EnergieRhôneVallée;Producteur #énergie renouvelable l’Opérateur au service des #territoires #Drôme #Ardèche #énergies #éolien #photovoltaïque #hydraulique #développementdurable;477;411;305;243;1436
BellatonOpinion;BELLATON guillaume;;212;370;74;780;1436
arnauddubief;Arnaud Dubief;Accelerating solutions to beat climate crisis. Currently at @ashydrovolt // Co-founder @asso_toi_aussi;565;205;133;531;1434
sanaa_dn;Sanaa N;Head of academic relations @ENGIEgroup;387;350;142;555;1434
KellyDavoust;Kelly Denise DAVOUST;L existence précède l’essence. Maire déléguée de BEAUFOUR DRUVAL , Vice -Presidente de Normandie cabourg pays d’Auge;254;704;189;286;1433
deinceps;deinceps;;249;167;30;985;1431
FxpTHORIGNE;Ferme expérimentale de Thorigné d'Anjou;;278;133;487;532;1430
Maxime92160;maxime92160;;568;231;44;586;1429
hervebigal;hervé bigal;C.E.O de INFLUACTIVE Agence digitale, PR et SOCIAL MEDIA. Métier et passion.#mediasociaux #digital.Lieutenant Colonel (RC) Armée de l Air et de l'Espace BA 942;749;218;182;280;1429
Sdrmasaki;Sandro Masaki;Chrétien. Doctorant en Génie électrique. Enseignant. Entrepreneur. Consultant.;382;65;142;837;1426
GroupeSepamat;Sepamat, Créateur de solutions automobiles;"🚗♻️ Depuis 1970, nous développons des solutions pour réduire la part de voiture individuelle au profit d'une utilisation raisonnée. 
#MobilitéDurable";1172;116;60;75;1423
HenriBaile;Henri Baile;"Maire de Saint-Ismier
Président de la communauté de communes Le Grésivaudan
Conseiller Régional";499;215;363;346;1423
LaRenaissance71;La Renaissance;Le compte Twitter de La Renaissance, hebdo en #SaôneEtLoire et dans l'#Allier #PHR #Info #Presse;1360;6;55;1;1422
Pasunmouton2;Pasunmouton;;1332;82;5;2;1421
LeMondeDavec;Le Monde D’Avec;🎙 1er podcast gouvernemental présenté par @MarleneSchiappa et dédié aux acteurs de l’économie sociale et solidaire et de la vie associative.;133;677;310;292;1412
YMuadi;Étoiles;;902;135;33;342;1412
M_i_c_r_o_c_o_s;ALIمرغني;Project Analyst;262;944;39;164;1409
Stephane_POIREL;POIREL Stéphane;;1051;65;60;232;1408
associationjaie;Association JAIE;Association œuvrant dans l'#éducation, l'#intégration, le #leadership des #jeunes pour un #développement #durable.;678;266;45;416;1405
DudesertFred;Fred Dudesert;;807;61;8;527;1403
MpciGov;Ministère du Plan et de la Coopération Int'l;Compte Twitter officiel du Ministère du Plan et de la Coopération Internationale. 🇬🇳;367;28;937;70;1402
nicolas_4750;Nicolas­čçĘ­čçÁ­čçÁ­čç╣;"@FCPorto­čĺÖ
@F1­čĆÄ
@SCSSoftware­čÜŤ";278;494;27;602;1401
CommEnergieOnt;CommEnergieOnt;"Nous réglementons les secteurs de l'énergie en l'Ontario
En utilisant les tweets de la CEO=votre message peut être publié sur notre site Web
Retweet ≠ appui";1242;94;22;42;1400
equiinoxes_;equinox🇨🇵🏳️‍⚧️;;1154;36;5;203;1398
EModernisme;Ecologie & Modernisme;Réseau environnemental ayant pour objet de promouvoir une écologie réaliste, humaniste et innovante. #ecomodernisme #écologistesnonVerts;812;127;119;336;1394
ChardonJmc;J-M Chardon;Préserver la diversité des #paysages, la singularité de l'#environnement et l'élégance du #patrimoine dans le bouleversement du monde et le choc des cultures.;321;39;7;1027;1394
ChapuisCh;Christophe Chapuis;Premier secrétaire fédéral du PS de Loir-et-Cher. Conseiller municipal de Vendôme. Conseiller communautaire de Territoires Vendômois;151;347;160;731;1389
stagiaire_union;Le Stagiaire;Mes opinions n’engagent que moi et pas tous les stagiaires de France;570;357;9;448;1384
PerformoT;Performo Tedo;"i have shaed all documents videos and best praticess guides for QHSE maangement and power management
qhsetools.com/";996;243;21;118;1378
C2abcom2;C2abcom;Écoute Réflexion Action;488;312;64;513;1377
AdrienCastex;Adrien Castex;Créateur et romancier passionné par la science-fiction, l'intelligence artificielle et les modèles sociétaux.;483;38;8;847;1376
Glawdys30078570;Glawdys Akete;Civil aviation officer/consultant;513;54;34;773;1374
chanstransports;Claude-Henry & ses périples;"Compte dédié aux transports urbains dans sa globalité à travers la photographie. 
RDV sur linktr.ee/claudehenryets…";122;913;297;42;1374
OMGA_74;OMGA 74;OMGA 74 est une #association à but non lucratif créée en mars 1977 à l'initiative des #experts comptables du département et agréée par l'Administration fiscale.;1362;0;10;0;1372
PcqvpM;PCQVP MALI;;142;798;271;160;1371
ise_uqam;Institut des sciences de l'environnement de l'UQAM;L'Institut des sciences de l'environnement (ISE) est un lieu de concertation et de coordination interdisciplinaires en sciences de l'environnement;497;164;545;164;1370
AymericJoinLamb;Aymeric JOIN-LAMBERT;Mettre en oeuvre la #transitionénergétique des bâtiments et de l'industrie, développer les #EnR, produire de l'hydrogène vert;747;96;137;389;1369
thiombianoyaci1;thiombiano yacine;promoteur de kalmanma automobile et maintenance;545;50;13;760;1368
jlazeras;Juliette&Ecolo;Pour consommer, manger, se déplacer, vivre mieux en respectant la planète. #environnement #climat #nutrition #reductiondechet;973;211;83;100;1367
lemoulincanada;Le Moulin Microcrédits;#Financement par micro-prêts allant jusqu’à 15 000 $ aux personnes #immigrantes qualifiées afin de soutenir leur réussite professionnelle. EN: @windmillcanada;454;139;41;733;1367
lenders_sam;Lenders Sam;;396;783;174;14;1367
DegravePhil;Phil Degrave;;180;29;1;1155;1365
RenouveauBxM;Renouveau Bordeaux Métropole;Le groupe d'élus progressistes à @BxMetro.;507;100;279;478;1364
collegeJMoulin;Collège Jean Moulin Chartres;Sport, Arts, Langues, Sciences (sections athlé, subaqua, CHAAP, LCE, latin, DNL, informatique…).  Et des dispositifs pour toutes et tous : ULIS, UPE2A, EHP.;153;180;191;839;1363
MeilleurCoub;Vox-Artifhistoire;"Abonne toi ou cancer.

#histoire #humour";624;66;654;18;1362
Olivier_TLSE;Olivier_TLSE;Citoyen impliqué. Scientifique.;496;30;4;830;1360
Tayiro_officiel;TAHIR MAHAMAT SALEH ISSA;ENTREPRENEUR, PROMOTEUR, INFLUENCEURS;199;42;26;1093;1360
RaoulEmaha;2sans7;;1105;73;7;173;1358
PhilippeMaison;Philippe Maison;"Sustainable Developer / Expertise Transmitter / Intermediate between question and answer / Data analyst ***
The views expressed on my twitter are mine alone ***";404;353;77;524;1358
jbleducq;jbleducq;"Assistant Professor, looking for patterns in chaos, with science and art.
Microbe and plant evolutionary ecology.
@universitelaval
github.com/JBLED";187;221;283;666;1357
sartout;lydie sartout;directeur Projets et Solutions pour les territoires - #enedis #transitionenergetique #territoires #données #smartgrids;300;155;253;649;1357
Bapho66;Baphomet;"Scepticisme, rationalité, athéisme.
En faveur des sciences, des OGM et du nucléaire.

Hail Satan !";421;99;5;832;1357
ChristianYvesM;Christian-Yves MAMPUYA;Founder & CEO at Makuta Technology SAS (Bank Switch, Mobile Money, Online payment, Card personalization, Money Transfer, Card payments processing...).;873;232;43;209;1357
Befalimpertinen;Befa Limpertinent;;200;194;6;956;1356
Calif_solutions;CALIF;Conseil #affairespubliques #influence #lobbying #territoires #entrepreneurs depuis 2009, membre de l'AFCL - Leader en Auvergne-Rhône-Alpes;425;218;270;442;1355
Loraineroncin;Loraine;Responsable des Relations Extérieures et des Partenariats @AACClive ex/@SixiemeSon et @presidents_les @icibarbes;846;187;142;177;1352
CentrERE_UQAM;Centr'ERE;Centre de recherche en éducation et formation relatives à l'environnement et à l'écocitoyenneté | UQAM;348;433;498;73;1352
Blobsilver;Cruce Wayne;Justicier masqué;219;322;15;794;1350
SceauxEnsemble;Sceaux Ensemble;Groupe municipal Ville de #Sceaux (92) élus #LREM, associatifs, n'appartenant pas à la majorité. #AvecVous;395;414;93;446;1348
NewWor22;New World;New World est une Organisation qui à pour mission de soutenir et d'améliorer par tous les moyens, les conditions de vie des populations défavorisées .;148;484;125;590;1347
Chricie29;Chris M;Assignée à résistance  - citoyenne engagée pour la défense des libertés;350;2;4;991;1347
MagloireAhisso1;Yml Ahs🙊🙉🙈🇧🇯😇;Panafricaniste.;342;82;25;898;1347
lejetdetamaman;kingofmanmanw;jon snow made in fgy đŹđ«đ«đ· ici je provoque en tweetant sĂ©rieusement de maniĂšre non sĂ©rieuse;480;241;50;575;1346
JusticeSocial10;Justice Sociale;;322;86;4;933;1345
Flore2860;Florence GUIGNIER;Opticienne passionnée, j'aime accompagner vers le bonheur et le bien-être, à commencer par la vision;263;76;31;974;1344
vbriat;briat vincent;"#Affairespubliques @RTE_Aura
#TransitionEnergetique
#MarkalTimesForever
tweets my own & RT not endorsment";408;330;51;555;1344
JusteLeo18;Juste Adeyori;"Learn Digital Maketer Pro,
CryptoEnthousiast, Web3 Activist, Ai, Géomètre Topographe,
Passionné d'Économie et Finances";209;175;20;940;1344
laurette1608;Laurette Duranson;;762;238;40;304;1344
C21_Eurogestrim;Century21Eurogestrim;Crée en 1999, notre agence fait partie du réseau CENTURY 21 depuis 19 ans et se situe au 25 boulevard Renouvier à Montpellier;174;700;464;5;1343
gauche_chalet;La Gauche Chalet ðºð¦;Fondu de flocons de neige. Amateur de cuisine woke. PrÃ©fÃ¨re la lutte des classes Ã  la lutte des races. Demi-bisexuel(le).;1118;165;25;34;1342
RaeddOng;RAEDD-ONG;Recherches Actions en Environnement pour un Développement Durable - ONG;157;679;359;147;1342
seitzdavid34;Seitz David;Praticien Reiki et Massothérapeute;143;293;51;854;1341
psykop_;psykop;;873;52;10;404;1339
GraceEbuwe;Grace Ebuwe M;Président of Cohésion BUSINESS GROUPE S.A.S /Publiciste of Université de Strasbourg /France , Trader certifié Price Action              Cadre du parti UNC;217;612;305;204;1338
yves_laszlo;Yves Laszlo;Mathématicien, Prof. IMO Université Paris-Saclay;337;143;105;746;1331
WiMamm;WM đđ;Donât forget to look up;432;117;8;774;1331
JeunesMacron65;Les Jeunes avec Macron 65;Compte Twitter des jeunes rassemblés autour d'Emmanuel Macron dans les Hautes-Pyrénées #TeamMacron #Macron;385;153;344;448;1330
Zangetsu__;Ulquiorra;IngĂ©nieur đźŚ‘;815;45;9;461;1330
Shantico3;Shantico;Conspiracy Realist | Tweets are not real life;1043;42;9;236;1330
BenjaminBlancBB;Benjamin Blanc;Responsable @HorizonsJeunes pour Toulouse đ 50% @SciencesPo_Tlse - 50% @INSAToulouse;153;406;255;516;1330
Enermatique;Dioxydehusband;Anti-anti đ„ CO2 husband;686;39;26;576;1327
RochasXavier;#XavinGap;#Gap #HautesAlpes #AlpesduSud #Histoire #Climat #Transitionécologique #Transitionénergétique #changementclimatique #adaptation;42;377;14;888;1321
FPCIRGL;Forum of Parliaments of ICGLR (FP-ICGLR);The FP-ICGLR is an inter-parliamentary organization composed of 12 National Parliaments of the ICGLR Member States;719;337;234;28;1318
J_De_Lille;J DeLille;Ecolo depuis toujours, présentement éco-anxieux et en passe de devenir écolo-rageux... pour me calmer, je plante des trucs et je les regarde pousser.;763;170;18;366;1317
socialenergie;Centre d'Appui SocialEnergie (CASE);Soutien aux travailleurs sociaux et plaidoyer sur les questions énergie et eau. ⚡💧  Un projet de la @FdSS_FdSSB (FR/NL/EN);613;193;68;442;1316
onditquoimag;On Dit Quoi Magazine;Revaloriser, découvrir le Gabon dans son mélange tradi moderne. Présenter ceux qui font bouger et avancer le Gabon, tel est l'objectif de notre magazine...;285;209;588;233;1315
ElisabethNyombo;Me Elisabeth-NYOMBO;;145;521;425;222;1313
Kiala1_Man;Man David KIALA;Personnalité publique, Chercheur en Sciences Économiques, Cadre de l'UDPS et Président de l'ONGD ZECO;99;149;894;168;1310
glody_tadia;tadia mbula glody;expert comptable, entrepreneur, leader et acteur politique .#nous sommes le seul espoir pour le développement de notre pays .;199;767;77;266;1309
MilamberLeMage;Lu Do;;612;9;2;686;1309
Steph062012;sora 3175;;737;32;24;515;1308
VRM_ca;Villes Régions Monde;Villes Régions Monde est un réseau interuniversitaire voué à la diffusion, à la valorisation et à l'animation de la recherche en études urbaines au Québec.;317;396;527;67;1307
H2Lepinau;Herve De Lepinau;député de Vaucluse;137;285;648;235;1305
celine_barto;Céline Bartolomucci;Software engineer yesterday, environmentalist today. Nature addict always. 🌍🐘🌱🦉 #nature #conservation #biodiversity #sustainability;306;470;99;429;1304
LoustaudB;LOUSTAUD Benjamin;;921;22;7;351;1301
selorh82;silue selorh;;1160;63;2;75;1300
SamVenere2022;Sam Venère;Citoyens engagés. Informer, alerter, signaler, s'indigner.;685;138;27;447;1297
Uriel_Codjie;uriel-codjie.wallet;;811;190;82;213;1296
YSDAYSDA1;YSDA;ð©contact@ysda2014.org;657;21;37;581;1296
MatthieuHes;Matthieu Heslouin;Chief Digital Officer @Bpifrance▪️Proud Founder of Digi4b, @voulezvousdiner, and @Wipolo;499;174;371;252;1296
EcoDetay;Eco-Detay;"Prce que l'économie est trop importante pour n'être comprise que par les économistes.
Notre vision: Réconcilier le 🌏 universitaire haïtien et le citoyen lambda";256;507;471;62;1296
mwHerby;MW;Biography;931;121;10;233;1295
Poudingue4;Poudingue;;749;136;7;403;1295
Idris83161907;Idris;;349;752;183;11;1295
notokopaul;Paul Ndakala;Never give up;102;101;12;1078;1293
Vincent7033;Vincent;;102;450;13;728;1293
DocGaster;Hugo;đ Fac dâHistoire GĂ©ographie Aix en Prov L1 | đ»passionnĂ© de la GĂ©opolitique et le Monde | Vice President chez @assomeridio | @HorizonsLeParti;117;676;90;410;1293
muzito;Archi. KoolerMan;Architecte de formation, né et résidant en RDC, soucieux d’un environnement sain et sauvegardé par tout être humain, pour l’intérêt de l’humilité entière.;237;556;307;192;1292
nowoxo;Seb;;686;113;7;483;1289
cbrusset;Christophe Brusset;;673;367;141;106;1287
duodecimal_;DUO DECIMAL;Expertise-comptable;1134;98;46;8;1286
RbaGroupe;RBA Groupe;;1280;0;4;1;1285
SolvoCollectif;Solvo;Collectif de journalistes, orienté solutions. Plurimédia : presse écrite et #web, #photojournalisme, #radio et #podcast, #vidéo TV et web. #sojo #journalisme;631;257;320;77;1285
FoncelJerome;Jérôme Foncel;;272;406;127;478;1283
CannoisJean;JeanMichCannois;"Appelez moi JMC.
Attaché à sa ville, ses paysages et traditions, sa richesse culturelle, sa force sportive.";1242;12;19;7;1280
fabienvillard49;fabien villard;Angevin chauvin;926;118;112;121;1277
TITI901;FRED;;762;122;7;385;1276
DEBATDACTU_;@DEBATDACTU;đđđ;186;209;6;874;1275
Walterd95593360;Walter de Oliveira;Nec plus ultra;212;110;103;849;1274
GuergBen;G. B.;Consultant en Management, ouvert sur notre société, son fonctionnement et son futur.;469;60;28;717;1274
StephChatelin;Stéphane Chatelin;Directeur de @nWassociation (anciennement investi dans @dromolib et @ENordEst). Où va-t-on ? Pourquoi ? Comment ? #sobriété_efficacité_renouvelables #négaWatt;741;107;387;39;1274
boniface_ngani;Boniface NGANI;Jeune leader, Jeune Ambassadeur DKT international, Activiste de droits de l'homme, homme de la parole, libre penseur, étudiant en Médecine,...;146;691;226;210;1273
lowtechs;Actualité sur les low-techs;"Toute l'actualité sur les low-techs en temps réel.
Un media @influence_sol.
#lowtech #low-tech";691;1;579;2;1273
benl1k;benlik;Dans la vie a la difference des echecs, quand il y'a echec et mat la partie continue.... // Snap: adamlik;654;233;269;114;1270
MesnageImmo;Christelle Mesnage Immobilier à Dinan et environs;Les professionnels de l’agence CHRISTELLE MESNAGE IMMOBILIER au coeur de DINAN vous conseillent pour acheter, vendre ou louer votre bien en toute confiance;1211;23;32;2;1268
VIENSflashmober;Etat d'urgence;Insurrection permanente, alternative à Punishment Park.;1011;126;19;111;1267
BCheokh;bouh cheikh beibih;;255;695;295;21;1266
PlazaParis15;Stéphane PLAZA immobilier Paris 15 Suffren;Agence Stéphane Plaza Immobilier Paris 15e 157, avenue de Suffren PARIS 75015;937;86;172;69;1264
diag_partners;Diag'Partners;Nous vous accompagnons dans tous projets ! #diagnostic #immobilier;644;508;92;20;1264
Son_OfSamuel;Bobby Smiles;"Studying ūü™ôūüíĶūüí∂ at @SolvayEDU
, mainly talking about E&M Governance, Finance, banking But also sometimes sport like cycling";392;211;24;636;1263
caydave97200;David Berger;;1179;11;3;68;1261
JehanAngoDieppe;Lycée Jehan Ango Dieppe;;591;87;515;67;1260
Groupement_ACP;ACP;Assistance Courtage Partenaire : Le groupement des courtiers indépendants en assurance & protection sociale;1228;15;15;0;1258
Meryam50994480;Meryam;;1213;20;0;24;1257
RechercheAvenir;Recherche et Avenir;L'association facilite le #rapprochement entre #Laboratoires et #Entreprises, favorise les interactions entre #Recherche et #Industrie, Éducation et Culture...;582;132;358;185;1257
Mika_san38;MikaMa;Haut fonctionnaire, 4 fois vainqueur de la C1, chroniqueur au NY Times, chevalier de la legion d’honneur, ex gouverneur de la banque centrale du Japon;416;113;7;720;1256
Rem_CW;Rem;;431;218;3;603;1255
jacinthegagnon1;jacinthe gagnon;Mère & Militante politique  et passionnée de démocratie.   Ce que je tweet n'engage que moi;628;380;161;83;1252
FabienMorrow;Fabien Morrow;Cynical French-American;765;90;39;357;1251
Paypalzinor;Alzinor;"Insurance agent IRL💵💵💵
He/Him ♂️
Twitter is like a zoo, but at least here, you don't have to pay to see monkeys 🐵 🙈 🙉 🙊 🐒";1050;37;30;132;1249
k_migagaya;Migagaya Kévin;"Étudiant chercheur en science des interactions entre les propriétés physiques, chimiques, biologiques et des composants de l'environnement 

#therwandansarnazis";510;188;202;349;1249
Tradingfloww;Florent PZT;Trader particulier, analyse technique. Mes tweets ne sont pas des conseils d'achat.;396;106;243;503;1248
OusmanKodo;Ingénieur Moussa ousman kodo🇷🇴🇨🇲;"Je mesure 1,82 mettre et 71 kilogramme.
Je suis ingénieur en génie industriel et maintenance. Je suis célibataire sans enfant.";187;722;230;108;1247
JWick2345;John_Wick2345;;333;267;3;644;1247
MudimbiLazzy;Lazzy K. Mudimbi;Fonder & Président at GerardKM Group LLC.;790;82;98;275;1245
BotikalaDaniel;Daniel Baseke Botikala;Telorga ULB;516;537;143;49;1245
marieamelie_l;đMarie-AmĂ©lie Lenaerts;Journaliste spĂ©cialisĂ©e enjeux des ocĂ©ans @rtbf @lecho @oceansconnectes | Navigatrice | TraversĂ©e de l'Atlantique Ă  la voile en solitaire #minitransat2019;182;467;287;308;1244
marchadouroliv;Marchadour Olivier;;921;225;3;93;1242
ExpaceoOfficial;Expaceo;#EXPACEO est un cabinet de conseil informatique spécialisé autour des nouvelles technologies #Microsoft, centre de formation agréé par l’état français.;418;199;41;582;1240
GZrB12;G;Psychologue de comptoir diplômé, éditorialiste, amateur de tofu et de nains de jardin;474;56;10;700;1240
MeinhardSteinb1;Meinhard Steinberg;Internet est le produit d'une combinaison unique de stratégie militaire, de coopération scientifique et d'innovation contestataire.  (non ce n'est pas de moi );925;107;13;195;1240
ongddb;ONG Développement Durable Et Bien-Être;;61;481;109;589;1240
AguyMelchy38269;Fritz Robert Louis Jean;06 Mars 1979;624;193;17;401;1235
MaiteVezina;Maité Blanchette Vézina;Députée de Rimouski, ministre des Ressources naturelles et des Forêts et responsable de la région du BSL et de la région de la Gaspésie–Îles-de-la-Madeleine;262;194;494;284;1234
tphilippet;Thierry Philippet;;1173;12;3;45;1233
avenirattendpas;L'Avenir n'attend pas;Changer la façon dont se prennent les décisions politiques en construisant ensemble, assos et politiques, les solutions de demain. Présidente @juliettemeadel.;402;191;385;253;1231
MichelVialatte;Michel VIALATTE;Michel Vialatte, 63 ans, ancien élu du Doubs (conseiller général et ville de Besançon), est ancien administrateur général territorial et écrivain.;319;242;202;468;1231
CELESTPH;Philippe CELESTIN;"Agent Général AXA
Associé fondateur ARTEMIA Technologies
Maire Adjoint Ville de Dourdan (Essonne)";1151;36;20;23;1230
ARCHAMBAULTLuc3;ARCHAMBAULT Luc;Je retranscris des vieux livres d’histoire, les corrigent. J’écrit aussi des passages de l’histoire à partir de vieux documents en compilant diverses sources;1101;20;18;89;1228
godet_jeremie;Jérémie Godet 🌻🍉;"2ème Vice Président de la Région Centre Val-de-Loire
Co-président du groupe Écologie et Solidarité @Elus_EetS_RCVL";186;590;403;49;1228
yvaSme;Yva Souriac;;930;92;16;188;1226
y_elaoufir;Yasmina El Aoufir;Conseillère en Développement Durable dans le secteur de l’éducation. #SDGs #ODD #Sustainabledevelopment #Climatechange #RSE Tweets are my own ➡️ 🇲🇦🇨🇦;270;650;127;179;1226
RusselOuedraogo;Aaron wendveneem;;366;600;19;241;1226
LesPagesdArda;Ardanxela;#Streameuse à mes heures perdues, affiliée @Twitch, Paris, France 🇫🇷 twitch.tv/ardanxela       📚 Bookstagrammeuse passionnée : Roman, Manga, Webtoon;482;122;76;544;1224
BaudJeana;BAUD JeanÀ;;1177;13;0;34;1224
PierreLLoup;Pierre L. LOUP;"Investisseur. Analyse actions, small et mid caps.
Chaîne YT : piped.video/c/Patrimoineen…
Newsletter : patrimoineactions.substack.c…";553;227;112;331;1223
MickaelCosson22;Mickaël Cosson;Député de la 1ère circonscription des Côtes d’Armor - Conseiller municipal d'Hillion - Conseiller communautaire Saint-Brieuc Armor Agglomération;118;726;267;111;1222
KeyChicky;Key;Money maker;942;21;11;248;1222
eelv_douai;EÉLV Douai 🌻🇪🇺;Groupe local Europe Écologie Les Verts de l'arrondissement de Douai 💚🙋💪;515;143;231;331;1220
Laulanphilippe2;Laulan-philippe;;1206;0;2;11;1219
QCNouvelles;Québec Nouvelles;Québec Nouvelles offre aux Québécois une perspective libre et décomplexée sur l'état du Québec et ses enjeux les plus pressants.;441;240;537;1;1219
maxcorsa2;max corsa;ICT STUDENT;682;29;20;486;1217
PortBordeaux;Port Bordeaux;"Situé sur le plus vaste estuaire d’Europe, Bordeaux Port
Atlantique accueille 1000 navires par an et contribue au développement économique du sud-ouest.";160;201;666;190;1217
noka_narcisse;Noka Narcisse;coordinateur national a.i/ COJEKA, DG Empire National ( imprimerie, porcherie, poulailler) et Cadre de l'Ensemble pour la République MK;380;121;139;576;1216
GreenFutureEur1;Green Future Europe;"Association militant pour les EnR et énergies de transition.
Engagée pour la transition en 🇪🇺, grâce aux EnR, et à un usage raisonné et éveillé du charbon.";712;87;218;198;1215
zesoundengineer;El_Otro;;291;95;4;823;1213
CollEpiBatignol;Collectif Epinettes Batignolles;Le Collectif est animé par @batignettes @BEpinettes @MartinPtre @NadiaDesBatigno @NOURISSONPasca1 @patrollot @ValTessier_17 @vito75017.;324;83;275;529;1211
MarkoFrejus;Marko frejus;;297;9;6;897;1209
IbrahimBald;Ibrahima Baldé;Journaliste, Champion d’Afrique, Supporter de Chelsea;217;86;300;599;1202
OLADE__;OLADE;➫ Nous aidons les jeunes passionnés ❤️‍🔥 à optimiser l'impact positif 📈 dans leurs communautés 👥, créer des projets innovants et atteindre leurs objectifs. ✨;433;105;256;408;1202
sopeejef;SOPEEJEF ASBL;Synergie des Organisations Engagées pour l'Emploi et l'Entrepreneuriat des Jeunes et Femmes (Non Profit Organisation);322;157;38;685;1202
SalifKO31547825;Salif KONE;"Activist about Climate and Social Justice.
#Agroécologie #Semences 
Genre et Développement. 
My CV us.docworkspace.com/d/sIEKL-…";137;711;184;168;1200
e80313;Francisco;;289;34;6;870;1199
MakhnoStoof;Makhno;;777;65;24;331;1197
MOmbendet;Mayombo Ombendet Kelly Alfred;;194;410;40;553;1197
GAttalActu;Gabriel Attal Actu;"Toute l'actualité de Gabriel Attal

◽ Ministre Délégué aux Comptes Publics
◽ Conseiller Municipal de Vanves

❗ Compte NON GÉRÉ par Gabriel Attal ou son équipe";609;7;107;474;1197
AlainRogister;AlainR;Collecteur organique de souffrances en route vers l'oubli;1029;137;9;22;1197
CabinetAgcr;Cabinet AGCR;"Suivez l'actualité du cabinet d'expertise-comptable AGCR !
Nous accompagnons les entreprises réunionnaises en quête d'efficacité depuis plus de 30 ans.";1070;36;10;79;1195
ridwane_ar;Ridwane Abdul-Rahman;EU enthusiast doing my part in strengthening the EU-Guinea partnership đȘđșđŹđł. Team Leader @UEenGuinee. Views my own, retweets not endorsements.;135;463;486;111;1195
PharaonChambers;Pharaon Chambers;La révolution des consciences et de l'imaginaire pour fonder un autre monde vivable n'est plus un luxe mais une nécessité pour que survivre l'espèce humaine! 🕔;701;71;11;412;1195
TheNextWomenTun;The Next Women Tunisie;Plateforme de networking on et offline pour promouvoir les femmes entrepreneures de Tunisie et région Mena.;378;471;206;138;1193
MOONIRMOONS;Danielle Rieu;⚜️;742;66;31;352;1191
MouvementSoreso;Mouvement Soréso;Mouvement #politique français naissant #Sobriete #Resilience #Souverainete. Jancovici, Barrau, Keller, Servigne au pouvoir #energie #climat #décroissance;509;319;45;317;1190
JeanlucGirod;Jean-luc Girod đ§;DĂ©lĂ©guĂ© RĂ©gional Ouest Francilien @Orange @OrangeIdf #experienceclients #5G #Fibre #Yvelines #HautsdeSeine #ValdOise #RSE #Innovation #telecom;240;168;153;626;1187
CAMPOClaude1;CAMPO Claude;;1129;17;4;36;1186
Olhamele;Harle;;722;27;3;430;1182
climat_urbain;CRC Action climatique urbaine_ S.L.VanNeste;"Chaire de recherche du Canada en action climatique urbaine
CRC in Urban Climate Action 
#experimentation #justiceClimatique #suburbain #territoire";204;319;225;434;1182
fermefloraleurb;Ferme Florale Urbaine - Lilas;Producteur à Paris et Vitry de fleurs bas carbone : sans fioul, sans pesticides et sans nouveaux déchets. Vente à la ferme et livraison à vélo.;267;187;440;284;1178
AtelierLIRE;Atelier Libre et Responsable;L’Atelier Libre & Responsable rassemble des femmes & des hommes désireux de dessiner un horizon collectif, humaniste et social dans la mondialisation #ThinkTank;499;54;80;543;1176
chacazoulou2;chacazoulou;Best to be judged by twelve than carried by six;377;74;12;710;1173
ClgCharlemagne;Collège Charlemagne Laon;REP+, Label EDD, cité éducative;701;20;166;285;1172
mdsc229;MdSC Bénin;Nous renforçons les capacités des OSC du #Bénin  Nos projets phares: #fosir #labelqualitéosc #ChildRightMonitoring;293;155;425;299;1172
M5BUZZDIOSKI;M5 BUZZ DIOSKI;AGENCE DE COMMUNICATION DE LA PUBLICITÉ ET D'ÉVÉNEMENT AU MALI +223 94 63 21 13.;893;6;45;228;1172
AssoVracParis;VRAC Paris;;199;196;560;216;1171
Mimoaam;Damien Rodrigaaa;(Propriétaire d'une grosse télé);115;433;21;602;1171
ericdandigne;Eric d'Andigné;J'ai le remède contre la phobie administrative;622;278;144;126;1170
RobertLeTigre;Robert Le Tigre;"Ici on discute thunes et statisingeries.
Dividendes et #Bitcoin enjoyer.
Père du #RégimeDesActifs et apôtre du #NarboySummer";329;97;46;697;1169
FilippiCecile;Cecile Filippi;Head of Digital Communications & e-Influence chez @GroupeEramet. Infatigable lorsqu'il s'agit de la cause des #femmes, de l'#environnement et du #climat.;211;61;106;791;1169
elliemingle;Ellie Mingle;;454;74;8;631;1167
imp5223;IMP5223 Ingénierie des Matériaux Polymères;Unité Mixte de Recherche CNRS UMR 5223 - Ingénierie des Matériaux Polymères;775;71;302;19;1167
RefashionEcoorg;Refashion;Eco-organisme de la Filière Textile créé par les entreprises pour réduire l’impact environnemental par la prévention et la gestion de fin de vie de ces produits;292;289;405;180;1166
YvonBonneau84;Yvon Bonneau;;665;378;36;87;1166
ClgLeFerronay;Collège Le Ferronay;Le collège Le Ferronay, a été construit en 1971 sur un vallon de la ville d’Octeville, aujourd'hui Cherbourg en Cotentin.;437;58;131;540;1166
LoukoumaneSaka;SAKA Loukoumane;Coordonnateur Ureport, blogueur, coach en développement personnel, conteur, slameur, technicien de froid climatisation et plomberie, jeune leader...;270;347;231;317;1165
Ame_Itinerante;Âme Itinerante;;394;216;47;508;1165
FiletPierre;Pierre Filet;Proviseur Lycée Polyvalent Lumière à Luxeuil-les-bains. Maire de Montagney Servigney;250;92;248;575;1165
FFIukraine;Force française de l’intérieur;Group of French-speaking resistance fighters in support of Ukraine. Clandestine sabotage Our actions are for the Ukrainian people. we f..k 🇷🇺 troll🤡.;1001;37;81;45;1164
FNIC_CGT_RA;FNIC-CGT Rhône-Alpes;Union REGIONAL Rhône-Alpes FNIC-CGT;261;173;421;309;1164
Espoir_bya;Espoir Bya'ene;Zacharie 1:3 Dis-leur donc: Ainsi parle l'Éternel des armées: Revenez à moi, dit l'Éternel des armées, et je reviendrai à vous, dit l'Éternel des armées.;814;166;34;150;1164
HaffnerEnergy;Haffner Energy;Concepteurs et distributeurs d'Hynoca, technologie disruptive d'#hydrogène compétitif vert et solution de décarbonation;240;334;413;176;1163
Adada_Hue;Adada Hue;;579;144;10;430;1163
SOUMAHO83307944;Lagosili ( La Critique );Fasoden Hɔrɔnyalen;369;282;55;457;1163
MouhamedKon8;Mouhamed Koné;;927;106;50;80;1163
Daddydu13;Daddy du 13;Dad;626;103;2;431;1162
mourad_amara;Mourad AMARA;chemistry of rare earth elements ... primary and secondary resources ... perspectives in Algeria;292;61;8;801;1162
AgileFourmi;Fourmi;;826;230;37;68;1161
Primum_Immo;Primum Immobilier;Achat, vente, location à Clermont-Ferrand et Pont-du-Château #PourVotreBien;255;576;60;269;1160
phinadax;NDIKUMANA Innocent;Big mind never die;590;181;76;312;1159
Camille_Slr;Camille Sellier;Journaliste @canalplusgroupe et @leJDD I Ex @OuestFrance85;150;604;197;207;1158
JulienDugenetay;Julien Dugenetay;deputy General Manager & CFO Boralex Europe #TransitionÉnergétique @boralexinc @boralexfr #Innovation #ENR #OnlyOnePlanet;351;236;84;486;1157
AlbatrosKhalid;Albatros;Albatros;1041;82;15;17;1155
BioProvence;Bio de Provence;#BioDeProvence est la fédération régionale de l' #agriculture #biologique. Elle œuvre au développement et à la promotion de l’ #agriculture #bio en #PACA.;366;116;547;122;1151
anaisiou;galligani anaïs;;191;388;124;446;1149
MassiliaSunSyst;Massilia Sun System ð;Entreprise citoyenne et solidaire de production d'#EnR #photovoltaÃ¯que Ã  @marseille et dans la @AMPMetropole pour contribuer Ã  la #transitionÃ©nergÃ©tique.;317;240;286;304;1147
djazayridu78;Gogeta78 arc préparation d'une hagra sans fin🔪🐺;;745;112;75;210;1142
julienndn;julienndn;"Trader 
investisseur crypto, nft's etc";222;721;40;159;1142
AteliersBocage;Ateliers du Bocage;"Nous accompagnons les transitions sociales, écologiques et numériques pour prouver qu'un modèle économique responsable
est possible !";272;244;202;423;1141
YouImmobilier;You-Immobilier;Bienvenue sur le fil d'actualité de You-Immobilier, agence immobilière située à Méru, spécialisée transactions, gestion & locations de biens. Adhérent #FNAIM.;1056;38;25;21;1140
MichodigniBenn;Benn MICHODIGNI;"Juriste de profession
Journaliste Béninois d'investigation
Secrétaire Général de l'ONG Terre des Orchidées";895;150;55;40;1140
era_cles;Era Immobilier Les Clés de Toulouse;Agence immobilière #Era sur #Toulouse #SaintCyprien #immobilier #vente #achat #location #investissement;1124;0;13;0;1137
jememarre9;Jememarre;La bonne zone, en permanence,…les accointances sont mon délice.En Space je ne parle à personne mais j’écoute.😶‍🌫️;492;465;33;145;1135
TrainClermont;Les Usagers du Train Clermont-Paris;Mobilisés pour l'obtention d'un temps de trajet raisonnable de 2h30 entre les deux métropoles et faire enfin entrer la ligne Clermont-Paris dans le XXI* siècle;145;775;103;111;1134
julioverneGT;Lycée Jules Verne Guatemala 🇫🇷 🇬🇹;Pour un avenir ouvert sur le monde 🌎 #Guatemala #France #FranceauGuatemala #Mission #amlanord #AEFE;429;130;340;233;1132
DroitDec;asbl Droit de l'Enfant Congolais;l'intérêt des enfants;479;296;221;130;1126
philippe_ratto;philippe ratto;Directeur d’offres RATP Dev lot bus et trolleybus #mobilite #transportspublics #lyon;113;234;61;717;1125
KHervekaz;Hervekaz Kaz;;652;160;5;308;1125
Association_AHQ;Association Hôtellerie du Québec;Association touristique sectorielle reconnue par le gouvernement, l’AHQ représente, informe et défend les enjeux de l’hôtellerie pour tout le Québec.;385;259;296;181;1121
contactcontac13;SDIExpertise;société de diagnostics immobilier en île de france;14;761;136;208;1119
decouvertes3863;decouvertes38630;Nos découvertes musicales, culturelles et nos balades dans la nature : facebook.com/decouvertesmusi…;134;731;203;50;1118
paukhou;pako;;906;11;12;189;1118
WilliamTertus;william tertus;;1028;69;13;8;1118
Auton_Omate;Le Lab de l'autonomie ⭐;Je développe mon autonomie et ma résilience, mon business et un portefeuille d'investissements à 100k€ | Partage d'informations & astuces sur le processus;680;159;81;197;1117
bastien_zerger;Mr.zerger bastien;20 ans 🦅 🫶🏻19/12/20🫶🏻;382;29;5;698;1114
raphael_goblet;Raphaël Goblet;Eco-conseiller indépendant, animateur d'ateliers, conférencier, chroniqueur bouquins, administrateur Monnaie Locale. Mes Tweets n’engagent que vous.;280;254;36;544;1114
retrtretertr;Redux;;1022;17;7;66;1112
ArianeFAVIER;Ariane Favier;#capitalimmatériel #actifsimmatériels #RSE #climat #valeurintégrale #entreprisecontributive #externalitéspositives #holoway #LeBonSensAuServiceDuBienCommun;421;374;92;225;1112
n2_nicolas;Nicolas;"C'était mieux avant.
Worldwild french spectator
Interests:  geopolotics, maths (++), geometry, sports";450;205;97;359;1111
NicolasKlatka;Nicolas Klatka;Chargé de mission mobilisation citoyenne au Groupe Mammalogique Normand.;411;240;122;338;1111
AllagbaP;Allagba Koffi Pascal, Avive Citizen;"Je suis un citoyen Avive
nitter.net/AllagbaP/status/…";242;704;118;46;1110
DebatEauIDF;Débat Public sur l'eau potable en IDF;Compte du Débat Public L’eau potable en Ile-de-France, organisé par @CNDPdebatpublic, du 20 avril au 20 juillet 2023.;129;476;389;116;1110
Mohamed41531423;Mohamed-120;Put me at the table where they talking about Money, not people. ð¯;39;50;12;1007;1108
OlivierMbuyi243;Mb Forceđšđ©;never betray the Congoâïž;109;356;327;311;1103
Patrick03560720;Balhinfo Plus;L'info en continu.;929;97;56;20;1102
AichaLawson;Aicha Lawson;"Believe in #sustainabledevelopment
Passionate about #digitalmarketing
President & Founder of @DunyaEthic";94;565;180;263;1102
Abraham41213775;Abraham Lincoln;Tooooz;596;59;7;440;1102
gomisdavid78;Tommy Eagan;Suivez moi si vous le voulez mais je suis pas sur de savoir où je vais;447;254;49;348;1098
MBarnier2;M Barnier;Transports autrement;938;78;6;76;1098
SbastienSapin;Sébastien Sapin;Alchemist fighting any distorsion of realism engendered by evil.;447;31;12;607;1097
AKANKROU;GUILLAUME BEDA;🐘;140;613;93;250;1096
kisdanc;faurich gerard;“L'état qui engendre la règle est différent de celui que la règle engendre.” Nietzsche;503;66;22;504;1095
Enermine_CFECGC;CFE-CGC ENERMINE;La Fédération CFE CGC Enermine regroupe les Syndicats CFE CGC Pétrole, FIBOPA, SNCH, BRGM et les Syndicats des mines. Adhérent à IndustriAll.;313;86;130;566;1095
Cabinet_Cogec;Cogec;;1080;4;4;6;1094
RocheDonfack;DONFACK MEKONTCHOU ROCHE;VICE-PRÉSIDENT NATIONAL COOP-CAMEROON;371;282;70;371;1094
anhnazd;Para Bellum;De la force nait le droit;738;12;161;180;1091
CAAVRhoneDuranc;Centre d'affaires Agri - Viti Rhône Durance;"Ce compte sera prochainement désactivé. Merci de suivre 
@MillesimeCaap pour ne rien manquer de notre actualité !";669;216;83;122;1090
sodjinoudossou;SODJINOU V. Dossou;"Docteur en médecine, Docteur en Santé Publique, expert OMS sécurité sanitaire, lutte contre maladies et intelligence épidémique.

L'espérance ne déçoit jamais!";241;140;228;479;1088
KalonjiTshibasu;Kalonji Tshibasu;GĂ©ographe;466;487;80;54;1087
GingNews;News Gaming | FRANCE;"Actualités jeux video en temps réel
Toutes les promo gaming sur @GingPromotion";742;6;336;3;1087
benfonty;Benoît FONTY;"Senior Software Engineer @talend
@benfonty@piaille.fr";749;83;31;224;1087
MounirRguigui;Mounir Rguigui;les conversations ne doivent pas être des joutes pour savoir qui a tord ou raison, mais un enrichissement mutuel et un épanouissement de soi..;967;37;10;72;1086
Natott04;Nathalie Ottino;SPIE Industrie et Tertiaire - division industrie - Développement RH;272;41;25;748;1086
Lavandes4;Dhieres;;861;28;1;190;1080
MameAbySeye;Mame Aby Seye đź‡¸đź‡ł;"DĂ©lĂ©guĂ© GĂ©nĂ©ral Ă  l'Entrepreneuriat @dersenegal
Promouvoir, dĂ©velopper et financer l'entrepreneuriat pour les femmes et les jeunes au SĂ©nĂ©gal.";76;10;917;76;1079
chou_yech;meramar;;1055;10;2;11;1078
The_Wellness_Gu;Wess Aza;Dedicated to improving health and wellness by providing and sharing knowledge for a healthy life.;341;75;33;628;1077
sanpedroportci;Port Autonome San Pedro;;474;86;473;44;1077
al_secco;Anne-Laure Secco;Députée au #GCVS du @PSValaisRomand - Vice-cheffe de groupe PS et Gauche Citoyenne - Vice-présidente @PSValaisRomand;215;173;149;538;1075
DialogueDirect1;Dialogue_Direct;;848;28;7;191;1074
derpie;Pierre Deraiche;;101;71;7;895;1074
GeraldRegent1;Gerald Regent;"Ecole des Mines Alés
IAE Paris Sorbonne";317;144;14;599;1074
SOLAALGrandEst;SOLAAL Grand Est;#association qui facilite le #don de produits frais des #agriculteurs vers les plus #démunis. #gaspillagealimentaire #solidarité #antigaspi #ESS #RSE #grandest;145;220;120;588;1073
LukeLBouk500;Luke L. Bouk;"𝕹𝖔𝖙𝖍𝖎𝖓𝖌 & 𝖓𝖔 𝖔𝖓𝖊 𝖜𝖎𝖑𝖑 𝖘𝖙𝖔𝖕 𝖜𝖍𝖆𝖙'𝖘 𝖈𝖔𝖒𝖎𝖓𝖌 ""𝖓𝖔𝖙𝖍𝖎𝖓𝖌""
𝕿𝖍𝖊 𝕲𝖗𝖊𝖆𝖙𝖊𝖘𝖙 𝕬𝖜𝖆𝖐𝖊𝖓𝖎𝖓𝖌 𝖔𝖋 𝕬𝖑𝖑 𝖙𝖍𝖊 𝕿𝖎𝖒𝖊";613;125;19;315;1072
UNOPS_Tunisie;UNOPS Tunisie;We support sustainable development in Egypt, Libya, Algeria, Morocco & Tunisia, with a focus on the empowerment of youth & women. @UNOPS @UNOPS_fr;303;82;543;144;1072
alfgismo;xav just;;121;196;28;727;1072
DeDoudard;DoudardDeLagree;Bonapartiste, libéral et fier de l'être. Je crois que le peuple français a encore quelque chose à dire.;114;24;7;926;1071
BHSS_Science;BHSS Science;Bill Hogarth S.S. Science Department;512;83;272;204;1071
benoitbonte;Benoît;cofounder & ceo @humanroads;272;157;183;456;1068
SPIROEVs;SPIRO;SPIRO βs mission is to accelerate the access of affordable, clean energy technology in the mobility sector !;103;27;884;54;1068
chrisfortier95;Fortier;Principale Adjointe au collège Jules Ferry d’Eaubonne;186;222;152;502;1062
desirer_mabonda;Désirer kabongo;;480;330;177;75;1062
LoumaJobs;Louma Jobs et Concours au Cameroun;Une plateforme qui aide à trouver facilement toutes les offres d'emplois et les concours disponibles au cameroun;459;86;451;65;1061
a_miclot;Collège A. MICLOT de Port-Bail-Sur-Mer (50);Internat d'excellence. Section sportive scolaire voile. Option foot. Option LCE Anglais. Port-Bail-Sur-Mer. Département de la Manche. Académie de Normandie.;99;529;162;271;1061
hmazukas;Héritier Mazu;"Il ne suffit pas d'espérer le bonheur; il faut le vouloir, le bâtir, l'entretenir ; il faut agir pour la justice. Ne perds pas ta vie à la rêver.
MPH, MSC";435;333;73;219;1060
audrenjphilippe;Jean-Philippe Audren;Délégué TdP-FdE (toutes circos). membre du Conseil National de Territoires de Progrès. Élu bureau Renaissance-FDE territoiresdeprogres.com;445;156;100;358;1059
MatondoJosapha1;Josaphat Matondo;"Congolais de père et de mère.
Évangéliste, Écrivain, Entrepreneur et panafricain.";502;234;8;313;1057
gtshiangala1;Godefroid Tshiangala;"Consultant en gestion d'entreprise sociale et collective.
Investisseur immobilier.
Pdt. Association pour le développement économique et social du Kasaï-oriental";179;207;97;573;1056
cite04;CITE;CITE is a non-profit organization that builds capacity for social development through technology, innovation, entrepreneurship and international cooperation.;191;226;439;199;1055
FondsMuniVert;Fonds Municipal Vert;Le FMV aide les #munican à adopter des #solutionsclimatiques, et ce, plus rapidement. Le FMV est un programme de la @ReseauFCM. | In English: @GreenMuniFund;653;183;178;40;1054
astrogogo213621;astro;Un horoscope pas comme les autres;984;0;41;25;1050
amandinerovere;amandine rovere;Marcom Manager # marketing opérationnel # communication 360 # digital #deee #green it;419;231;113;287;1050
energieTEAM_fr;EnergieTEAM;Depuis 20 ans, energieTEAM est un producteur d’électricité renouvelable qui développe des parcs éoliens, photovoltaïques et du stockage d'énergie.;293;350;268;139;1050
famsa_scopa;FAMSA SCOPA;Official Twitter handle for the Standing Committee on Population Activities under @official_famsa.;437;87;204;322;1050
UniversumFrance;Universum France;Attirer, recruter et retenir les meilleurs #talents. #Datas #DatasCollection #EVP #MarqueEmployeur #EmployerBranding;184;223;175;466;1048
bk_runfar;Bertrand Kaiser;;186;55;4;801;1046
biramawa;Biramawa Group - BG;Biramawa, votre magazine - ISSN France 2729-4218;609;1;405;31;1046
Jim20120400;Jim;;978;21;5;41;1045
Stendhal_31;Collège STENDHAL;"Collège #REP+ du Grand Mirail (quartier Bagatelle)    
@actoulouse @HauteGaronne";403;87;376;179;1045
Lausm09;Laurent Saint-Martin;;756;2;9;276;1043
Marine_ANESTAPS;Marine Jannarelli;"Master 1 PESAP Montpellier

Chargée de Mission Inclusion et lutte contre les discriminations à l'ANESTAPS";205;240;140;457;1042
KayembeMuyaya;Muyaya Kayembe;F;364;485;190;2;1041
Faszebook;Ótnász;Egy riportertől elvezhető a titulusa ha baloldali politikustól zavarót kérdez,akkor a nemzeti érdek ellenes politikusstól is el kell venni!Ők nem politikusok!?;469;34;7;529;1039
LemienJust;Just Lemien;Fils de résistant, résistant moi même, ancien dés forces spéciale. Nageur de combat, mineur démineur.;829;6;14;189;1038
MagaliWatteaux;ArcheoGeo@Watteaux;MCF (@UnivRennes_2) en histoire et archéologie médiévales / Archéogéographe. Membre de @EATempora et membre associé de @ArcheoEnv7041. Vice-présidente de l'AFAG;226;178;289;343;1036
LeRelecqKerhuon;Ville de Le Relecq-Kerhuon;Bienvenue sur le compte Twitter officiel de la ville de Le Relecq-Kerhuon.;568;97;343;28;1036
matgautier;Mathieu GAUTIER;"Associate professor in @insadelyon Research in @labodeep 
Urban geochemistry. Environmental chemistry. Nature Based Solution. Wastes. Circularity. Anthropocene.";205;265;139;425;1034
IronPhil7;Iron_Phil;;212;107;14;698;1031
MichelleBoulan8;Michelle Boulanger;;389;5;7;629;1030
VoixDesJeunesDD;La Voix Des Jeunes Pour Le Développement Durable;Programme axé sur l’Education Environnementale, la Citoyenneté Mondiale et Solidaire, prenant le format d'un concours d'éloquence Inter lycée.;224;180;136;488;1028
VilleLachute;Ville de Lachute;"Twitter officiel de la Ville de Lachute 
đ 380, rue Principale, Lachute QC, J8H 1Y2
đ 450 562-3781
đ§ medias@lachute.ca
#VilleLachute";794;92;130;8;1024
Bapt54;Bapt;"đČđ«đȘđșđșđŠđŠđČ
Citoyen engagĂ©
#VĂ©lotaf
#Clamart";486;66;43;428;1023
LIDAM_UCLouvain;LIDAM;"Louvain Institute of Data Analysis and Modeling in economics and statistics
Research center of @UCLouvain_be";443;205;276;98;1022
andryrafaly;Rafalimanana Andry;ðð¼;761;86;74;101;1022
SudParisSoleil;SudParis Soleil;Sud Paris Soleil est un projet citoyen de production d'énergie photovoltaïque, basé en proche banlieue Sud.;492;118;179;233;1022
CCA_RDC;CELLULE CLIMAT DES AFFAIRES RDC;Service Spécialisé près le Président de la République Démocratique du Congo;94;12;874;39;1019
BibliotechSIB;Bibliotech;Veille franco/anglophone autour de l'#innovationnumérique au sein des #bibliothèques, effectuée par quatre étudiantes de l'@ENSSIB ! 👩🏻‍💻📖;270;152;109;486;1017
wanouxpat;Tenants vs Regulatory Capture in Florida;Help me protect vulnerable tenants.;321;514;148;34;1017
ChefMaelle;Chef Maëlle;Experte par l'organisation Mondiale de la gastronomie en pâtisserie sans gluten - Consultante en pâtisserie sans gluten - Professeur -Traiteurs;149;296;245;327;1017
HiceoFr;Hiceo.fr;hiceo, conseil en communication (print et web) & marketing, relation presse, organisation d'événements, sondages & enquêtes, développement d'entreprise.;347;178;28;464;1017
GabrielElamine;Gabriel Elamine;"La complaisance réjouit tout simplement ; la critique constructive , préférable, éclaire et fait progresser ...";34;478;503;1;1016
OSchmurz;Scribouilleur;Gratte-papier imbuvable. Toujours dans son burlingue. Jamais drôle, sauf le dimanche. Rêve d'écrire des préfaces.;271;309;11;425;1016
QLFDessins;Marioso;;587;61;10;357;1015
BienvenuM89;MADJILEM Bienvenue;Officier des droits de l'Homme au Haut-Commissariat des Nations unies aux Droits de l'Homme (HCDH);145;459;177;233;1014
cafe_diplo;Café diplo Haïti;CAFÉ DIPLO HAÏTI 🇭🇹 est un laboratoire d’idées .📡 🌏. Cafediplo509@gmail.comhttps://piped.video/channel/UCcVnvfxwAuii3tHA0Aw8p5Q8r;189;297;386;139;1011
WhitecastleD;Whitecastle Dicky;Vivre à Mazargues, mourir à Sormiou;821;42;4;141;1008
Ca_me_nerve;ca_me_nerve;Parfois ça chatouille, parfois ça gratouille, et quand ça gratouille trop fort ça m'énerve;851;66;2;88;1007
jeanpuiforcat79;jeanpuiforcat1945;;989;3;13;0;1005
LetchimyX;Letchimy Xavier;;516;89;48;352;1005
SaftiMacon;Safti Frédéric Chevrau Mâcon;Acteur incontournable de l'immobilier sur Mâcon, je m'engage à mettre à votre service mon expertise, mon expérience et mes compétences dans la transaction;1003;0;2;0;1005
Frdric36415171;Frédéric;Vous le découvrirez de par vous même , et puis toute personne est spécial car unique 😉🤔;496;18;3;488;1005
MaxStpPierre;Max Stp;Né dans un dôme où ineptocratie est roi et maître!;337;127;29;511;1004
FnaimV;FNAIM Var;;936;17;48;2;1003
FirstPhosphate;First Phosphate Corp;A Canadian mineral exploration and development company fully dedicated to extracting and refining advanced phosphate material for the LFP Battery industry.;252;208;386;157;1003
SergeMaroie;Serge Maroie;Les convictions fortes n'excluent pas le respect de l'autre;847;10;12;133;1002
DNArchi;DNArchi;DNArchi vise à questionner la conception architecturale numérique en proposant des éléments théoriques et pratiques pour la connaître, la penser et l'assister.;398;256;221;127;1002
EmbaParFrancia;Ambassade du Paraguay en France;Compte officiel de l´Ambassade de la République du Paraguay en France;335;108;382;175;1000
daye_med;Konate Med Daye;Spécialiste en droit privé, expert en mine et métallurgie.;806;48;12;131;997
greenebullfroc;Greenebullfroc;;436;56;16;488;996
__Raedy;Rædy;"Rædy est un cabinet de conseil IT. 
Nous vous accompagnons sur l’ensemble de vos projets digitaux. 
L'Artisanat au Service du Numérique ✨";659;33;9;295;996
HerveLyzia;HERVE Lyzia;;528;110;19;337;994
Ithnd2;Ithnd ð«ð·ð¸ðª;DÃ©teste l'arrogance et le mÃ©pris des autres, respecte les personnes qui le mÃ©rite. Horreur des extrÃªmes #MajoritÃ©Respectable #AntiRenaissance;864;17;8;104;993
idrissi_samir;samir IDRISSI;entrepreneur, 60 ans, habite Rabat,consultant en finance & industrie;200;322;66;405;993
NarratifsBourse;Narratifs Boursiers;"ð ""Narratifs Boursiers"" ð. DÃ©codage #Bourse, #Crypto & #investissement ð. Infos uniques ! Rappel : Pas de conseil en investissement. ð¡";769;28;48;147;992
claud_rabillard;Claudine Rabillard;Solutions pour la #TransitionEnergétique dans les #Territoires #sobriété #Collectiviteslocales #Concessions @enedis;477;34;130;347;988
EolMerCalvados;Parc éolien en mer du Calvados;Compte officiel du #ParcEolienEnMerCalvados, parc éolien en mer de #Normandie, source d'énergie renouvelable pour demain. Mise en service 2025.;256;294;367;71;988
Lesoleilnoir_9;Lesoleilnoir_9;Raci.lis.e,whitepowerđđ». niech ĆŒyje ĆwiÄta BiaĆa Europa.;202;97;42;644;985
TNtinani;Tino Ntinani;;58;98;12;815;983
SMadjiri;Salissou Madjiri;;392;195;33;362;982
CLCSflp;Combat Laïque Combat Social - Fédérer le peuple;Aujourd’hui, le renouveau du combat laïque est à la fois une réalité et une nécessité universelles... #laïcité #republiquesociale #égalité #féminisme;601;89;92;199;981
SidibLamine14;Lamine Vicky SIDIBE;le Travail;301;273;144;263;981
BillyBenTshiba2;Bill Tshibangu officiel;"Géologue technicien
 🗻🌋🌋🌍🌏☀️🌦️";223;143;26;587;979
EmbaCubaGabon;Ambassade de Cuba en République Gabonaise;Compte Officiel de l'Ambassade de Cuba en République Gabonaise. 🇨🇺🇬🇦;665;201;96;15;977
marylagrange;Ptitemuriel;;946;25;3;2;976
fidele_djimadja;Djimadja Fidèle;"- Journaliste
- Conseiller en perte de poids
- Écrivain/Romancier";542;16;16;401;975
tv_tc1;TC1;Liberté. Indépendance. Actualité                        Entreprise de Médias Radio et Télévision;663;124;9;178;974
Marechal_VMN;Maréchal_VMN_Jean_Moulin;Maréchal souverainiste. Tout pour la France.;668;75;16;214;973
AfricaAero;AfricaAero;Africa Aero is a media group dedicated to air transport in Africa. Africa Aero est un groupe de médias consacré au secteur du transport aérien en Afrique.;221;366;272;114;973
NdalaRossi;Rossi ndala;ingénieur informaticien.;294;214;229;233;970
VincentAurez;Vincent Aurez;Directeur - Innovation, Développement, Communication. @Novaxia_Paris CA association HOP , Conseil d'orientation Labo ESS Mes tweets n'engagent que moi.;240;236;133;361;970
UMahiman;Ultimate Mahiman;;588;42;9;329;968
MichelR04141758;Michel Richard;TGVEU2025@gmail com;583;57;30;298;968
Celine__Allain;Céline Allain;IA-IPR EPS @acrennes;115;127;125;599;966
JacquelinePanu;jacqueline panu;Une femme indépendante ouverte dans les développements Africaines, sur la Renaissance Africaine dans une Conscience Politique et Culturel.;18;30;26;892;966
pec_04;Pierre-Emmanuel Chossat;Responsable communication #SocialMedia @IGNFrance #RS #ComPol #ServicePublic. PassĂ© par @salle421 @valdemarne_94. Passion đž & đ·;221;146;85;514;966
ldarbonnel;Laurence DARBONNEL;"StratĂ©gies digitales B2B đ #Inbound marketing #ABM đŻ Directrice Conseil #CybersĂ©curitĂ©
#Coach professionnel";446;288;150;80;964
ChristVdbPro;M Vandenbroucke CPE;Compte Pro;440;230;87;204;961
avocat_jude;"Avocat De La Jeunesse"" Jude DELICE""";Avocat de profession;114;663;137;46;960
MDPmaxonfrance;maxon France (mdp);Concepteur et producteur de systèmes mécatroniques sur-mesure. Distributeur de solutions motorisées. Expertise en Motorisation, Mécatronique et Automatisation.;715;32;59;153;959
AIMES_MLB_2020;AIMES Montigny - La liste écologiste et citoyenne;"Alternative IgnyMontaine Ecologique & Solidaire
La liste écologiste & citoyenne à Montigny-le-Bretonneux
#Montigny78 #SQY #Municipales2020 #écologie #solidarité";607;120;131;100;958
delescaillestev;steteto99;;265;146;11;535;957
ThibaultThier12;Thibault Thierry;;651;15;3;288;957
sos_rdc;SOS Villages d'Enfants en RDC;La Chaleur d'un foyer pour chaque Enfant;103;265;271;318;957
JacquesDesbiens;Desbiens jacques;retraité;256;157;21;522;956
COMPETENCEPLUS1;COMPETENCEPLUS78 CONTACT;;894;36;4;21;955
moutonnoir170;montonnoir;;795;2;0;157;954
MathiasCadot;Mathias Cadot;#nantes #reze #angers @accoordnantes @comite21 compte perso;203;312;103;335;953
bestreet__;123;;342;47;1;560;950
GroupePena;Groupe Péna;La vocation du Groupe Péna, groupe industriel familial aquitain, est d’assurer le #recyclage des #déchets industriels et ménagers.;517;213;128;91;949
SakowinGreenNRJ;Sakowin Green Energy;Sakowin accelerates the #EnergyTransition through the production of CO2-free, low-cost sustainable #hydrogen using methane plasmalysis.;518;237;98;95;948
CLangevin_INRAE;Christelle Langevin;;233;128;164;423;948
QairosEnergies;Qairos Energies;Producteur #gazverts en Sarthe (72) à partir de #biomasse : #hydrogène et #méthane.;270;137;201;335;943
NtabazaJean;Kakonge Ntabaza Kyapi Jean;Jeune chercheur Congolais, analyste politique et membre de #EnsemblePourlaRépublique🇨🇩;324;86;23;509;942
LiberteWatts;Guillaume Faure;⚡️⚡️ L’app qui te récompense si tu baisses ta consommation aux heures de pointe ⚡️⚡️;232;399;53;257;941
charles071961;charles l'observateur;;815;49;3;73;940
charpentierdam2;charpentier damien;;868;25;2;43;938
BreveOnline;La Brève Online;"La Brève Online est un journal d’information, d’éducation, de sensibilisation et de développement communautaire.

""Donner la vraie info, c'est notre valeur";473;69;99;296;937
CAAVValleeRhone;CAAV Vallée du Rhône;Ce compte sera prochainement désactivé. Merci de suivre @MillesimeCaap pour ne rien manquer de notre actualité !;710;93;67;66;936
APaulicand;Arnaud PAULICAND;Pallet Transfer System Product Manager at Group @Hellomoov @elcomsas #industry #conveyor #pallettransfersystem #automation #industry40 #industriedufuture;282;276;89;283;930
shneederfort;Shneeder LINCIFORT;ūüá≠ūüáĻūüéĮ‚úäūüéĮūüá≠ūüáĻ Student | socially engaged | Business Manager Founder of @sekocleanHT, Co-Founder, Chairman and CEO of @impacteHT ‚ŹĪChild of God ūüôŹūüďö;186;2;18;720;926
Lucpetitfrere;Petitfrère;Consultant;284;221;244;177;926
FedAllure;Fédération Allure ®;Défendre le #Commerce #Indépendant franchisé, affilié et associé de l’habillement, du textile et équipement de la personne.;178;595;110;42;925
ivanovic16;N3rveux;je suis nerveux;673;107;9;136;925
MATDS_BF;MATDS Burkina Faso;Compte officiel du Ministère de l'Administration Territoriale, de la Décentralisation et de la Sécurité du Burkina Faso;220;5;697;0;922
wikaagency;Réhane | Wika Agency;"CEO de l'agence web WIKA |
On accompagne les entreprises à se développer sur le Web2 et Web3
#site #application #design #frontend #backend #Logiciel #actualités";452;34;18;418;922
AFROPEPITESHOW;AFRO PEPITES SHOW;@Lereveafricain offers a unique INTERNATIONAL MEETING PLATFORM... entirely ONLINE! 2023 Call for projects is open Registration: afropepiteshow.com #ArtsIndustry;741;16;128;36;921
ColettisEmmanu1;Colettis Emmanuel;;920;0;1;0;921
KanangilaR;kanangila richesse;criminologue, licencié en sécurité d'État, renseignements et espionnage.;258;206;211;246;921
ca_gip;Crédit Agricole Group Infrastructure Platform;"Répondre aux enjeux de la révolution digitale du groupe Crédit Agricole. Nous réunissons plus de 1 800 talents ! 
Rejoignez-nous ! 👇 #TopEmployer2023";386;101;190;242;919
BenoitSwixim74;Polier Benoit Swixim du Genevois;actualités immobilières   #geneve #immobilier #achat #vente #location #etatdeslieux #estimation #hautesavoie #serviceimmo;604;201;111;3;919
sarahkin9;mariesarahft;viens on se suis, car on est perdu alors on se perd ensemble🤪;554;231;62;72;919
AGCFiduciaire;Agnès Fève;"Votre Cabinet d'Expertise-Comptable à #Paris🖌
N'hésitez pas à nous contacter au 01 42 73 57 57 ☎️";882;24;1;10;917
ViciRaeth;Victor R.;Always look on the bright side of life;497;281;30;107;915
cristoprice;Tyler Cross;I love this game;97;395;10;412;914
ChrisEkoko3;Chris Ekoko;;66;464;222;161;913
DSDEN2B;DSDEN de Haute Corse;DSDEN 2B;370;144;208;191;913
jisakalimine;jisa kalimine;"Ingenieur-frigoriste retraité,fondateur de la société kolwezi technigue industrielle france froid industriel et sport d'entreprise
dans le Monde entier.";814;84;13;1;912
dmbigshort;David;Banking UX Designer,  interested about Finance - New era inc.;168;109;18;617;912
MbayeMory;mory mbaye;;104;344;76;387;911
ByTelRegions;Bouygues Telecom Territoires;Bienvenue sur le compte @BouyguesTelecom dédié aux collectivités et institutions locales de 🇫🇷 - #numérique & #territoires #OnEstFaitPourEtreEnsemble;328;199;269;111;907
Lacjoe1;Lac joe;;495;91;3;318;907
Moussas70432535;Moussa sinayoko;;517;132;7;247;903
Luma20562966;Luma;hey;192;96;11;602;901
AimeNgimbi;Aime Ngimbi;;488;138;51;219;896
kendjo_romain;Romain Kendjo;G;249;497;146;3;895
KourriAhmed1;Kourri Ahmed;Chief Happiness Officer au service du Leadership pédagogique;643;97;35;118;893
MczenDavid;Mczen david;;878;9;5;1;893
maghrebsolution;Maghreb Solutions;Maghreb Solutions fourni aux professionnels un service intégré de #transport et de #logistique vers et depuis les pays du #Maghreb (#Tunisie & #Maroc) 🚛 📦;204;203;290;195;892
JeanCailloux10;Los Borrachos;;321;57;33;480;891
Vousetmoi4;Vousetmoi4;;139;69;112;571;891
MadCookiesfr;Mad Cookies;"Boutique très artisanale de Maxi Cookies !
Les madcookies sont envoyés dans toute la France dans leurs boîtes à camembert pour pouvoir les réchauffer au four";277;75;96;438;886
Mercilavie1;Mercilavie;;478;12;6;390;886
Martialito2;ramosma;je suis éducateur dans un IME.;732;31;8;114;885
bienspassee;Bien s’passer;;232;38;13;601;884
CaffProAubagne;Pro avec les Pros;Centre d'affaires des Professionnels Aubagne / Garlaban - Crédit Agricole Alpes Provence;589;113;88;93;883
CarolineLouisy;Caroline LOUISY;;696;14;0;173;883
bahaeddinezliaa;baheddine ZLIAA;Chargé de partenariats à #Pôleemploi_idf, passé par la Ville de #Paris, le Conseil Parisien de la Jeunesse #CPJ et le Conseil Régional des Jeunes d'IDF #CRJIDF;74;606;76;127;883
EmmanuelJEANLO4;Emmanuel JEAN LOUIS;"Conseiller pédagogique/Formateur /
Officier de Développemment d'Enfant et de Jeune/Fondateur de la Maison Pédagogique d'Haïti.";208;461;86;127;882
JcqtJustin;Justin;;141;66;31;643;881
favier_florent;Florent Favier;Comment sensibiliser aux défis qui nous attendent si nous voulons continuer à vivre demain aussi bien qu’aujourd’hui ? #nature #oceans #communication #influence;380;204;222;74;880
GuindoIsmael4;Guindo Ismael;Co-Président Bénévoles Engagés pour la Promotion des Droits de l'Homme (BEPDH);127;124;14;612;877
Valerie_Revel;Valérie Revel;Maire de Lescar. Médecin en Gériatrie et Santé Publique.;250;170;424;33;877
Bart_Abac_;Bart Abac;Caleçons vos goûts ?;587;57;7;224;875
EcoNouvo;EcoNouvo;Actualités crypto, géopolitique, économie. Analyses & perspectives novatrices #EcoNouveau #crypto #économie #geopolitique;398;284;76;115;873
ClaireAhoton;Claire AHOTON;Activiste-Environnement /  / Hydrologue en formation/ Activiste-Climat;107;428;109;229;873
TurgeonRodrigue;Rodrigue Turgeon;Avocat/Lawyer, J.D., M.S.V.D. | MiningWatch Canada, National program co-lead | Québec Meilleure mine, Co-porte-parole | Western Mining Action Network, co-chair;170;463;82;155;870
NatsuoDante;Criminal raccoon ð´ââ ï¸;"Go, do a crime.
May the old walls fall and nature claim back what is rightfully hers";503;51;2;313;869
Greng50;Paulo Ferreira;50 Nuancen vun gréng;673;53;19;122;867
vscattolin;Vincent Scattolin;Maire de @villededivonne | Vice-président de @PaysdeGexagglo | 1er Vice-président du Pôle Métropolitain du Genevois français;215;306;221;125;867
jamy_william;JamyWilliams;"En recherche d'un réseau permettant la liberté d'expression. 
Ciao Meta, Welcome Tweeter.";739;32;3;92;866
Canal11haiti4v1;Canal11 Haiti4vtkt;Canal 11, la Seule et l’Unique;366;72;31;395;864
seb_dur1976;Sebastien DURAND;;169;202;8;484;863
marieguidanxe;Marie;|Marie | ♌︎ ♏︎ ♏︎ |21 ans | 🎙Podcasts sur le développement personnel 📮guidances personnalisées instagram.com/mariexguidance…;391;30;341;100;862
AnalyseInd;Salon Analyse Ind.;35e édition du salon des solutions en analyse, instrumentation et process industriels 5-6 avril 2023 - Paris Champerret #instrument #analyse #processindustriels;406;240;177;31;854
dokkiapp;Dokki;Se former n’a jamais été aussi simple !;478;246;75;54;853
fredmarascia;Frédéric MARASCIA;Directeur Développement Territorial Bourgogne EDF @EDFCommerceEst Et si on parlait #énergie, #transition écologique et #décarbonation en #Bourgogne;377;195;122;158;852
ImmobilierBlb;BLB Immobilier;;845;4;3;0;852
respiii1;@¢respiii$;;148;212;20;470;850
JeanChristianV5;Jean Christian Valentin;;172;276;17;383;848
d_cuny;Damien Cuny;;76;165;66;541;848
aissatounamfe;Aïssatou Nam;;417;143;33;255;848
Jhonnysanon1973;Jhonny Sanon;Jhonny Infos est une page qui forme, qui informe et qui instruit.;114;660;69;2;845
ChrisBuzzacaro;Christophe Buzzacaro;;243;41;15;546;845
hyppolindzo;INDZONTSON;AGENT D'AFFAIRES.;218;585;36;5;844
2510picasso;Picasso Alain;“La créativité nécessite le courage de se débarrasser de ses certitudes.”;588;58;87;111;844
HarisMegzari;Haris Megzari;Ãconomiste du comportement ð§  Ã  lâUniversitÃ© de Bordeaux. Jâenseigne les stats, lâanalyse de donnÃ©es et la microÃ©conomie. ð¨ð»âð«;238;271;74;260;843
TwittosGPT;TweetosGPT;Tout mes tweets et réponses ici sont générés par ChatGPT. Même cette bio ! Suivez-nous pour des contenus uniques et originaux !;409;12;116;305;842
SLoosveldt_GRDF;Sylvaine LOOSVELDT;Déléguée Territoriale Loir et Cher;228;70;183;360;841
cadam3734;Daniel Campeau;Retraité à l’affût mais discret - La langue française se meurt un mot à la fois…;56;139;32;613;840
ESIBSparis;ESI Business School;L'ESI Business School est l'école de commerce du Développement Durable, de l'impact social et du digital, qui forme aux métiers de la nouvelle économie ! 🎓🌍♻️;384;182;202;71;839
Hormasso1;Kidiwal Barry;@Derrière toute réussite d'un peuple, d'une nation il y'a celui qui a payé le prix le plus fort.;55;511;51;220;837
ThegreatWSF;WSF;;435;96;0;305;836
Sbastie04881691;Sébastien;;501;136;5;193;835
Sommeteconomie;Sommet de l'Économie;"Le 9ème Sommet de l’#Économie organisé par @challenges se tiendra le 1er Décembre 2022 au Palais de Tokyo, à Paris.
#SommetEconomie2022 #Politique #Ecologie";284;54;453;44;835
phi_osiris;Osiris Isis;;578;122;4;130;834
ngangay_y;Yves MILAN NGANGAY;Directeur Général de l'Institut Congolais pour la Conservation de la Nature, @iccnrdc 🇨🇩.;47;52;671;64;834
hdi53ali;Hamdi Ali;;791;9;16;14;830
guyb63550;bretoguy;Rifle expert ***;808;19;1;0;828
SAS_SabiAgri;SABI AGRI;"Entreprise #Française, fabricant d'#agroéquipements #électriques à destination de l'#agroécologie.
Découvrez nos modèles de #tracteurélectrique.";335;110;257;125;827
by_concilium;BY CONCILIUM;Conseiller en Création et Gestion de Patrimoine;745;52;19;9;825
Kareline3x;Kareline;Esprit sain dans un corps sain.;324;367;10;123;824
BensadaKarim;Bensada.karim;;142;309;47;326;824
ousmanecisse;Dr. Ousmane CISSE;Mineral law and policy;133;282;370;34;819
John29Inv;John Breizh;;266;46;18;489;819
53794Dia;đź‡¸đź‡łAdama Kaladio;Project Manager. Social Worker.đź¤ťEmpowermentđź’Ą of womenđź’«. Childrens rightsđź’Ş ChoniqueurâśŤđź‡¸đź‡łđź‡«đź‡·đź‡˛đź‡·;373;190;102;149;814
KamaraMahamado2;Kamara Mahamadou;"Économiste
Banquier d'affaires
Écologiste";138;117;5;554;814
StLuLuu;StLuLu;Du côté de la côte d’émeraude. #teampharma industrie;536;166;7;103;812
theeinformer;The Football Computer;Football computer;714;41;8;45;808
MEL_Avenir;Métropole Avenir;Groupe politique constitué de 32 élus de la @MEL_Lille, présidé par @Marie_Tonnerre;137;396;235;39;807
celui_qui_est;Nom contractuel;Fier membre du personnel sous-payé de l'ESR. Peut servir de plante verte lors de déplacements officiels à l'étranger.;81;665;14;47;807
JulienHR_Mtl;Julien Hénault-Ratelle;"Conseiller de ville pour le district de Tétreaultville
Porte-parole de l'Opposition officielle en développement économique";197;181;158;270;806
tertusssss;tertus;;430;23;4;348;805
MpianaPascal3;Mpiana Pascal;H;253;412;135;5;805
LudiBinoche;Ludivine Binoche;Principale Collègue A.Bruant;66;109;73;557;805
alainbaston;Sylvain COHEN TANUGI;;751;4;9;39;803
bardet_jo;jo bardet;;717;61;0;24;802
tessst14;Bitonio EC;;795;0;6;0;801
vincent_de_rul;Vincent de Rul;;119;188;70;423;800
BEIFrance;BEI en France;La BEI, la banque de l’Union Européenne, est active en France depuis 1959. Ses priorités de financement incluent l’action climatique, l’innovation et les PME.;148;240;110;301;799
kguernouti;Karim Guernouti;"Chef de Service des Relations Extérieurs
au Centre de développement des EnR, CDER (web.facebook.com/cder.dz)
PHD student (univ-alger3.dz/)";102;556;53;87;798
LeandreBenoit;Leandre Benoit;Polytechniques Montreal, energie, mobilité, environnement, économie, social;101;462;12;223;798
coursjus77;Luc beraut;;563;123;22;89;797
michel_priol;Michel Priol;Actif;164;277;102;254;797
mousescorte95;mous;Hé;266;193;20;318;797
ibrahimdjama273;Ibrahim djama pro;Ingénieur électrique PRO;576;172;33;14;795
GustaveBanks;Gustave Banks;Futurologue qui observe les évènements d'aujourd'hui et les tendances de notre futur⌛;72;579;60;84;795
gabrielLabont2;gabriel Labonté;Raiders nation;244;66;6;476;792
MukadiJoseph5;Joseph Mukadi;Panafricaniste,Époux,Séc. hon. de l’EJCSK délégué à la plate forme des confessions religieuses,Consultant GC chez Halo;369;296;64;61;790
IdfSecora;Secora IDF;;787;0;1;0;788
Objectif_AST;Objectif AST;Objectif AST : Le mĂ©dia pour les candidats aux Grandes Ecoles đŻ;519;47;53;167;786
moufid_taleb;Moufid Taleb Explorer;"French explorer, 28YO.

I feel concerned about everything that damages my home: the Earth.";151;83;14;534;782
LyceeCharles;Lycée polyvalent Charles de Gaulle - Compiègne;Lycée polyvalent Charles de Gaulle-Compiègne Lycée des Métiers de la Restauration et du Tourisme Un lycée écoresponsable à taille humaine.;367;72;155;187;781
Henri_Alfandari;Henri Alfandari;Député de la 3ème circonscription d'Indre-et-Loire Conseiller départemental, Ancien Maire de Genillé, Groupe Horizons;37;300;399;42;778
DavidSi68622196;Mosi;;246;74;38;420;778
XMobility2;XMOBILITY Le Mans;#Mobility #Cleantech #Startups : worldwide Event  based in Le Mans to bring together all the innovators for futur of mobility đ Visit xmobility.org;412;66;95;205;778
ArturTesting;testing_artur;hard bio;774;3;0;0;777
MachelNguema;Machel N Nguema;People who underestimate me are still surprised by me at the last minuteð ,the most important thing for me is to get to my destination. Machel N. Nguema;325;131;38;282;776
SimbiHeradi;h.baba;patriote, qui croit aux jours meilleurs de son pays;631;27;15;103;776
oliviermalgrain;Olivier Malgrain IAD Yvelines;Passionné d’immobilier, je fais partie du réseau numéro un en France , aussi bien en nombre de ventes qu’en nombre de conseillers.;728;28;18;2;776
asso_pagestec;Pagestec;Association pour le développement, la promotion et la défense de la discipline Technologie au collège.;677;0;98;0;775
girard_marilyn;marilyn girard;;226;88;25;436;775
CEIMIA_mtl;CEIMiA;International Center of Expertise in Montreal on Artifical Intelligence | CEIMIA contributes to the responsible development of #AI. @GPAI_PMIA;243;279;188;64;774
Snoopx_31;Antonin;;74;171;21;506;772
Radioenvironne1;Radio Environnement Guinée;Radio Environnement, la première radio Web spécialisée sur les questions environnementales et de développement durable en Guinée.;188;289;81;213;771
francoismudinga;françois mudingayi;Activiste de droits de l'homme;339;163;17;251;770
CedricRathier;Cédric RATHIER I RATHIER-CHAZOT Immobilier;J'accompagne les particuliers et les professionnels dans la réalisation de leur projet immobilier en tant que Conseiller Immobilier.;662;58;16;33;769
Doumbiaamara10;Doumbia amara;;119;269;26;354;768
GnonlonsaL;Gnonlonsa Luc;Tant qu'il reste à faire,c'est que rien n'est encore faire;143;129;35;460;767
Damiensribeauc1;Damiens ribeaucourt;;719;29;4;15;767
heaeolik;huntcent;;555;13;3;195;766
DelphineFoca;delphine foca;Enseignante en STL Biotechnologies et en BTS ABM;228;49;44;442;763
CercleReforme;Le Cercle de la Réforme de l'Etat;Le Cercle de la Réforme de l’État est un cercle de réflexion indépendant, entièrement dédié, et c’est le seul dans ce cas, au sujet de la réforme de l’Etat.;150;174;222;217;763
Sebo471;Sébastian Zietara;;737;17;3;5;762
HorizonsSGL;Horizons Saint-Germain-en-Laye;Comité Horizons de #SaintGermainenLaye • Rejoignez-nous ! • Référent : @EmmanuelHaiat;86;182;417;77;762
BallaFaada;kallaamou;mouride ! ESP #polytechniQ ðIT techniQ #programmeur #Sonatel #VidÃ©otron (Canada maroc) #baytourÃ© MH #sauroubay2rÃ© #ð¸ð³ð²ð¦ð¨ð¦ð;303;211;145;102;761
gracekintoki1;gracekintoki;Gestionnaire, Marketeur, Motivateur, Entrepreneur, Designer, analyste politique, chercheur;291;117;56;294;758
Clinique_Rouen;Clinique du Droit de Rouen;En association avec le @m2daf_rouen. Pour nous contacter par mail : cliniquedudroit.rouen@gmail.com;350;80;243;85;758
GREENMOT_off;GREENMOT | Drive Innovation;Nous optimisons la consommation énergétique des véhicules légers et industriels #Rétrofit #Essais #TestCenter #TransitionEnergétique;343;136;60;219;758
antoine_bastin;antoine bastin;EFQM Master Assesor & consultant;585;34;33;105;757
MasterCEDDETE;Master CEDDETE - URCA;Master Economie Appliquée - parcours Chargé d'étude en Environnement, Développement durable et Transition Ecologique - UFR Sciences Eco. et de Gestion - URCA;229;129;110;289;757
pvlvalais;Vert'libéraux Valais / Grünliberale Wallis;"Parti de #créateursdavenir, s'engageant pour un Valais performant 💪, progressiste 🏳️‍🌈 , ouvert 🇪🇺 et écologique🚇.
Une nouvelle force de proposition🍀";315;76;241;123;755
CLuyeye77;Cedric Luyeye;;251;97;29;378;755
xlittlegardenx;Judge;Pouvoir au peuple / ce monde est cruel;157;245;28;324;754
ismael_claude;Ismaël Claude (Bolo);;301;66;6;380;753
FemmesVoix;Voix de Femmes;Voix de Femmes est une organisation non gouvernementale qui fait la promotion des droits de la femme et de l'enfant et des droits humains en général;140;286;296;31;753
Benjamin_Prd;Benjamin - Kreypt;I try things and have fun  @KreyptmusicNFT  and also board member;365;116;94;171;746
ademe_bretagne;AdemeBretagne;Compte officiel de l'Agence de la Transition Ecologique en Bretagne;257;74;274;139;744
Toneo_First;ToneoFirst Mastercard®;"Mastercard® by ToneoFirst

Votre carte sans engagement, sans condition de revenus, et toujours à partir de 0€ / mois ! 💳

C’est le 🔥 !";640;60;30;13;743
AfrikaOng;ONG Mama Afrika (ONG MA);La culture, l’éducation ,la santé , l’environnement, les ODD sont nos priorités;404;51;238;50;743
AmbBoukrif;Amb.Hamid Boukrifđź‡©đź‡ż;Diplomate. Enseignant-chercheur.;170;33;442;95;740
NabetAmar;NABET Amar;"Support me on YouTube  type sportsh24
piped.video/@sportsh24";524;8;2;206;740
soupizreddy;soupizreddy;l'#homme augmenté vient-il du myolithique supérieur ?;89;31;2;615;737
archip_lobo;Archip Lobo;Co-founder and Business Development Officer at Nuru, DRC’s agribusiness-(cafékivu), water Access, energy transition, land governance, policy reforms.;76;458;75;125;734
therealyeahmen;kedav;infirmier libéral, defi lover, cycliste, ski de rando amoureux de la montagne. le privilège de l’âge, pas besoin de longtemps pour savoir que c’est de la merde;253;132;35;314;734
absoluce;Absoluce;Le groupement de conseils aux entrepreneurs, solidaire et indépendant;574;35;70;53;732
Solenat_;Solenat;#Solenat est une association créée par des agriculteurs des @PaysdelaLoire pour proposer aux acteurs privés et publics des contrats de services environnementaux;182;127;282;140;731
JAO96629128;JAO;;679;16;1;31;727
LifeEternel;Militante UnJourâđ;"Cash, chiante, fidĂšle et marrante !
Lutte pour l'Ă©cologie et la connerie humaine. Mais il y a du boulot đ";275;80;11;361;727
fcp0712;fcp;;664;33;0;29;726
JP_Brundu;Brundu-JP;#marseille # Président de l'Université Populaire Marseille-Métropole @upop_13 # animateur radio #RadioGalère #LAgora #lavoixdanslesidees;336;169;90;129;724
KakujaJeremie;kakuja jeremie;"Jeune entrepreneur c.e.o
Économiste";29;492;16;183;720
fafa56460;fafa56;;186;75;5;452;718
julesleboyz;JULESLEBOYZ officiel;"Les vestiges historiques,l'histoire est sombre quand tu parles tu tombe je suis a6 sur ma tombe ombre.
@julesLęboÿ";78;293;6;341;718
IBerroAmadei;Isabelle Berro-Amadeï;Conseiller de @GvtMonaco - Ministre des Relations Extérieures et de la Coopération;230;119;176;193;718
simonpie;simonpie;;609;21;12;75;717
MarcLeTerrien;Marc Le Terrien;;301;63;19;334;717
PuechPierre2;Puech Pierre;#immobilier #maisons #appartement #appart #villa #Demeures #Propriétés #piedaterre #hautdegamme #luxe #prestige #Sceaux #Bourglareine;645;21;50;0;716
villededivonne;Ville de Divonne-les-Bains;"Compte officiel de la ville de Divonne-les-Bains. 
Actus, infos pratiques, événements... #ilovedivonne";612;41;61;2;716
RaphaelleY13095;Olivia Raphaelle Yao;trouve son bonheur dans les petite chose et ne porte pas de jugement sur autrui...j'aime la différence des autres;97;423;19;175;714
CucchiLaetitia;Laetitia Descoin-Cucchi;Directrice de la communication @aue_corsica;53;353;83;224;713
thomas_bbu;Thomas Bbu;Entrepreneur #EnR đ | EngagĂ© pour la transition Ă©nergĂ©tiqueâ»ïž #transitionĂ©nergĂ©tique #Ă©cohabitat #Ă©nergiespropresâïž;87;95;18;512;712
inclunea;Inclunéa;"Développer des supports de communication fonctionnels pour faciliter l’inclusion des personnes en situation de handicap.
#MadeInFrance #CAA #autisme #trisomie";235;40;94;341;710
AugustinNikeima;Augustin Nikeima;;509;134;12;55;710
Bart_955;Bart;🇹🇳;236;181;37;255;709
20Chaigneau;Vincent Chaigneau;Personal account. Opinions are mine. Views from around Europe, esp. the UK, France and Sweden, where I live. Loathe both conspiracy and propaganda.;135;273;23;277;708
VivienLaater;laater vivien;je suis capable du meilleur comme du pire mais dans le pire je suis le meilleur ...;232;57;16;403;708
baffeur77;GRINCHEUX;Élargir son point de vue. L’ouverture d’esprit n’est pas une fracture du crâne!;378;90;24;216;708
GuyhoquetRomans;Guy hoquet Romans;Agence ImmobiliÃ¨re ð¡ Achat/Vente ð¬ Location ð 04-69-28-12-78  romanssurisere@guyhoquet.com;677;18;10;0;705
EmmanuelCoque;Emmanuel Coque;;618;69;14;1;702
gateopen7;gateopen;We facilitate access to information through the publication of opportunities for Africans. Our target is made up of Community groups,Municipalities and star ups;263;290;58;90;701
Frantz08069541;Frantz;Que tu t'appelles Michel ou Mohammed, aime la France ou quitte la.;471;37;16;176;700
modemploisrs;Mod'emplois;đ La 1Ăšre plateforme qui propose Ă  tous les futurs entrepreneurs en quĂȘte de sens le mode dâemploi de projets Ă  impact positif, rĂ©ussis et duplicables partout.;277;119;131;173;700
KNegaut;Jean Paul Mundibu (children Yah);"Kintwadi ya Bakongo. 
L'avenir, ça se travaille.
Ni de gauche ni de droit, je me sens libéral.";587;42;7;63;699
spi_62700;Stephane Plaza Immobilier Bruay La Buissière;À l'écoute de besoins et projets immobiliers;525;146;8;20;699
ClubAudace;Club de l'Audace;Créé en 2003 par Thomas Legrain, le Club de l'Audace a pour but d’organiser et de favoriser des rencontres professionnelles Club-Audace.com;130;351;91;127;699
tzcld20;Territoire Zéro Chômeur Paris20;Collectivement nous identifions des activités utiles qui permettront de créer des emplois locaux destinés aux habitant.e.s du quartier Fougères Le Vau.;104;375;127;91;697
getyellowfr;Yellow;"Le tableau blanc qui illumine vos workshops, réunions d'équipe et présentations ☀️
#collaboration #communication #intelligencecollective";221;110;133;233;697
FNAIM_Picardie;FNAIM Picardie;Votre projet immobilier mérite l'expertise d'un professionnel.;681;0;16;0;697
TransitionsEco;Transition écologique du droit économique (TEDE);"Projet de recherche pluridisciplinaire visant à identifier les leviers de la transition écologique en droit économique

♺ et ♡ ne valent pas approbation.";287;81;121;206;695
CRECQ;CRECQ;Le CRECQ est un OBNL qui travaille en concertation pour la protection de l'environnement dans une optique de développement durable au Centre-du-Québec.;209;113;250;117;689
pelle_michel;PELLE Michel;Enseignement catholique Ille-et-Vilaine;355;36;260;32;683
EdouardC12;Edouard C.;@ESSEC alumni;62;349;10;262;683
reix_toine;Antoine Reix;CPE à @acmontpellier, Lycée Pierre Mendes France | 🎓M2 Meef CPE à @FacEducMtp | STAPS à #UT3 | #Rugby 🏉 | 🗺️🇫🇷🏴󠁧󠁢󠁥󠁮󠁧󠁿🇪🇸🇩🇪🇮🇹🇬🇵🇺🇸🇲🇶🇨🇭;117;125;42;396;680
RoueOng;ONG-LA ROUE;La ROUE est une ONG qui encourage et promeuve la participation des jeunes au développement de la Guinée 🇬🇳;179;137;141;222;679
DGS_transports;DGS Transports;DGS Transports, spécialiste en #messagerie et  #distribution de colis / palettes en France et en Europe | Membre du réseau TSE & Sud Intégral;225;148;169;136;678
HubertMacron;Hubert Macron;"ūü§Ė Uberisation des discours d'E. Macron par des mod√®les de langage.
Tous les messages sont g√©n√©r√©s par des alternatives libres √† ChatGPT (Alpaca, Vicuna, etc.).";545;128;4;0;677
MARTINL21009522;MARTIN LUIS;aucune;652;11;0;12;675
jeandenismuller;Jean-Denis MULLER;Directeur général @ Le réseau des Carnot;463;85;111;15;674
Jjur_ow;Jjur;I don't need you to tell me who I am;187;116;19;349;671
lokoli_jimmy;Jimmy Lokoli;;110;316;59;186;671
Emilac63;Lacourt Émilie;;228;40;6;396;670
Amf49Maires;AMF49;"Association des #Maires et Présidents de Communauté de #Maine-et-Loire
#amf49
@l_amf";143;71;178;275;667
noel_wika;NOËL BASEMBE WIKA;"Analyste politique, ex-membre du MLC et de RSF de Lunda Bululu.

Je me définis en personne souffrant de la folie de sincérité.";187;192;135;152;666
AbcComptabilite;Abc-comptabilite;;582;31;50;1;664
GAUTIERRomain8;GAUTIER Romain;;74;112;130;347;663
HenriMorin11341;henri-joseph morin;;348;3;11;299;661
share_the_spink;Pink Coconut Lady đźŤŽ;IDGAF quand mĂŞme;152;200;24;285;661
GEcologistes;Les écologistes 🌻 Seine Yerres Sénart 🚣‍♂️🌿;"Groupe local du Val d'Yerres Val de Seine de la forêt de La Grange à celle de Rougereau

Nous contacter par mail : valdyerres.valdeseine@eelv.fr";194;289;119;58;660
Nervien59;everett hitch;;242;3;3;412;660
AndrFartoukh;André Fartoukh;;615;14;0;29;658
mindsetik;Mindsetik®;Imagine ce que tu pourrais accomplir avec un état d'esprit positif et gagnant... Restons concentrés. 🧠🖤 L'énergie est bonne ici ! ⚡️;497;32;59;68;656
CabinetGrehal;Cabinet Fabrice GRÉHAL Assurances;Courtier et agent général en assurances d'entreprises (Dommages, prévoyance , placement...);647;5;3;0;655
KHulet_off;K Hulet;;292;96;1;266;655
rlog57;Robert LOGIACCO;;24;46;11;573;654
IsabelleLabord2;Isabelle Laborde;;284;152;8;209;653
darmau_marie;Marie Darmau FREDON IDF;Responsable Partenariats FREDON IDF;216;103;51;280;650
saposparfums;Saposparfums;Sapos parfum: un parfum pour tout le monde. Nouveaux arrivages disponibles chaque semaines.;239;1;277;133;650
MichelVuTh29598;Michel Vu Thi;Le doute est-il le socle de la recherche ?C'est plutôt la certitude qu'on sait, quelque part, mais pas encore consciemment, qui donne envie de chercher.;224;170;156;99;649
EljyLaure;Eljy Laure;"Artist - Author - Creator
Artistic Mediator - Art Therapist
 Woman of the world and elsewhere.
House of Artists Order No. J252806";533;53;45;18;649
Blind216Blind;TS_ ðŸ‡«ðŸ‡· Ù†;Â« Dans la guerre qui s'engage, la France sera hÃ©roÃ¯quement dÃ©fendue par tous ses fils, dont rien ne brisera, devant l'ennemi, l'union sacrÃ©e Â»  ðŸ‡«ðŸ‡·;449;41;25;132;647
elodie_rich;Elodie Richard;Enseignante de @ClasseReyvroz #classeunique #Reyvroz #CircoEvian #RobotEvian #E3D1 #marepedagogique #VendeeGlobe2020 #flexible;131;286;81;149;647
CryptOdysseeFR;Crypto Odyssée;"🔍 Actualité et enseignement #crypto & #blockchain
🎓 Mission : informer et guider la communauté francophone";432;76;24;114;646
ekolloenvi;Ekollo;Media dédié aux ODD de l’environnement #GreenTech #EkoDurable #EkoPortrait;293;30;42;281;646
YSory;wenssa le charismatique;pour l'égalité et la justice pour tous dans le monde avec l'assistance de DIEU;300;40;10;295;645
IbKonate11;Ib Konate;;379;181;21;64;645
Diomde5;le chat;Spectateur de la société;226;91;5;323;645
wonderful_gone;Frédéric GAUDIN;;93;148;27;376;644
BachoudC;BACHOUD Constance;"Directrice de l'Innovation Circulaire @TrioGreenwishes
Professeur.e de RSE @Paris_Dauphine
#économiecirculaire ♻️ #développementdurable";171;251;101;121;644
Midi2i;MIDI 2i;#MIDI2i : Fonds d’investissement d’immobilier d’entreprise : gestion, valorisation – SCPI - Fonds Energies Renouvelables;272;215;86;70;643
Kazama242;Kazama243;Activiste indépendant juste pour la liberté et l’égalité pour tous les immigrés ✌🏾243&242;455;81;22;85;643
Lion_Electrique;Lion Électrique;Lion Électrique est un fabricant innovant de véhicules lourds 100% électriques, dont des camions commerciaux de classe 5 à 8, autobus scolaires et minibus.;231;98;222;87;638
FonciereVdParis;Foncière Ville de Paris;🚀La Foncière de la Ville de Paris facilite l'accession à la propriété des classes moyennes et modestes #brs #ofs #paris;74;304;135;125;638
daventura972;David VENTURA;Professeur de Technologie au Collège Constant Le Ray Vert-Pre Robert Martinique;146;143;126;223;638
UdRCenC91;P-Oubit;Usager quotidien du RER C et des autres transports en commun franciliens, fatigué des difficultés quotidiennes.;369;38;4;226;637
ClassemediasMLV;Classe Médi@s;"Classe Médi@s du collège  La Vaucouleurs. 
Classe labelisée en 2020, elle regroupe la 4ème A (SEGPA) et la  4ème M (générale).";135;193;125;184;637
bouni333;bouni;;182;83;5;366;636
LietarRonan;Ronan Liétar;Photographe;267;133;75;161;636
Cooperans_Fr;Cooperans;"Cooperans est un cabinet de conseil en politiques de développement, connectivité et coopération internationale.
Anglais: @Cooperans_En
Chinois: @Cooperans_Zh";372;119;72;72;635
PartiPais;PAIS;Parti Africain pour l'intégration et la souveraineté  . PAIS;187;401;42;5;635
Royal_Obliviion;Dervaux Thibaut;;176;159;11;288;634
Insider_Mobil;Eric_Ritter;;302;100;12;219;633
deunze;Den;Whatever Engineer;254;184;15;179;632
CapitalInfoHT;Capital Info;Pour un monde libre, l’Information est capitale.;291;5;43;292;631
novotsky;novotsky;n'aime pas trop les injustices, tout le monde a la droit de vivre décemment;597;22;0;11;630
RemoNerV;Remo;"♥／l 
（ﾟ､ ｡7 
　l、 ~ヽ 
　じしf_, )ノ";31;562;36;0;629
ecoactumaroc;ecoactumaroc;ecoactu.ma;611;8;3;7;629
templie40351919;templier;;474;37;3;114;628
WatcrTrue;WatcrBoy;;114;36;2;476;628
ONG_ADDEH;ADDEH;Militant de droit de l'Environnement et de l'Homme;540;84;3;1;628
libre_express;Libre Express;Suivez toute l'Actu #Securite #Justice #Terrorisme au #Benin , au #Sahel en #Afrique de l'Ouest et dans le #Monde;371;91;150;13;625
RQMP6;RQMP;Regroupement québécois sur les matériaux de pointe (RQMP) - FRQNT;232;111;86;195;624
pascalhasting;Pascal Lendormy;;221;122;15;265;623
Stevelin_imanga;Steveline Imanga;Citoyenne du monde !;213;55;18;337;623
IlungaDaddy5;Ilunga Daddy;;455;11;3;153;622
folynedy;Foly Nédy;Chanteuse Opéra, Moderne, Afro, Classic;149;160;179;133;621
gchanseaume;Grégory CHANSÉAUME;#assurances #professionnels #entreprises #prévoyance #retraite;468;41;48;63;620
ZertalSalim;zertal salim;Ma liberté de penser;213;53;2;347;615
InsideTaiwan;Inside Taïwan;Le webzine francophone sur Taïwan;343;82;89;101;615
j_pommerole;POMMEROLE Jérémy;Maison de Quartier Beaujardin;277;93;33;212;615
Samthenuggetman;SamTheNuggetMan;Season 5;493;20;2;100;615
cableriedaumesn;Cablerie Daumesnil;Dynamisme, réactivité et pas moins de 7 000 m² de câbles et fils électriques aux portes de Paris à votre disposition à des prix compétitifs.;459;50;88;17;614
SalonDuBrasseur;Salon Du Brasseur;Le Salon du Brasseur est un salon professionnel leader en France destiné aux brasseurs professionnels et amateurs.;156;73;274;110;613
MediaLibPresse;MediaLib;#Anticensure Les faits rien que les faits “Si vous voulez dire la vérité aux gens, faites-les rire, sinon ils vous tueront.” Oscar Wilde;132;450;20;9;611
AyitiIni;AYITI INI/HAÏTI UNIE/UNITED HAÏTI;Pour une Haïti libre et prospère;66;449;80;14;609
Inattentif;L'inattentif;;179;209;5;214;607
ActusEnergies;Florine Lesieur;Bienvenue ! Je m'intéresse de près à tout ce qui touche aux énergie solaires et j'ai créé ce blog pour partager mes connaissances avec vous.;600;0;6;0;606
ma_skim;Maxime;"ingénieur, surfeur, breton.

CGT ✊ PartiPirate 🏴‍☠️ #Nupes";276;128;85;116;605
DefranceKrys;Defrance Krys;;59;15;3;528;605
BOUKHARIThierry;Thierry BOUKHARI;Directeur Délégué GIFI;376;132;64;27;599
Todomodo55;Todomodo;Médecin HU et chercheur en biologie cellulaire;391;23;4;178;596
gobrokcrypto;nuance;"Toujours surpris de voir autant de personnes s'invectiver, autant d'énergie et de temps gaspillés!
Putain d'époque!";151;198;1;245;595
RedLine544;Adrien Houdry;GROWTH x CLIMAT = invalid_request đ;476;49;21;48;594
ArmpBenin;Autorité de Régulation des Marchés publics - Bénin;L’Autorité de Régulation des Marchés Publics (ARMP) est une autorité administrative et indépendante chargée de la régulation de la commande  publique au Bénin.;276;61;239;18;594
DavidNishimwe1;David Nishimwe;chief executive at @CEJG_Burundi;27;497;18;51;593
MoonBordeaux;MOON;We empower African rural communities with innovative clean #energy solutions and help governments achieve universal #energyaccess (#SDG7).;163;146;109;173;591
DevSuccess_HQ;DevSuccessHQ;"ð¯ ExpÃ©rience TerminÃ©e
ð¤ Je suis une expÃ©rience 100% automatisÃ©e !";398;87;106;0;591
AAcajjaoui;Temps Actuel;;500;14;6;71;591
DpKore;Abe Jèn Kore Jèn;ABE Bric à Brac & SERVICE DE PRÊT PDG DG PIYAY BARBERSHOP PDG ABE Transport(ATLOVV) Resp Gestion Stock Valerio Canez;453;33;24;78;588
ModellingEnergy;Energy Modelling Hub;Bringing the Tools to Support Canada's Energy Transition;64;246;205;73;588
ElodieDesigner;Designer Elodie;;164;255;26;143;588
thierrymidi;Thierry Midi;Chanteur, musicien, conteur et magicien je rentre dans la peau des animaux avec mes costumes géants pour faire chanter, danser et rêver les enfants.;288;160;61;79;588
barmeimmo;BARME IMMOBILIER;Notre objectif ? Vous accompagner au mieux dans vos projets d'achat, de vente, de location, ou de gestion en s'adaptant à vos attentes.;585;0;3;0;588
lesage2018;Alain Ndaba Lesage;Master en administration des affaires et Expert en statistique de la population.;204;142;22;219;587
joelkei;joel kei;Journaliste depuis 3 ans, j'écris pour informer et partager. Passionné de l'actualité, je cherche à comprendre et à rendre compte au mieux.;102;342;16;126;586
lg2_digital_xp;LG2 Digital Experience;Human-centered digital products and experiences from @lg2_agency 🇨🇦.;125;104;203;151;583
R2PI_podcast;R2PI - Podcast;"ðR2PI, podcast de la PI, soutenu par le CEIPI et crÃ©Ã© par ses membres       
ð¬ Nouvel Ã©pisode tous les mercredis 12h
podcast.ausha.co/r2pi";162;221;169;31;583
NunuMuamba;nunu muamba;;468;31;5;78;582
RoroFeyte;Romain Feyte;Responsable communication de la @CACPLOfficiel - Community Manager de la @CACPLOfficiel et de la @villecannes;372;72;49;89;582
tchick23;P@Christ;Serviteur de Dieu et expert en passation des marchés;422;88;3;68;581
FriedaFan3;SINOTRUK Frieda;SINOTRUK EXPORT MANAGER;472;72;35;2;581
Sheriff_Makobo;Sheriff MAKOBO Adrian;Journaliste Top Lualaba FM Kolwezi;148;286;50;95;579
popilo02;popilo;about to learn something;260;69;36;213;578
AudillonS;BOKONAM Samtou;Gestionnaire et suivi évaluateur de projet et programme, 💞 activiste social sur la santé sexuelle et de la reproduction en devenir;46;219;73;240;578
GadjiGuy1;Gadji Guy;« Choisissez un travail que vous aimez et vous n’aurez pas à travailler un seul jour de votre vie. » dixit Confucius.;95;33;1;446;575
ColGVauquelin;Collège Vauquelin;Compte officiel du collège Nicolas-Louis Vauquelin de Toulouse. Un collège du numérique et du développement durable dès la rentrée 2022.;337;105;121;11;574
Verob681;Verob68;;66;95;5;407;573
UneJackie;Une Vie en Plus Jackie;"🌸LE MAGNÉTISME🌸
-Vous recherchez une VOYANCE, un SOIN énergétique, un TALISMAN, une AMULETTE, une ORGONITE, un BIJOU MAGNÉTISÉ, vous êtes à la bonne place";285;39;2;247;573
Menu52749912;Menu;;570;2;0;0;572
Laurent_JDeBord;Laurent / Journal de bord;Blog personnel  #Bretagne #Droite #Souverainiste;192;192;159;28;571
Altimo_;Altimo;#immo #immobilier #bègles #achat #vente #location #immoneuf #estimation #acheter #louer;524;36;7;3;570
Torrensimmo;Torrens immobilier;L'Agence Torrens Immobilier est spécialiste en achat, vente, location, gestion locative et syndic de copropriété à Montauban, Tarn et Garonne et Toulouse.;553;1;0;14;568
RoidelaFenetre;Le Roi de la Fenêtre;Faites confiance au premier site de vente en ligne de menuiserie.  Le Roi de la Fenêtre vous accompagne partout en France.;259;105;186;18;568
GregToulous1;GregToulous1;"Toulousain, je prends l'avion, la voiture, le vélo.
Converti au vélotaf par pragmatisme: +rapide, -stress, - bouchons, +écono, +écolo. 28km/j en VAE, no transpi";125;45;28;369;567
web_observeur;Observateur du Web;;138;104;4;321;567
Leonida60790717;Leonidas;;382;92;3;89;566
lhemercied;MD;Bonjour je suis théologien et je partage des principes spirituels  des pour une vie heureuse et épanouie avec Dieu.;148;66;59;293;566
HassanSall3;Hassan Sall;Rien;497;20;4;44;565
OmatukuArmand;Armand Omatuku;je suis ingénieur pétrolier;53;46;5;460;564
GiGiLedur;MacLedur;Ici on parle crypto, finance et macroéconomie! rejoignez nous sur Facebook « En trade crypto & finance 🇫🇷 » facebook.com/groups/34652273…;248;89;16;211;564
BancsPublics7;Bancs Publics Sète;Créé en nov 2021, Bancs Publics est un collectif citoyen de 900 adhérents mobilisés contre le projet écocide d’un parking souterrain en centre ville.;298;91;74;98;561
CDstockM;Cd;stocks;406;26;7;122;561
BinTshoha;Tshoha bin Onyumbe André Abraham;Enseignant d, universités Diplomate internationaliste et chercheur indépendant , Doctorat en Relations inters#  Dptie, coop inter, Gestion et  Regl des conflits;216;74;10;261;561
andreas_louis_;Andréas;Chargé de projets Climat & Environnement au @rncreq. Membre de @Les_shifters.;251;20;24;264;559
valerflore;Valérie FLORENT;"Coordonnatrice de la Maison de la Biodiversité - ENS FORET DE BUZET 
Adjointe au Maire de Balma chargée de l'Environnement et du DD(2014/2020)";333;72;127;27;559
Convergenceafr1;Convergenceafrique.net;L'actualité du continent et du reste du monde;275;8;33;242;558
ERAPGI;Patricia Gomez Immobilier;;554;1;2;0;557
HeureMaroc;L'Informat'Heure Maroc;Source d'information en continu concernant le Maroc;525;0;32;0;557
SamdalYaz;mancoolsam;;157;164;13;221;555
MahdiCaeruleis;Madmad;Absolument rien d'intéressant;376;19;2;156;553
IliasKAMAL;Ilias KAMAL;Écrivain, rêveur, visionnaire et faiseur de mondes.(Et accessoirement chercheur en intelligence artificielle);61;297;40;155;553
realismebarbu;Bravo Zulu Hôtel;;347;154;21;31;553
LACPOP;LACPOP;Laboratoire d'analyse de communication politique et d'opinion publique, UQAM;198;33;133;188;552
Lepharmacienfr;Lepharmacien;Le dispositif indispensable pour améliorer la communication digitale entre les patients et leur pharmacie référente;430;38;67;17;552
Wydget4212;Wydget42;;82;7;6;457;552
KabundiPatrick3;Kabundi Patrick;Chrétien, passionné du théâtre et du cinéma, internationaliste;130;94;74;251;549
ValerieBastoul;Valerie Bastoul;;359;62;109;19;549
HoulleyEric;Éric Houlley;Maire de Lure, Vice-Président à @bfc_region en charge de la Cohésion territoriale, #BourgogneFrancheComté #BFC;118;133;143;154;548
TheScentSquad;TheScent;Nous sommes là pour vous guider à travers les arômes les plus raffinés. Suivez-nous pour des critiques, des conseils et des anecdotes parfumées 😁.;165;28;96;257;546
vithalise;Thalie;"Psycho Énergéticienne ~
Guidance Oracles

Rendre le travail sur soi accessible et joyeux !";285;29;43;188;545
Aleroux_;Aurélien Leroux;Avocat au Barreau de Marseille;218;58;27;240;543
deboniclaire;Claire De Boni;;431;78;18;16;543
GillesLoumingou;"LOUMINGOU GILLES W ; Educator , Writter";"Hello. I am Gilles. For beginning; thanks  and I believe that we are going to have a good things to share togather. Revelations 2020 talk about it God bless you";375;38;4;125;542
Flowetu;Florent Wetu;;97;261;45;139;542
cookiedougth;Cookie;@BitcueInc Founder / @WSBFrance Crypto-investor;285;128;36;93;542
DhayenYakfiStop;Dhayen Yakfi Stop;Dhayen Yakfi Stop est une campagne qui a pour objectif la prévention et la lutte contre les violences faites aux femmes et aux filles (VFFF) en Algérie.;473;42;19;7;541
SYDERhone;Syndicat Départemental d'Energies du Rhone;Le Syndicat Départemental d’Énergies du Rhône est un EPCI qui, dans le département du Rhône, est l’autorité organisatrice de la distribution d’électricité.;97;264;96;83;540
julienpierejean;julien pierrejean;;397;35;0;107;539
DVAExecutive;DVA Executive Search;DVA Executive Search est un cabinet de #recrutement de #cadres et de #conseil en ressources humaines, spécialisé dans les #métiers de l’#immobilier;166;164;69;138;537
salocinreyob;Nicolas Boyer;;227;245;44;21;537
vpmedd;Min. Environnement et Développement Durable RDC;Vice-Primature, Ministère de l'Environnement et Développement Durable - RDC;227;9;108;191;535
XLottheSafti;Lotthe Xavier Abithea Martigues Côte Bleue;Agent immobilier expert de son secteur, présent pour vous accompagner tout au long de votre projet, alors échangeons 👍;370;109;30;25;534
CRE_BSL;CRE du Bas-St-Laurent;Organisme de concertation régionale en matière de protection de l’environnement et de développement durable.;240;91;110;92;533
LeBivouak;LE BIVOUAK';"Un espace de #coworking au cœur de Landiras, en #SudGironde.
125m² d'espaces de travail : salle de réunion, un open-space, 2 bureaux privatifs.";436;72;19;6;533
IrocoDigital;Iroco;"Développeurs d'un numérique plus responsable. 
Mail éthique, transparent et éco-responsable : ouvrez votre compte sur iroco.co";333;68;21;111;533
rmglzz;Rémi Gliozzo;Fondateur et brasseur à La Malpolon. marottes: bière, rock, arts graphiques et cuisine. Fut un temps parisien.;199;145;63;125;532
_shroedinger;Shrodinger;;252;58;8;213;531
C21_Auteuil;CENTURY 21 Auteuil immobilier;Agence spécialiste du 16ème arrondissement, partenaire idéal des propriétaires cherchant à faire estimer leur bien, à vendre, à louer ou à faire gérer.;530;0;1;0;531
kristel_olben;Kristel Olben;"Marxiste et donc révolutionnaire.
Habite une ville de 35 000 hab. dans une région rurale. 
Rédactrice du Bulletin rouge. Me contacter pour le recevoir.";360;58;52;58;528
bernardmani4;Bernard Mani;"Né à Katanga Manono 02 Juin 1989 

Acteur Humanitaire";173;224;130;1;528
noel_coralie;Coralie NOEL;HFDD Haut-fonctionnaire au développement durable du ministère @education_gouv Engagée pour la transition écologique et l'éducation au développement durable #EDD;129;37;252;108;526
loic_MKG;Loïc MOUKAGNI-MOUNGUENGUI;Jeune Étudiant en Économie à l'université Omar Bongo passionné de la question Climatique et environnemental.  responsable projet de l'ONG DDB et CA  JVE Gabon;47;196;93;189;525
OpaDevelop;Tourisme durable,Tourisme responsable Océan Indien;La #vitrine du #Tourismedurable #Tourismeresponsable dans l'#Océanindien , et  du #Développement #Paysoceanindien #initiatives #ONG remarquables;403;60;13;48;524
Xanxosst;Old Fellow;;295;104;0;124;523
JournalSantEnvi;Journal Santé Environnement;Média d'investigation, de vérification et d'information dans le domaine de la Santé et de l'Environnement en Afrique.;331;152;23;17;523
DubourgNico;Nicolas Dubourg;;135;24;6;358;523
titiraif;taïtaï;;104;57;22;336;519
Leveridiq;Leveridiq;;130;19;0;370;519
lenergiedelame;L'énergie de l'âme;✨ Nettoyage, Harmonisation, Dégagement et Purification de personnes d'animaux et de lieux✨ ✨ Praticien en Radiesthésie Hébraïque - Radionique - Onde de Forme ✨;438;60;7;13;518
gautron_marie;Marie Gautron;"DĂ©veloppeuse front-end chez @TroopersAgency #react #nextjs. đ»
EngagĂ©e pour un numĂ©rique plus responsable đ± #accessibilitĂ© #greenit
Fondatrice @TookeaVoyage âïž";159;147;56;154;516
DMA_ONG;Défense des Milieux Aquatiques;DMA a pour vocation exclusive d'agir pour la défense, la protection et la conservation de l'intégrité du milieu aquatique naturel.;172;166;50;127;515
cherchereveur;Mysun;MySun est votre partenaire confiance pour vos travaux de rénovation energetique en france;226;38;2;249;515
EspoirRtv;Espoir TV;organe de presse;431;22;43;18;514
ProRomanaz;Romanaz pro;;178;201;18;115;512
hadjambaloufof;Hadja;"Fondatrice de Fabik Ferme Ecole, prémière école privée d'agriculture de Guinée. 
Présidente du Reseau AWLN autonomisation des femmes rurales";68;130;60;253;511
MarnezImmo;MARNEZ IMMOBILIER;;503;0;6;0;509
1P4A_ACTED;1Planet4All;Financé par l'Union Européenne et mené par 14 ONG, dont ACTED en France, 1Planet4All est un projet destiné à sensibiliser la jeunesse aux enjeux climatiques;332;92;66;18;508
PatrimoniaC;Patrimonia Concept;Spécialiste de la fiscalité et de la location meublée.Courtier en maisons individuelles, transaction neuf et ancien;504;0;2;1;507
AminDaoudH1945;Amin Daoud Houssein;;130;175;13;188;506
CFeucheres;Collège Feuchères officiel;CHAM Classe Défense UPE2A Classe relais BIL ALLD/ESP ITALIEN Pôle espoir Hand Patineurs Label Num 3 EDD3 Label 1 🙋🏻‍♀️=🙋🏼‍♂️ @flofisch1 ppale adj admin;142;70;80;214;506
CSINATECH;CSINATECH;Constructeurs et équipementiers Chinois de matériels de construction et de véhicules industriels. Start-ups et sociétés Chinoises des hautes technologies liées.;213;17;13;261;504
myriam_afia;Myriam Afia;Univers Ecofem association Présidente Eco-féminine amoureuse de la nature , artisane du bien-être@universecofem;61;140;9;294;504
ZomeGabu;Gabu Zome;;476;25;0;2;503
AudaceGaming;Audace Gaming;Volet Gaming d’Audace Studio. Projet en cours de développement sur Twitch/YT/TikTok. Contact : audacestudio.business@gmail.com;94;246;18;144;502
mines_media;mines.media;« Se défier du ton d’assurance qu’il est si facile de prendre et si dangereux d’écouter »;346;38;107;0;491
samuelpilot;Samuel PILOT;;84;348;29;28;489
Dexterk_69;Dexter;π©πΏ;193;96;11;189;489
UDI_du_94;Élus UDI du Val-de-Marne;💜  Groupe des élus @UDI_off & apparentés au Conseil départemental du Val-de-Marne  • Président : Jean-Pierre Barnaud  • @UDI_valdemarne;94;197;142;55;488
LouisMotquin;Motquin Louis;;295;41;4;148;488
WelterDelphine;DELPHINE WELTER;"Journaliste TV
Reporter d'investigation
Auteure
#pressejudiciaire
Cover Films 
Les Experts du Crime / Podcasts exclu M6 diff 2023";49;153;61;224;487
gdnclln;Céline;passionnée par les relations euro-méditerranéennes et les questions migratoires. L3 LEA.;88;87;21;291;487
Dugondor_Wolfen;Wolfen Dugondor;"Nous lutons contre les Pédophiles et l'injustice, nous protégeons les animaux et la nature, soutenons Anonymous, les Gilets Jaunes, Etc.
Q 17 Bisous !";289;188;5;4;486
CB7_3449;CB7ALL;;276;137;10;63;486
BloisCapitale;Blois Capitale;;151;149;54;131;485
sweetyprisci;Prisci;Oscille quotidiennement entre extrême bonne humeur et désinvolture. 😏 Instagram : lejournaldeprisci;349;37;20;78;484
frenchsystm;frenchsystm;;437;27;16;4;484
KarimouSMEMP;Salimane KARIMOU;Homme politique au Bénin, ministre des Enseignements maternel et primaire, depuis 2016;258;158;52;14;482
TheVinss140;Vincent Bertrand;;309;75;11;86;481
YDCCoquinDeb;Y.D.C Déborah Coquin;Y.D.C votre agence immobilière 100% digitale vous accompagne dans tous vos projets de vie : piped.video/xcHCXlNEVI8;395;33;5;47;480
Mpoukou1;Mpoukou;tolérant;445;27;0;8;480
AderimChartres;Aderim Chartres;;476;0;4;0;480
0x_Samm;0x Samm;;143;135;18;181;477
KmeleonC;Kmeleon_cosplay;"🇫🇷Cosplayeuse - Streameuse affiliée Twitch Make-up / Cosplay 
🏆Dauphine CFC 2020 Grand Est 
💰ko-fi.com/kmeleoncosplay
instagram.com/kmeleon.cos/";145;51;67;214;477
OlivierBararu;Bararunyeretse@Oly;Quality Service Provider, Founder of The Transformers, Lecturer at ILU & BSSU, Consultant at GINIIS, Interpreter at GNDR and Isoko, Trainer at Infinity Group;32;304;73;68;477
ChambreDuGabon;Chambre de Commerce du Gabon;;192;121;129;35;477
cascades_fr;CASCADES_fr;Créer un système de santé canadien durable face à la crise climatique. Ce projet a été réalisé avec l'appui financier du gouvernement du Canada. @CASCADES_en;315;81;60;21;477
moccromoorish;moorish;;222;35;6;213;476
lighton225;Light ON;Light on est une association de jeunes africains qui fait la promotion du savoir-faire technique et technologie local;203;96;34;142;475
BizzarriniL;Bizzarrini Lucas https://registerbizzarrini.com/;Register Bizzarrini and Iso cars;320;34;2;119;475
CreaXine_France;CréaXine;;167;112;13;183;475
oledimna_DIS;Olivier LE DIMNA;Directeur du Group DIS;316;84;34;39;473
ItelaVaguy;Vaguy Itela;Ma façon d’être avec les autres.;169;177;18;108;472
Cannabix2Gaule;Cannabix et Idefix;;463;2;1;4;470
FM_Anticosmo;FM_Anti-cosmopolite;Franc-Maçon 🔺 de Droite Patriote 🇫🇷 et Chrétienne ✝️ L'assault contre le Mal est lancé Aucun cosmopolite, islamiste, hippie, ne seront épargnés !;342;43;4;81;470
DarthZador94;ZouZ;When the power of love will overcome the love of power, the world will know peace ...;271;51;2;146;470
amandine_ynwa;amandine7514_ynwa;LFC supporter ⚽️❤🔥 #OLSC France;81;79;12;296;468
KevinSannac;ð KÃ©vin Sannac ð;Cartographe chez @enedis_pyr_S (â¡ðºï¸) // #TFC ðð¤ #StadeToulousain â¤ï¸ð¤ #Chocolatine #ComptePerso ð¨ðµ ðªðº ð â®ï¸;149;142;34;143;468
josuARUNA;josué ARUNA;;127;149;166;25;467
lindalikie;Au service du peuple;l'homme du peuple;168;210;64;25;467
Vijay49726999;Currency Times;"Get crypto and blockchain-related news every day. 
#CurrencyTimes $SOL $ETH #BTC #DAO #DEX #NFTS #NFT #NFTart";187;131;33;115;466
ElieKatalayi;ELKAMU;"Congolais d'origine et juriste.
Amoureux du Droit constitutionnel et administratif.";89;257;30;89;465
MonPetitWallet1;Mon Petit Wallet 💵🪙 | Finance & Crypto;Actu quotienne Finance & Investissement 🏦💰 Ici on travaille le mindset pour survivre sur les marchés financiers;236;119;40;69;464
ben_ouppa;Abakar ben ouppa;"(Mathé-Infor)maticien                                                                         
Nul ne peut se prévaloir de ses propres turpitudes";128;44;43;248;463
SevMma;MMA Rodez SEV'Assur;#assurance #mma #rodez;460;0;3;0;463
CecileC_Bib;CécileC_Bib;Bibliothèques / Documentation musicale / Technologies numériques et environnement;62;234;38;127;461
CherdoSafti;Pascale Cherdo SAFTI;Conseillère indépendante en immobilier chez SAFTI à Villeneuve Les Maguelone et ses environs.;461;0;0;0;461
laclasseadalas;Ted Pesch;;69;111;26;254;460
RivDroiteImmo11;Rive Droite Immobilier;Spécialistes dans le 11ème arrondissement de Paris depuis 35 ans, nous vous accompagnons dans tous vos projets immobilier;374;32;12;42;460
labfluens;Labfluens;Le Laboratoire sur l'influence et la communication regroupe les professeur·e·s et étudiant·e·s s'intéressant à l'influence comme pratique communicationnelle.;175;86;157;42;460
AdrExpertise;ADR Expertise;Cabinet jeune et dynamique, qui se veut à l’écoute des chefs d’entreprise pour les accompagner et les conseiller au mieux de leurs intérets.;458;0;1;0;459
0762679z;Collège Jacques Brel - Cléon;;173;36;141;107;457
campusmodeluxe;Campus Mode et Luxe;Attractivité et valorisation des métiers et des formations de la #mode et du #luxe en Pays de la Loire, #parcours et #réussite, #innovation pédagogique;186;124;60;87;457
jeanbono__;Jeanbono;;164;41;32;220;457
ihoebrarbelgium;IHO Ebrar Belgium;We zijn met onze hulpacties en projecten actief bezig met het verbeteren van de levensomstandigheden van de armen en behoeftigen over de hele wereld.;299;11;89;56;455
Corbusier116225;Le Corbusier;La compassion, l amour du prochain , le bien êtres de tous et le perfectionnement  dans le travail;95;253;107;0;455
AmbiaudE;Ambiaud eric;;277;95;3;78;453
in_fi_poitiers;IN&FI Crédits Poitiers;Agence de courtage spécialisée dans le prêt immobilier, le rachat de crédits, la restructuration de crédits, et le prêt professionnel;294;133;7;16;450
SuncorEnergie;Suncor;La vision de Suncor est d'être dignes de confiance pour gérer les précieuses ressources naturelles.;316;2;131;0;449
constant_samuel;Samuel Constant;Enseignant - Militant à la #FSU #SNUipp ✊ - Investi au #DinanRugby 🏉 - Élu municipal à #Languédias;95;268;27;58;448
aldimambou;John M.;Financial Auditor | Co-founder of Global Educ | MOS Master ð»â¨ï¸ | Former President of ConfÃ©rence des Grandes Ãcoles de CÃ´te d'Ivoire ð¨ð®ð¨ð®ð¨ð®;116;95;8;229;448
cofinaudit;COFIN'AUDIT;"Cabinet d'expertise comptable. Accompagnement des Chefs d’entreprise. Création, investissement, cessions, transmissions...
cofinaudit.com/";357;55;22;14;448
Prozon_com;Prozon;Site d'e-commerce spécialisé dans les #fournitures techniques pour les #professionnels. Gagnez du temps et de l'argent en faisant vos achats sur prozon.com 🎯;208;126;32;81;447
CashMakker;Maxime | RM Dropshipping ðŸ“ˆ;E-commercant // je tâ€™apprends Ã  faire de lâ€™argent en ligne // 28 ans et bientÃ´t millionnaire grÃ¢ce au RM Dropshipping. Suis moi et je te montre comment faire.;274;33;34;104;445
RBuchaut;Romain;élu (géo)local(isé), Maire de St-Paul lez Durance, Conseiller d'@AMPMetropole - #Cadarache #iter / facilitateur & militant du territoire/ #géomatique @CrigePACA;288;55;67;35;445
LiptakoG;Liptako Gourma;Autorité de Développement Intégré des États du Liptako-Gourma;47;137;220;40;444
LeFirminhaiti;Le Firmin;Le Firmin est un média qui propose des informations à travers son site web. Les articles se présentent, la plupart, sous forme de commentaire et d'entretien.;93;97;116;136;442
J_T_academie;J_T_académie;"On vous aide à comprendre les marchés et la psychologie mise en place en vulgarisant #économie, #finance et #actualité📊📰
📧contact pro : jt.academie@gmail.com";314;79;21;28;442
HLeloue;Hildegard Leloué;Journaliste @Vivant_lemedia | Photographe @StudioHansLucas  | Illustratrice freelance | Fondatrice EUtopia podcast | 📍 Poitiers;127;181;47;84;439
TerresDemeuresC;Terres et Demeures de Normandie;L’accueil et le plaisir de vous recevoir, sur l'ensemble du territoire Normand, grâce à notre approche singulière de l'immobilier.;435;0;2;0;437
Jagisamonechel1;J'agis à mon échelle;Chacun peut agir concrètement pour la #planète et l'#environnement. Ensemble adoptons les bons gestes pour l'#écologie, la #santé et notre #portemonnaie;184;146;67;39;436
nazih_taha;Nazihovitch Ismailovitch;Cpartak;295;27;4;108;434
agencimpactimmo;IMPACT IMMO;ð;327;11;68;25;431
GreenImmobilier;Green Immobilier;Retrouvez-nous également sur Facebook et Linkedin pour plus d'informations !;383;24;7;17;431
JdsAssocies;JDS & ASSOCIES;Cabinet d'expertise-comptable pour vous accompagne au quotidien ! #Paris #expertcomptable;427;0;3;0;430
AllianceABAOC;Alliance Biodigesteur Afrique de l’Ouest et Centre;L’AB/AOC a pour objectif de contribuer à l’amélioration des conditions de vie et de la résilience des populations à travers la promotion du biodigesteur.;142;80;75;133;430
BakhetAnil;Hamed Bakhet Anil;Bonjour مرحبا;263;111;28;28;430
MaFeuille_com;MaFeuille;Pour une intendance écoresponsable;249;50;8;122;429
Demainyapo;Demain?!?;Montrer qu'on est des grosses feignasses, qui n'ont d'intérêt que pour le divertissement  et détruire;307;64;6;50;427
nathphil7;Nathalie Philippon - Panther'Immo;;233;178;7;9;427
abdou_yassey;Abdou yassey M.yahaya;"""L'histoire de l'humanité est désormais une course de vitesse contre la communication et catastrophe """;297;82;4;43;426
Placements_I;Le Placement Intelligent;Passionné d'investissements et de bourse;140;35;23;228;426
Pantalon1jambe;B2f B2f;;355;25;3;42;425
LegoviauxM;Legoviaux Michaud;;113;302;5;4;424
MONTEROClaude;Alain Claude MONTERO;;158;69;57;137;421
65_college;Collège BEAULIEU 65;Collège Beaulieu Saint Laurent de Neste, section sportive escalade, Internat d'Excellence;73;41;62;245;421
HylikoH2;Hyliko;"Décarbonez votre flotte de camions 3 fois plus vite !
Plateforme de mobilité zéro émission : camion, hydrogène, crédits carbone.";144;141;51;82;418
MinPEMGOUVGA;Ministère de la Pêche et de l'Economie Maritime;Compte officiel - Ministère de la Pêche et de l'Economie Maritime du #Gabon @comgouv;108;37;74;199;418
Kossywa;Kossywa Hougbekey - Coach en performance;Développez votre charisme et performez votre capacité à bien négocier et à mieux communiquer #communication #negociation #charisme #langagecorporel;346;51;11;9;417
GuyHoquetErmont;Guy Hoquet Ermont;;412;0;4;0;416
MusoshiHubert;Hubert M.;Patriote et Humanitaire;163;218;6;22;409
ToureJojo;Jojo_Touré;Qui a les pieds carrés, aime le ballon rond.;136;148;6;118;408
EwenBesson;Ewan Basson;Je critique des gens en citant mes sources;182;60;5;161;408
balanceton8020;Balanceton8020;un petit délire sur l'actualité et ma passion le poker 😀;235;76;2;93;406
internetfm1;Coucou;Scoop : les journalistes sont des fonctionnaires !!;276;44;1;84;405
CPdauphine;CrediPro Dauphiné;Courtier en financements professionnels;385;14;4;0;403
FrenchAcoustics;French Acoustics;French Acoustics est une startup française créant et commercialisant des produits audio made in France. Nos mots d'ordres sont : fidélité et performance.;192;23;47;138;400
CA_Manumesure;Manumesure;Métrologie, contrôles réglementaires et maintenance industrielle;179;107;64;50;400
DefendEthiopia_;Defend Ethiopia EU;"Defend Ethiopia Task Force in Europe (DETF-EU) is a group of Ethiopians in Europe from all walks of life defending Ethiopia. 

More at DefendEthiopia.EU/";128;89;135;47;399
ssac_81370;Saint Sulpice Active et Citoyenne;Une association citoyenne porteuse d'un projet écologique pour un territoire démocratique et solidaire, à Saint-Sulpice (Tarn) #StopTERRA2;322;1;47;27;397
FnaimG;Fnaim 47 Lot et Garonne;"Chambre syndicale de la FNAIM 47 Lot et Garonne
Syndicat professionnel";382;0;14;0;396
BochaDelphine;Delphine Bocha;;23;48;1;319;391
jae_bf;Jeunes Acteurs de l’Energie | Young Energy Actors;Organisation de jeunes spécialisée dans le domaine des énergies renouvelables, de l’environnement et du climat au Burkina Faso;71;243;62;12;388
NaoriKimi;Louis;;276;49;0;62;387
KarambaHadj;el hadj karamba diaby;jouriste de formation  né le 12 Décembre  1957 à Touba Rep de guinee  habitant en France  depuis 1982.;159;170;57;1;387
Cpart_Paris13;Côté Particuliers Paris 13;L'immobilier à sa juste valeur, des services complets, un suivi de proximité, au juste prix. Retrouvez ici les actualités, tendances, conseils #immobilier;357;20;7;2;386
AugustKinglo;Abdon Kinglo;HydroScientist 💧;75;134;38;139;386
OmegaEventProd;Omega Event Prod;Entreprise multi services;22;17;30;316;385
a_deoliveira;Alex DE OLIVEIRA;;151;63;17;154;385
sosehpad;Sos Ehpad;"Solutions concrètes pour vos défis quotidiens.
#ehpad #soins #infirmiers #infirmière #hopital #soignants";239;119;23;4;385
CNENormes;Conseil national d'évaluation des normes;Créé par la loi du 17 octobre 2013, le Conseil national d'évaluation des normes a pour mission d'évaluer les normes applicables aux collectivités territoriales.;126;40;181;37;384
ceditpro;cedric;;57;237;12;78;384
ecoleau;Pierre l'ecoleau;"Spécialiste de ""l'Eautonomie"" en eau de pluie, réglementation, filtration / qualité de l’eau alimentaire ...  #ANC #compost #eau #eaudepluie #ToiletteSèche";101;167;75;40;383
BethanyFoster4;Bethany Foster;Energy Systems Innovation Lead | Physicist | STEM;67;148;34;133;382
SylvieBarkat;Sylvie Barkat;"Bonjour et bienvenue ami(e)s vendeurs et acheteurs, vous êtes au bon endroit.
Vous souhaitez connaitre la valeur de votre bien , un clic sur le lien ci dessous.";376;5;1;0;382
ADCEJinter;ADCEJ;;105;119;116;42;382
kikwembo_kibwe;Kikwembo Kibwe;;90;174;24;93;381
Laffont4369;Laffont;;365;4;1;11;381
Le_Chiren;Me;"Conçoit des solutions via des systèmes de production d'énergie renouvelable à échelle humaine.
Plongé dans le marasme administratif et les lois sur l'e°.";273;2;1;104;380
BaezSilo;silo baez;Ingenieur;351;11;3;15;380
MalagieP;Malagié Pierre;;324;33;21;0;378
LesShiftersLyon;Les_Shifters_Lyon;"Les Shifters est un réseau de bénévoles aux profils, expériences et compétences très variés pour la transition carbone de l’économie. 
Groupe local de Lyon";118;115;127;18;378
LB_Courtage;LB Courtage;LB Courtage;314;53;3;7;377
Stelliant;Stelliant;Choisir l’agilité des services à l’assurance;225;35;68;49;377
Laforet_Nancy;Laforet Nancy Est Nancy Sud et Dombasle;;373;0;3;0;376
Lebout10;Joel Lebout;"Directeur agence SOM Ingénierie de Sites  (joel.lebout@ortec.fr)
Activités de supervision de travaux, essais, sécurité, RP dans le domaine de l'énergie";49;266;48;11;374
FeuilleEmbarque;La feuille embarquée 🍃;Association de promotion de la navigation verte et du cabotage 100% écologique en Méditerranée. 0 émission, 0 bruit, 0 déchet. lafeuilleembarquee@gmail.com;210;33;78;53;374
cayes_infos;Cayes-infos;Le Grand Sud D’Haïti chez vous;333;3;31;6;373
papedio66876223;papediouf;Da boss;31;166;18;156;371
AlhoussariH;ALHOUSSARI Houda;;15;161;22;172;370
ImmoChristel;Christel bourdonneau immo;;360;4;4;1;369
CollgeCourteli1;Collège Courteline;collège G. Courteline, (Paris XIIe), compte alimenté par des publications des élèves des ateliers citoyenneté, biodiversité : valoriser l'engagement;98;46;126;98;368
celeven_07;Celeven;Médium et Psychothérapeute 🦋 | Je t’aide à retrouver ton chemin grâce à un suivi adapté à ton histoire 💙;201;9;41;116;367
PecheurDeFond;Li Po;Investisseur dans la valeur et apprenti en zen.;113;44;72;137;366
AllassaneKonat6;Allassane Konaté;#Politique #Communication #Economie #Digital #Business #Humanitaire;24;189;95;58;366
SYSTRACANADA;SYSTRA CANADA;ðŸšƒ;160;29;137;40;366
ConstasMagazine;Magazine Constas;"CONSTAS, LE MAGAZINE DE L’ASSOCIATION DES CONSTRUCTEURS DE ROUTES ET GRANDS TRAVAUX DU QUÉBEC / ACRGTQ.

Présence du génie civil et de la voirie au Québec.";250;67;47;1;365
EcolearnFrance;EcoLearn;Nous concevons et dispensons des formations dédiées à la durabilité, à destination des professionnels, entreprises et écoles.;198;43;92;32;365
urban_analyse;Urban-Analyse;Urbanism, Mobility, Project Management, GIS, Digitalization & Intelligence;28;157;35;145;365
JulesChatelain1;Jules Chatelain;;225;76;6;55;362
MaximeCoppet;Maxime Coppet;LycĂ©en | PR đ«đ·;204;36;119;0;359
ClermontEtVous;Clermont & Vous;Clermont & Vous est une association destinée à imaginer, travailler et proposer ensemble un nouveau projet municipal à Clermont-Ferrand. Rejoignez-nous !;70;140;108;41;359
JoshuaDamjacq;Joshua Damjacq Mukongela;Étudiant en santé publique dans la filière d'environnement et développement durable à l'Université de Lubumbashi (UNILU).;19;256;19;62;356
MartinotPhilip1;Martinot Philippe;Éleveur #ovin dans les #deuxsèvres, Vice-président de la #cuma La Fontaine à #Pierrefitte . Secrétaire général de la #FNCUMA . Elu chambre d'agriculture.;66;67;62;161;356
Swisslife17000;Assurance SwissLife La Rochelle - Sarah Hollevoet;;267;23;2;63;355
FrancophoneSol;Francophone de la Solidarité;Sensibiliser et agir sur les territoires francophones pour l’écologie et la solidarité 🌱🌍   Association parrainée par @Yann_A_B;19;51;285;0;355
Karl58219994;Karl;leadership autodétermination de l’Afrique;164;16;11;163;354
Mea_Gouv;Ministère de l'eau et de l'assainissement;Compte officiel du ministère de l'eau et de l'assainissement du @GouvernementSn 🇸🇳 @smthiam;114;3;213;20;350
PhilippeFleury_;Philippe Fleury;"Sustainable Development Professional & Economist,
Nature Aficionado & Global Citizen,
Legislative Fellow, House of Commons of Canada.

My opinions are my own";8;252;37;49;346
ExcellproDiag;Excellpro Diagnostics;Excellpro Diagnostics, un professionnel pour vous accompagner dans toutes les démarches nécessaires à la constitution d’un DDT de vente ou de location;342;1;2;0;345
electro_toile;Electro_toile;;313;0;32;0;345
stephane_jubert;JUBERT Stéphane;;223;36;9;76;344
GHClamart;Guy Hoquet Clamart;;290;48;3;3;344
CollegeBouquet;Collège Jean-Claude BOUQUET - Val de Morteau;Collège du Val de Morteau avec ses deux sites : Villers-le-Lac et Morteau;182;52;61;48;343
cnw_france;CNW - France;Réseau national de conseillers en Assurances Indépendants, spécialisé en assurances vie, épargne, prévoyance, assistance, protection juridique.;342;0;0;0;342
Baronchristop14;Baron christophe;;310;14;8;9;341
EffigFormation;Effigest Formation;Accompagnement des entreprises en Conseil et en Formation  : #formation #rh #paie #management #social #communication;178;70;43;49;340
AddixGroup;AddixGroup;ð¨âð» L'ESN labellisÃ©e NumÃ©rique Responsable & Happy At Work ! #DigitalForABetterWorld;91;220;14;14;339
swisslifhalluin;BAERT CHARLOTTE;Votre agence à Halluin vous conseille pour votre assurance vie, épargne retraite, complémentaire santé, prévoyance, assurance de prêt immobilier...;337;1;0;0;338
CCosmopolitanie;La Cosmopolitanie;;62;88;24;164;338
AssoAeT;Association Action et Transition;"Association Action et Transition Paris 15 engagée socialement.
contact.aet15@gmail.com
📍153 rue de la Croix Nivert 75015";100;111;46;81;338
On_Renove;On Renove;;138;9;2;188;337
fmazurkiewicz;fdbmzk;;253;28;1;55;337
actionsMempBj;Actions MEMP Bénin;Actions du Ministre des Enseignements maternel et primaire du Gouvernement du Bénin;175;126;34;1;336
huruma6;HURUMA ADROMA David;Jeune Professionnel au Budget et Expert en puissance en Finances Publiques à l'ENF. Amoureux de la formation multidisciplinaire.;158;92;37;48;335
URBAN_LIVING__;URBAN LIVING PARIS;L’immobilier parisien haut de gamme : conseil, accompagnement, transaction #immobilier #residentiel #paris #surmesure #offmarket #exclusivite;267;52;16;0;335
AMDCEE11;A.M.D.C.E.E;"Association Malienne de Développement Communautaire et de l'Epanouissement des Enfants (A.M.D.C.E.E)
associationmdcee@gmail.com / 60 32 16 80";96;57;24;156;333
steph_ouel;Steph Ouel;;209;64;0;60;333
AllianzTarascon;Allianz Nathalie Frazzitta Tarascon;Nous sommes à votre écoute pour vous accompagner dans vos projets et vos besoins d'assurances aussi bien pour votre vie privée que pour votre activité pro;332;0;1;0;333
CollegePMF;Collège Pierre Mendès France WOIPPY;Compte officiel du collège Pierre Mendès France WOIPPY;78;46;60;148;332
fmartin_cbc;Frédéric MARTIN;Manager at CGI Business Consulting | CleanWalker | et...;269;38;1;22;330
Sidi13093030;Sidi;;61;245;15;8;329
ilanga_amida;Amida Ilanga;Assistante à la faculté de droit /unikin, apprenante à l’école de criminologie de l’université de Kinshasa, coordonnatrice de l’ONGD/ FEDD politicienne engagée;32;161;59;77;329
PourBazana;richard mbiya;Je suis un libre-penseur en politique,passionné pour les Mines , mes tweets n'engagent que moi.;71;183;12;62;328
GBETOENONMONhil;GBETOENONMON Hilary;"Juriste de formation
Deuxième adjointe au Maire des jeunes de Bohicon (AMJB)
Responsable des adolescents et jeunes handicapés de l'association des JLT/UCOZ";40;191;8;89;328
Larcheresavocat;Cabinet Larcheres Conseil;Cabinet d'avocats intervenant principalement en droit immobilier, droit de la construction et droit patrimonial de la famille;325;1;0;0;326
ommaribrahim82;omar brahim;;316;8;0;0;324
VettedExperts;Vetted;Vetted distribue des solutions vérifiées durables pour les entreprises et les acteurs publics | Un besoin ? contact@vetted.fr 📩;223;32;51;17;323
gueille20;Gueille20;"Tout se mérite et le mérite n'est qu'un acharnement à ce dont on ne mérite. 
Citoyen Engagé.  #Economist #AfriCainDécomplexé
#Humanist #PanafricaEntrepreneur";41;104;50;127;322
eminozkara7;Emin ÖZKARA;"Député régional bruxellois indépendant (Parlement bruxellois)
Conseiller communal indépendant (LB 1030)
secretariat.ozkara@gmail.com
+32 477 88 29 16";231;19;21;50;321
milie_pelletier;émilie pelletier;"Photographe
📸PORTRAIT📸ÉVÉNEMENT 📸CORPO
👉info@emiliepelletier.ca
emiliepelletier.ca";50;169;18;83;320
CohadeDiane;COHADE Diane;ðConseillÃ¨re Immo IAD France ðclaix ðRecherche de biens & dâentrepreneurs passionnÃ©s dâimmo ð;314;3;2;0;319
xtofhenry;christophe henry;;147;45;7;120;319
ToursPatrimoine;Tours Patrimoine;Cabinet de conseil en Gestion de Patrimoine indépendant, nous vous conseillons dans les stratégies d'organisation patrimoniale ou d'investissement.;312;2;2;0;316
AllaouiAsna;Asna Said Allaoui;@Directrice AMS SARLU COMORES @Presidente Cooperatve PTCFL @Presidente Association FEMME PILIER DE DÉVELOPPEMENT;77;57;82;99;315
AnAFDVietnam;Nguyen Thi Thanh An;Head of Climate and Energy Team @AFD_France au #Vietnam;72;37;54;152;315
ChloeClair_namR;Chloé Clair;namR CEO | The power of data for ecological transition 🌱;35;120;64;95;314
djallabi_;๐๐ฃ๐๐ฅ๐ฅ๐๐๐ข ๐๐จ๐ฎ๐ก๐๐ฆ๐๐;"๐๐ข๐ ๐ฅ๐ซ๐ฌ๐ฉ๐ฌ๐ค๐ฒ๐ข | ๐ญ๐ฏ๐ฌ๐ง๐ข๐ ๐ฑ ๐ช๐๐ซ๐๐ค๐ข๐ฏ | ๐ฆ๐ซ๐ซ๐ฌ๐ณ๐๐ฑ๐ข๐ฒ๐ฏ | 
๐ฌ๐๐๐๐๐๐๐๐, ๐บ๐๐๐๐๐๐๐๐ & ๐พ๐๐๐๐ ๐๐๐๐๐๐๐";55;138;41;78;312
actio_man;Fondamental'man;"-Etudiant en compta
-Passionné par la finance

L'investissement est comme un puzzle, il faut trouver les bonnes pièces, pour bâtir un patrimoine solide";289;4;18;0;311
Ahaha_hihihi;Ahaha_alala;Du rire aux larmes de rire aux larmes ...;266;38;5;0;309
roof_scapes;Roofscapes;đźŚ± Transformer les toits inutilisĂ©s en espaces accessibles et vĂ©gĂ©talisĂ©s. đź‡şđź‡¸ FondĂ© au @MIT. đź‡«đź‡· BasĂ© Ă  Paris.;68;67;102;71;308
thar_woe;Thar Wö;cigogne des Ardennes;179;88;3;38;308
John_Erwann;John-Erwann Dutheil;;305;1;0;0;306
mohalm22;MOH 🇲🇦;👍;209;39;5;52;305
mdiop2;MOUHAMET DIOP;@Sénégal @telecom @informatique @agrobusiness @elevage @momodiop73;54;141;27;82;304
MKabandika;Divin Patrick Kabandika;Personnalité politique et religieuse, éprise des valeurs morales et civiques de paix, de justice, de liberté et de patriotisme.;84;123;7;87;301
ArmySouhil12251;الوزير;تموتو على التقرعيج🌚;174;27;4;96;301
MartineMerzier;honestly;;205;67;9;19;300
SeguretStephane;SEGURET Stéphane;Je vous accompagne, à temps partagé, et met en place les méthodes et outils financiers essentiels pour structurer votre organisation et gagner en efficacité;297;1;2;0;300
BarbuCorp;M. Lebarbu;;119;145;4;32;300
MihetoNtwara;Santos Ntwaram;;76;138;14;72;300
BollandCollege;Collège A Bolland - Bessières;;99;56;84;60;299
tresaner1;tresaner;A habité a Llanfair­pwllgwyngyll­gogery­chwyrn­drobwll­llan­tysilio­gogo­goch en 1998;239;44;1;13;297
Pj0720Ml;Pj0720;;154;15;6;122;297
ThierryDanguin;Thierry Danguin;Consultant et Auteur #immobilier #hautdegamme #Capifrance #BeverlyFrance #TrielsurSeine #Vernouillet;219;57;19;1;296
LeviFinances;François LEVI Finances;Transmission de Patrimoine,Préparation à la Retraite, Protection de la Famille,Enrichissement Personnel,Défiscalisation,Immobilier,Crédit immobilier;263;31;2;0;296
TAQAMorocco;TAQA Morocco;"Major player in 🇲🇦 Morocco's energy sovereignty 
taqamorocco.ma
#TAQAMorocco";176;79;39;1;295
RICHARD07533683;RICHARD OLIVIER HARTMANSHENN;;270;5;14;6;295
hanau_thierry;thierry Hanau;;165;46;6;78;295
GuillaumeLaco19;Guillaume Lacombe;;154;15;1;125;295
Theo61488406;ZEH ZEH T RODRIGUEZ;diplômé de psychopathologie et de psychologie clinique, master 2 coopération au développement et action humanitaire a l'IRIC. PRESIDENT de L'ASSESIRIC;27;80;18;170;295
FinanceTechArcs;FTA;"Analyse et actualités sur les tendances de la finance et de la technologie. Suivez-nous pour rester informé.
#finance #technologie #analyse #fondamentale";253;2;6;33;294
credipro92;CrediPro Hauts de Seine;Expert en financement professionnel;291;1;1;0;293
IlungPatrick;Patrick Mpumbu Ilung;God;79;90;32;91;292
J_jordane;๐๐ผ๐ฟ๐ฑ๐ฎ๐ป๐ฒ ๐ก๐๐ข๐จ๐ ๐๐๐  ๐ทโ๐พ;#๐๐๐ ๐๐ง๐ญ๐ซ๐๐ฉ๐ซ๐๐ง๐๐ฎ๐ซ๐ | #๐๐ฎ๐ญ๐๐ฎ๐ซ๐ | #๐๐ก๐จ๐ญ๐จ๐ ๐ซ๐๐ฉ๐ก๐ | #๐ฆ๐จ๐ง๐ญ๐๐ฎ๐ฌ๐๐ฏ๐ข๐รฉ๐จ | #๐๐จ๐ฆ๐ฆ๐ฎ๐ง๐ข๐๐๐ง๐ญ๐ | #developpementdurable;58;91;26;116;291
Rrroule;Renée Rouleau, ex-mairesse de Clarenceville;"Humaniste
Mairesse de Saint-Georges-de-Clarenceville (2013-2020)
MAP (ÉNAP 2013)
B.Sc.Urb.";145;95;36;15;291
3H_Conseils;3H Conseils;"Le cabinet 3H CONSEILS, implanté à Reims, est un réseau national
de courtiers en gestion de patrimoine";150;121;18;0;289
JeanAimeKone;Jean Aimé Koné 🇨🇮;Étudiant en Master recherche de Géographie humaine à l'UAO #Bouaké, citoyen du monde. #Lecture | #Leadership | #Management.;24;85;1;179;289
GhlissKamel;Kamel Ghliss;MTR FROID Rungis;29;65;5;190;289
ASSURANCESMEYER;Jean-Thomas MEYER;Assurances Professionnelles;234;52;0;2;288
DavidLamy_;David Lamy;@suez Directeur Général Recyclage et Valorisation France;30;33;208;16;287
ZareSoumaila4;Africa Roots & Nature (ARn);;270;5;1;11;287
JSBatignolles;Jardins Suspendus des Batignolles;Association de promotion de la couverture vegetalisée des voies ferrées issues de la gare st-Lazare, favorisant la nature et la biodiversité au sein des villes;47;85;85;70;287
immochateau75;Immobilière du Château;Valoriser et assurer la pérennité de votre patrimoine, c’est notre métier ! Syndic de Copropriété et Gestion locative immobilière à Paris depuis 1956.;226;42;16;2;286
TsounguiErnest;Ernest TSOUNGUI đź‡¨đź‡˛;Software Engineer;171;19;5;90;285
PiusEkomki;Pius  Ekomki;Project M&E Officer, Youth Champion @ggwnigeria;77;132;66;10;285
instant_eco;Instant Eco;Nous vulgarisons l'économie et la finance pour en apprendre tous les jours. Ne ratez rien des actus et des infos importantes. @instant_eco;125;139;9;12;285
JournalJda;Le Journal De L'Agronome - JDA;Plate-forme d'actualité agronomique.;174;13;42;55;284
LouisLghni;L;Ingénieur dans l'énergie, spécialisé dans l'hydrogène  - Energy account - LC;70;179;1;33;283
AgencePhDesign;PhDesign;Une agence de communication au service des équipes de recherche qui vous accompagne dans la communication des moments clés de vos projets.;83;73;41;85;282
RaymondBykouko;Raymond Bykoukous;Conseil aux entreprises agricoles en matière de santé et sécurité au travail , prévention des risques professionnels. « placer l’humain est au centre de tout »;42;195;16;29;282
ClgCamusTorigny;Principal Clg Camus Torigny;Cyrille DUMESNIL,Principal du collège Albert CAMUS - Torigny les Villes;74;20;64;124;282
DthinkerNetwork;D+hinking;;182;12;86;0;280
MichelPourrez;Michel Pourrez;;276;2;2;0;280
YiLien000;Yi Lien;;228;36;16;0;280
jaysdarkside15;Jason Vorhees;;193;74;9;4;280
SIDE_MTL2023;Side-Sommet international de l’écocitoyenneté;Sommet international de l'écocitoyenneté est un événement fédérateur élaboré pour accélérer l’atteinte des 17 objectifs de développement durable (ODD).;165;70;41;4;280
Philphs42;Phil Phs;;68;37;3;172;280
BesnierJoelle;joelle Leroyer Besnier;;72;118;4;85;279
mbafet;Kiwilhu Mbafé Tossi;;35;61;21;161;278
Assu_Charlet;Assurances Charlet Etienne;Cabinet d'assurances toutes branches : auto, habitation, mutuelle,assurance-vie, placement, professionnel, rc pro.;277;1;0;0;278
IrWorme;Worme Érik ir;;118;80;1;79;278
LajoieArsene;Lajoie Arsène;"Je m'informe et réfléchis beaucoup.
J'essaie d'en retirer un savoir aussi scientifique que possible y compris sur les relations humaines et la citoyenneté.";137;76;2;62;277
AtlanticKaricy;Karicy & Company;"Contribuer à l'atteinte des ODD pour un monde meilleur; expansible et travaille avec les opérateurs économiques.";123;3;9;142;277
premierpiece;🇬🇵 Desperados RED;l'arôme donne du goût au desperados🍺 dans la bouche 👅& 5,9% de ambiguïté⌚ dans  tout le corps humain ça rende RED 🥒🔥💦💬🍑;75;26;11;163;275
AlexandreBernu1;Alexandre Bernuit;😄 Du côté obscur de la force : banquier hier, assureur aujourd’hui. Passionné de nvl tech & business en général ! 💎💡🦁 #sansfiltre #agentgeneral #assurance;203;57;13;2;275
Indymotion;Indymotion;Plateforme (Peertube) de diffusion de vidéos sur la science, les arts, l'histoire, l'aide aux plus démunis. Vous êtes créatrice / créateur ? Contactez-nous;252;12;9;1;274
TomWirion;Tom Wirion;;52;85;27;110;274
slourski;slourski;;156;35;2;80;273
SaicaGroup_fr;Saica Groupe;Le Groupe Saica offre des solutions durables pour la fabrication de papier et d'emballages, ainsi que pour la gestion et la valorisation des déchets.;220;13;32;7;272
priso_jack;Jack Priso Moutome;;103;143;7;19;272
JonathanBofukia;Jonathan Bofukia;Licencié en Économie Publique, Cadre au Fonds de Promotion de L'éducation et de la Formation.  Analyste politique et Président National du CONGO POUR TOUS (CPT);40;169;56;6;271
CDGMATClamart92;CDGMAT;;40;38;20;172;270
JulienGiovacch1;Julien Giovacchini;Chef d'EPLE;79;82;27;82;270
asmesropian;Anthony;Élève ingénieur fonctionnaire en génie urbain. Je m’intéresse à l’architecture, aux villes intelligentes et à la résilience des territoires.;57;31;8;173;269
ycFreddy;Freddy.C ðŸ˜˜;;248;17;0;4;269
WeerachaiJaila1;Weerachai Jailangka;;96;59;3;111;269
bruno_gabard;GABARD Bruno;le jour où la recharge électrique prend 5mn afin de parcourir 500 km à 130 je quitte les thermiques…;139;7;3;119;268
AssahoreDibo;Rehoboth;Change Management.;197;13;3;54;267
PERRINCamille11;Camille PERRIN;DSC Adjoint CFE-CGC Framatome (Chargé de communication)  - Coordinateur Qualité Framatome  Le Creusot;123;14;54;75;266
DominicRgnier;Régnier Dominique;;3;245;4;13;265
DonoFabrice;fabrice Dono;;77;167;20;1;265
energiemines;Magazine Energie;Magazine mensuel, traite l'énergie, les énergies renouvelables, les mines, la pollution,environnement ,  développement durable, eau, assainissement;198;21;45;1;265
NellyJanierDubr;nelly janier dubry;"Conseillère Régionale Hauts-de-France
Vice présidente de la commission agriculture agro-alimentaire 
Membre de la commission environnement";33;141;64;26;264
Chtirlipimpon;lolo lolo;;58;69;2;134;263
Cohesion_inter;Cohésion international;Notre monde est immense : immenses sont les richesses contenues dans les cieux, sur terre, dans nos cultures et dans notre patrimoine génétique.;88;166;4;4;262
Hormeyfinance;HORMEY;Finance durable, ISR, ESG, Placements verts;173;72;13;4;262
GacemLatifa;Latifa Gacem;Pour moi rien n'est grave tout va bien je vais bien;251;9;0;0;260
generaliavr;DELAMARE Nicolas;;258;1;0;0;259
ArgoAvocats;ARGO société d'avocats;#argo #argo-avocats #argoavocats #droitsocial #droitdutravail #prudhommes #contentieux #DRH #RH #social #newsRH;255;3;1;0;259
Lazzari_Bertran;Lazzari Bertrand;Personnel de direction, #IsidorePelage;30;102;66;61;259
PALMAROSAFEST;PALMAROSA FESTIVAL;✨ PALMAROSA - LIVE, ARTS & EXPERIENCES FESTIVAL ✨ 20.08.2023;93;89;49;28;259
DjiSanya;DJI NI SANYA;Dji Ni Sanya est un programme d’accélération visant à renforcer une dizaine de PMEs dans le secteur Eau et Assainissement.;222;18;7;11;258
chcordtmoller;Cordt-Moller Christian;;69;24;4;159;256
AntoineTHB;Tonyo;;50;94;20;92;256
e_wangana;Erick Wangana;;27;182;14;33;256
Diag26Valence;Diag 26 - Frederic Ferez;Diag 26 réalise depuis 2008 l'ensemble de vos diagnostics vente et location.;254;1;0;0;255
Allamin12152673;Allamine Mahamat;;106;95;15;39;255
CDER_dz;Centre de Développement des Énergies Renouvelables;CDER, a national research center, conducting research programs for renewable energy and energy efficiency development.;41;131;38;44;254
FS09956374;F S;;239;4;0;10;253
Rechargeplusfr;Recharge +;Location et réservation de points de recharge au sein de notre communauté d'utilisateurs de véhicules électriques ! 🚗 Partagez, Réservez, Rechargez !⚡️ 🔌;160;38;39;15;252
MajoriteEMM;Majorité Eurométropole de Metz;Page officielle du Groupe de la Majorité de l'Eurométropole de Metz #MajoriteEMM;54;151;24;23;252
Fediemedia;Fedie, L’autre voie(x) de la transition;FEDIE, édité par Réduisons le Co2 Communications - Edition Bimestriel #bois #solaire #gaz #fioul #carat #nucleaire #info #renouvelable;24;161;58;7;250
DayanetExperts;Dayan et Experts associés;Dayan & Experts Associés est un cabinet comptable qui exerce dans le Var depuis 1976.;249;0;0;0;249
stevensazima;Stevens Azima, PhD;Agric. Economistð¾Local Food Scholarð¥¦Proud HT Dadð­ð¹ Soc. Justice Allyâï¸Tweeting in: en, ht, fr, esðTopics: #AgriLife, #FoodSystems, #WomenInAg, #EcoEconð³;85;74;53;37;249
VFMaubeuge;VousFinancer Maubeuge;"Faites confiance à #Vousfinancer pour vous trouver une solution de financement sur mesure et vous aider à concrétiser tous vos projets 
#Maubeuge #creditimmo";249;0;0;0;249
bhnconseil;BHN Conseil Invest;BHN CONSEIL INVEST est un cabinet de conseil en investissement immobilier et financier qui valorise la proximité avec ses clients.;239;0;6;2;247
CamilleLouit;Camille Louit;Bonjour ! je suis conseillère en #immobilier sur #latresne et #bordeauxrivedroite #safti #camillelouitimmo;197;23;18;8;246
JLeclesve;Julien LECLESVE;"Ingénieur Exploitation en centrale nucléaire 1300MW

Mon dada, c'est l'énergie dont le nucléaire,
mais aussi technophile ! 🙂";41;36;36;133;246
BricioFty450;Bricio FTY DRC;;65;169;4;7;245
LamineGuey1;Lamine Guey;"Entrepreneur et chef d'entreprise
interprète en langue chinoise
Président du mouvement XAAL YOON";73;61;22;89;245
fidaltys;FIDALTYS;;243;1;0;0;244
abdulayfaye;abdoulaye faye;"Écrivain
Environnementaliste, spécialiste en éducation à l'environnement, au développement durable et à l'ecocitoyennete.
Acteur politique , culturel et sportif";117;46;57;21;241
MrBillyJM;Joseph Maxime Bilivogui;Entrepreneur, Investisseur, CEO d’EVEREST WOLVES GROUP S.A et Conseillé principal sur les secteurs dynamiques liés aux managements.;37;47;120;37;241
Crounchy1;Crounchy;;133;39;1;65;238
SENATOR_R_C_A;Ceresoli Abraham;"Jeune Auteur visionnaire de la Révolution Industrielle des États Africains et du 
Rassemblement de la Communauté Africaine (R.C.A)";141;11;2;84;238
Immoprieure;Immobilière du Prieuré;;235;1;1;0;237
ketchoum_f;Florian Ketchoum;Bon entendeur;108;64;23;41;236
WOS_RDC;Women of shift;"Former, encourager et accompagner les femmes à être actrices du changement positif et du développement durable en RDC.
Foi&Impact/Existe depuis 2020";39;64;18;115;236
LmtFlorian;Lmnt Flrn;"Un jour, je suis né. 
Depuis j'improvise.";138;65;8;25;236
LaFTPA;La French Tech Pyrénées Adour;Fédère les #startups des filières du territoire Pyrénées Adour;60;37;113;25;235
Ereinventons;Ensemble Réinventons;"PAN C Ensemble, Réinventons !🌹
Le courant idéologique des @Lesjeunessoc
Fb ➡️ @EnsembleReinventons
Twitter ➡️ @EReinventons
Instagram ➡️ @EnsembleReinventons";58;30;111;35;234
techstars_mtlFR;Techstars Montréal AI;"Programme d'accélération pour startups en IA basé à Montréal. 

English version : @TechstarsMTL
Alumni : airtable.com/shruNjioE4zIQsE…";58;59;81;36;234
IngeSobre;IngéSobre;"Pas encore diplômé, mais déjà sobre
Un petit bot qui essaie de faire bouger les choses";181;10;40;2;233
alpazur_audit;Cabinet Alp'Azur Audit;;231;1;1;0;233
don_kalambo;Don de Dieu Kalambo;;1;204;17;10;232
rahisdioum;DIOUMESSY MOUSSA;DG EVANTUS-GUINÉE Agrégateur de solutions innovantes aux secteurs productifs  (Public ou Privé) à valeur ajoutée.;50;122;56;3;231
VoyagerYYC;Aéroport international de Calgary YYC;"Compte officiel de l'aéroport international de Calgary YYC
Compte surveillé de 8 h à 17h
Courriel : infocentre@yyc.com  |  Tél. : 403 735 1234 
English: @FlyYYC";122;65;15;29;231
d_rahely;Dora Rahely Lucette;Try always to not lose my spirit đâ€;7;161;16;47;231
IHEDN_AR17_PDL;AR17 IHEDN PAYS DE LA LOIRE;Compte officiel de l'Association des Auditrices et Auditeurs IHEDN des Pays de la Loire (AR17);112;63;20;35;230
GrolandJouve;Groland Jouve;;130;41;17;42;230
F_Fauchere;Frédéric Fauchère;"Mobile eXperience B2B Division Director
#Samsung #SamsungElectronicsFrance #SamsungMobileExperience #SamsungMXB2B
#GlobalMobileSolutions #Digitalization";49;137;15;27;228
CornelisNlandu;Cornelis Nlandu;;172;16;4;35;227
bigre_5;Mass Medias;Je ne suis pas souvent de mon avis;113;79;1;34;227
nonaccessible_h;Non Accessible;"Handis psy et physiques qui répertorient des exemples de non-accessibilité et non-inclusivité
-
envoyez vos témoignages en DM!";104;29;74;19;226
AutrementBocage;Le Bocage Autrement;Collectif dédié au projet de Bocage Habité de Toulouse Métropole. L'urbanisation, oui, mais avec le respect de l'écosystème existant.;103;21;67;35;226
KhalilAziko;khalil AZIKO;"Ingénieur d'Etat Arts et Métiers polyvalent
Étudiant en Master 2: Ingénierie structurale - Ecole des Ponts ParisTech (ENPC)";3;144;26;52;225
madreamer74;⭐️ EnpetS ⭐️;Simple Twittos parmis d’autres. Ouvert à toute discussion dans le respect de l’autre;110;93;1;20;224
Bouticourt_Gen;Damien Bouticourt;;154;37;11;22;224
Fulkymco;Antonio;;111;30;9;73;223
EcolieuT;écolieu Art-Terre;"Tiers-lieu écologique et autonome proposant accueil et activités en lien avec la nature et les arts🍀🎨🎸
art.terre.ecolieu@gmail.com
+33 628 06 07 56";158;30;15;19;222
TSE_fr;TSE;Expert en développement #photovoltaïque et #agrivoltaïque, TSE est le leader indépendant de la production d’énergie #solaire en France ☀️🌾;17;154;26;24;221
MaisonCommune_;Club Maison Commune;#Ecologie - #Social - #Démocratie;12;18;188;1;219
AosaOrnella;Ornella Aosa;Je suis de la génération égalité. L'heure est venue-nos droits, notre avenir. La première Jeune de Kasa-vubu;17;118;52;30;217
leonie45i;Léonie;;50;164;3;0;217
AlbinLimousy;Limousy Albin;;111;1;1;104;217
Kevin_PretImmo;Kevin - Courtier - Prêt Immo;Courtier en prêt immobilier;211;1;4;0;216
PGielens;Pierre Gielens;;121;33;1;59;214
AFATEK3;AFATEK;Expert de la réfrigération, climatisation et gestion d'énergie et conseil dans la conception, l'installation et la maintenance d'équipements frigorifiques;99;90;22;3;214
AllianzStauthHa;Allianz Stauth Haguenau;;211;1;1;0;213
CgtFnee;FNEE CGT;;24;123;9;57;213
NivekCoffee;NiVeK Coffee;;7;166;5;34;212
dpe_muyinga;DPE Muyinga;;65;98;30;17;210
alain_doche;Alain Doche;;195;3;0;11;209
Clg_P_Langevin;Collège Paul Langevin;"♻️E3D niveau 3♻️
SEGPA/ULIS/IME #InclusionScolaire";99;37;55;18;209
asso_soutenable;Soutenable;"đAssociation d'intĂ©rĂȘt gĂ©nĂ©ral qui porte le dĂ©veloppement durable dans le dĂ©bat public en Afrique.

#ODD #SDG #Afrique #Africa";163;7;31;7;208
vabe95;Valentin Bernard;;87;93;1;27;208
c_inoui;Monsieur Chez In⭕️uï⭐️🚂📱👨🏽‍💻;Je suis commerciale, chargé de l’expérience Inouï #SNCF. Accompagne au🧳,à la mobilité🏃🏽‍♂️,aux loisirs🎡 à Gde vitesse🚄.Spécialiste📲 #inouiStLazare🧑🏽‍💻;106;50;14;37;207
Amibe_musquee;Amibe Musquée;Dessins d'actu, vulgarisation, politique, tranche de vie, autonomie.;89;20;1;96;206
dussault_sonia;Sonia Dussault;;70;64;2;70;206
contribuer_cree;Laetitia Mariot;;50;133;12;10;205
aga_o_bourdon;Olivier BOURDON SWISSLIFE;;204;1;0;0;205
DjaraNdjaye;Djara ndjaye🇸🇳🇸🇳;étudiante en Enr☀️ | communications | voix-off🎙️|au service de la nation;52;21;20;109;202
ecologickid;Eco Logic Kid đ±;"đ± Marque innovante eco-responsable 

đ«đ¶âđđđđđđđ  đđ đđđđđ, đđđÌđđ đąđ đđŁđđđđ đđđđđđđąđ đ";62;55;3;82;202
LongjumeauMma;Agence Longjumeau MMA;Professionnel de l'assurance depuis 30 ans - L'agence LONGJUMEAU se spécialise dans l'accompagnement, le développement et le conseil des entreprises.;200;1;1;0;202
ZoubereV;ZOUBERE Virginie;Communicante, dynamique et passionnée d'actions humanitaires;28;36;21;116;201
EppeHenry36439;Henry EPPE;;148;42;1;7;198
Gan_Langres;Agence GAN Assurances Langres;;197;1;0;0;198
EdDormoy;Edouard Dormoy - Conseil en Gestion de Patrimoine;"Gestion du Patrimoine de la Famille: Conseil en Construction, Gestion & Optimisation de Patrimoine 
Accompagnement Entrepreneurial
Cabinet Patriméo";116;62;16;1;195
Euporos_SA;Euporos SA;"Achat, vente & stockage de métaux précieux en Suisse depuis 2010 🇨🇭
euporos.ch 🥇";100;8;61;26;195
bnandi225;Ismael Cisse;Ivoirien @rhdp;56;66;7;66;195
SL_Rouillon;SwissLife Rouillon - Karine MORY;Assurance vie, épargne retraite, complémentaire santé, prévoyance, assurance de prêt immobilier et assurances professionnelles.;175;17;0;1;193
jl_milliat;MMA Orange Agence Milliat;L'expertise en assurances depuis 1988 !;186;2;0;3;191
EcsNath;Nath Eches;;78;19;9;85;191
ZeinabouSidib3;Zeinabou Sidibé;"Née le 04/08/1966 à Niamey, poursuivi les études primaires et secondaires à Agadez, études professionnelles à Niamey ; Mariée, 5 enfants. Diplômée de l'ENA.";17;150;15;8;190
mrichard79;Mickael RICHARD;"Professeur de physique appliquée - physique-chimie - RUPN -
LGT Ernest Pérochon Parthenay";30;85;5;70;190
DeepTalents;DeepTalents;Cabinet de #conseil en #formation - Explorer en profondeur les besoins en innovation des industriels au travers d’une expérience d’apprentissage unique.;185;1;3;0;189
EwoSmart;EwoSmart;"đźŚ± Durablement intelligent
đź’§Solutions connectĂ©es pour prĂ©server les ressources 
â™»ď¸Ź Faire un geste pour la planĂ¨te
đź“ŤAlsace";71;51;27;39;188
PhdConseils;PhD Conseils;Courtier Assurances de Personnes Epargne financière SOFRACO. Coach financier FILIB. Formateur professionnel.;186;1;0;0;187
Eurogrouptrade;Eurogroup Trading Network LTD;"Commodity trading business group Import-export of business in different countries
Partnership and joint ventures Open to branch out into new business.";8;172;7;0;187
gan_arriat;Gan Assurances - Sylvie Arriat - Auxerre;Deux principes : Disponibilité et Réactivité. A votre écoute, nous trouverons ensemble la solution la mieux adaptée à vos besoins. A l'impossible nul n'est tenu;187;0;0;0;187
groupemilaimmo;Groupe Mila Immobilier;Le Groupe MILA IMMOBILIER, une présence incontournable en Côtes d'Armor, pour être bien guidé dans votre recherche Immobilière;178;8;0;0;186
FerryEaubonne;Collège Jules Ferry Eaubonne;;43;31;37;74;185
TVanoffe;Thierry Vanoffe;;179;1;4;1;185
NatyB10491037;Naty B;;45;20;6;114;185
NP32527913;N P;;14;16;0;154;184
BinoistM;Desaëns Immobilier;;183;1;0;0;184
sesametg;Sésame SÉSAME;Incubateur et accélérateur de projets féminins.                                           «Ouvrir le Champ des Possibles»;82;31;54;15;182
Eleana_bl;Ana;;99;49;2;32;182
Ecologistes_Bzh;Écologistes au Conseil Régional de Bretagne;actualités des élu.e.s Écologistes au Conseil Régional de Bretagne : Goulven Oillic, Ronan Pichon, Christine Prigent;61;97;22;2;182
lolineloline11;loline loline;;175;4;1;1;181
Isa13581214;Isa;;53;49;3;74;179
yalitogofficiel;YALI TOGO;Le YALI est un programme des USA visant à développer le Leadership des Jeunes Africains.;115;8;47;9;179
PhilippeArnou16;Philippe Arnould;ancien dirigeant;102;57;8;12;179
MichelOman51144;Michel Omanyondo;Juriste et chercher en droit des affaires. conférencier et maître de cérémonie.;18;146;6;8;178
KossiAfannou1;Kossi Afannou;;56;116;2;3;177
UnivaoBouake;Université Alassane Ouattara;Suivez l'actualité de l'une des universités publiques la plus prestigieuse de Côte d'Ivoire;112;0;65;0;177
CabinetCouget;Cabinet Couget Finances;;175;1;0;0;176
InnoveMaroc;Maroc Innove;"Actualité marocaine en matière d'innovation: industrie, énergie renouvelable, IA, Tech
Moroccan innovation news: industry, renewable energy, AI, tech";29;132;12;1;174
UnRandomDuNet_;UnRandom đ;Un random avec un avis probablement diffĂ©rents du votre;107;57;0;9;173
auguste27503544;Auguste Zaongo;Ingénieur #Électronique et #Automatismes #Industriels;25;97;42;8;172
ArgentThelem;Thélem assurances Argent / Aubigny;Thélem assurances d'Argent-sur-Sauldre et Aubigny-sur-Nère, ouvertes du mardi au vendredi de 9h à 12h et de 13h30 à 18h, et le samedi de 9h à 12h.;170;1;1;0;172
Cassandra_ISCPA;Cassandra Madureira;Étudiante en Bachelor Journalisme à l’@iscpalyon / Journaliste chez Veridik;64;24;14;69;171
OfficielNordin;Nordin Pro officiel;"Nous sommes un service médiatique en ligne. Basé dans le Haut-Katanga Rdc.
L'ère est au numérique.";64;44;18;44;170
AjaddTogo;AJADD-TOGO;Nous sommes une association pour aider les populations défavorisées et promouvoir le Développement du Tourisme, Agriculture et l'environnement.;67;29;4;68;168
AgenceTrocadero;Agence Immobilière Trocadéro;L'agence Immobilière Trocadéro vous accompagne dans tous vos projets immobiliers.;167;1;0;0;168
CPFP_ASAFIN;CPFP-ASAFIN;"Bienvenue sur la page officielle de ASAFIN.
Le professionnalisme au service du social.
Suivez-nous sur Facebook, Instagram, LinkedIn et YouTube.";50;67;25;25;167
leroutierlauren;laurent leroutier;;95;46;1;25;167
delussygabriel;Gabriel de Lussy;;83;59;3;22;167
ngdoc1;ng doc;"Documentaliste passionnée de chant et membre d'une chorale ; je tweete documentation et veille";153;11;2;0;166
CabinetExium;CABINET EXIUM BEAUMONT;Cabinet d'Expertise Comptable;135;26;3;0;164
GG44801369;Gilles Gallon;;29;102;3;28;162
MAYERJeanLoui10;MAYER Jean Louis;;96;48;10;8;162
JeanPieDupont;Jean-Pierre Dupont;"Innovez et inspirez avec notre expertise en marketing!"" (Innovate and inspire with our marketing expertise!";10;101;16;35;162
GanArbois;Gan Assurances Arbois;;161;1;0;0;162
ousseny_kabore;KABORE Ousseny Avive Citizen;"I am an Avive Citizen
nitter.net/Avive_World";17;126;1;17;161
AlyaSYL59557144;Alya SYLLA;Assistant du DRH de MATD en Guinée.;15;122;7;17;161
cnjkayanza;CNJB/ KAYANZA;"Conseil National de la Jeunesse du Burundi/ Province KAYANZA~

Burundi National Youth Council/Kayanza province chapter";29;73;12;45;159
DeremeAvocat;Cabinet Derême Avocat;;119;39;1;0;159
OdiKopi1;Odi Kopi;President de la faculté de droit UPC⚖️, président de commission du civisme du LCMM.;13;54;40;50;157
LeGFORMATION;LeGuideDeLaFormation;Passionné par le développement personnel et professionnel | Partageant des conseils et des ressources pour vous aider à naviguer dans le monde de la formation |;127;4;8;18;157
clgterreville;Collège Terreville;;63;28;36;28;155
SIBchabanne;Katarina Nyberg (Hennichs);The International British Section Pontoise - Section Internationale Britannique - Collège Jean-Claude Chabanne;26;31;24;72;153
ngaruyinka7;Me NGARUYINKA Jean Claude;"I love Jesus Christ because he first loved me. I'm a Preacher of his Word, Gospel singer, Professional Court Bailiff, studied Public International Law 
Thanks";82;32;13;26;153
DurableParlons;Parlons Développement Durable;Une équipe au service du Développement Durable;35;54;41;22;152
Kakoujean89Jean;Jean kakou;;122;19;5;5;151
Moyim1Christian;Christian Moyimula;;4;127;16;4;151
GroupeBspl;bspl groupe;;150;1;0;0;151
Taaralorg;Taaral;Alliance Multi-Acteurs pour le Développement de l'Economie Circulaire du Plastique;119;5;21;5;150
VilledeNoyon;Ville de Noyon;Compte officiel de la Ville de Noyon. Ville d'art et d'histoire et cité de #Calvin #villedurable #patrimoine #oise #noyon;82;45;22;1;150
luc_kandolo;Luc'son Kandolo;Mon courage;26;89;21;12;148
DegdegHicham;DEGDEG Hicham;"Founder and CEO of DGSoftware

Phd student in university of Abou Baker Bel-kaid, Tlemcen,Algeria";20;98;8;22;148
Discove221;Discover;"Plateforme d'information sur l'environnement - le développement durable - le football 
Au Sénégal et dans le monde 
 #environnement #education";30;55;26;36;147
AllianceNetZero;Alliance nouvelles voies;"Les six plus grandes entreprises de sables bitumineux sur la voie de la carboneutralité.

CanadianNatural
Cenovus
ConocoPhilips
ImperialOil
MEGEnergyCorp
Suncor";84;13;36;14;147
AgnesGendre;Agnès Gendre;@CHToulonLaSeyne #comitéDD;45;27;12;62;146
forhealthiersen;FOHSEN;Foundation for a Healthier Senegal (FOHSEN) is a nonprofit organization committed to improving health outcomes for rural Senegalese communities.;66;10;33;36;145
ToureSitan1;Toure Sitan;Chaînes françaises Chaînes internationales Journalistes politiques Journalistes politiques Politique Pop Rap Séries & fictions Télévision Téléréalité Presse TV;3;136;6;0;145
Eavt_en_lutte;EAVT en lutte;Compte de l'ENSA Paris-Est, anciennement Marne-La-Vallée, dans le cadre du mouvement ENSA en lutte.;48;55;20;22;145
_CapSurLAvenir_;Cap Sur l’Avenir;Définir ensemble l’aviation de demain. Un projet piloté par l' @AeroclubFrance;81;7;38;18;144
Deepo103;Deepo103;;67;16;3;58;144
Thor25167441;LeViking;;71;23;1;48;143
kasindi_mac;Mac Roland Kasindi;Ir Electromecanicien;62;56;10;15;143
abid_inzira;ABID-INZIRA;Association Burundaise pour l'Interculturalité et le Développement durable, inclusif et innovatif, ABID-INZIRA;14;115;2;12;143
ChercheursEnH;Chercheurs en herbe;Association de médiation scientifique et environnementale varoise créée en 2018.;35;45;18;44;142
SangSens;BonSangDeBonSens;;80;26;3;33;142
Kales_7684;Voiment Alexandre;;15;110;17;0;142
PatrickMakayi10;Patrick Makayi;;2;136;2;2;142
ONG_FLISADD;Femmes Leaders;Être une référence des femmes actrices de développement, au cœur des interventions en tant que agent de changement.;6;116;16;3;141
fojemorg;Fojem;Fojem - Non Profit;101;25;5;10;141
geejgi_aqua;Géej gi;GEEJGi.COM est la 1ère solution d'e-commerce conçue pour l'aquaculture au Sénégal.;26;37;37;41;141
esihprize;Hult Prize ESIH;"Organisation Ă  but non lucratif
Leading a generation to change the world đźŚŽ
1m$ đź’µ us to Global Startup Prize";57;13;9;59;138
MandiToure666;Mandi Toure;;26;76;8;27;137
AngeFrade;fradé ange;"ognonu divende a so chiesa.
u chie micca perche u beri micca che none existe.
et voila !";53;56;21;7;137
rachid_saidj;RACHID SAIDJ;;130;6;0;1;137
FondationOpenC;Fondation OPEN-C;Le plus grand centre d'essais en mer européen dédié à l'éolien flottant et aux Énergies Marines Renouvelables (EMR);27;26;66;18;137
Turlututu_Dbile;Turlututu;Nosce te ipsum.  But can anyone really know oneself? Not a bot, but for the rest, mystery and enigma.;118;9;0;10;137
GC974;Grégory C;Tout homme porte en soit la forme entière de l'humaine condition.;55;42;1;39;137
halima_e14;So B;;15;6;0;115;136
RobertiFloriano;Floriano Roberti;Étudiant en journalisme ISCPA;12;112;1;10;135
BoisGreenlife;Alain BELS;Créateur et Concepteur nouvelles marques;17;31;8;79;135
gldssoussou;Gildas soussou;Mathematicien | webmaster |Infographiste| Relationship manager @aiesec_lome | Membre @jci_ul |Technicien en froid climatisation | Gmail:gldssoussou@gmail.com;14;88;13;19;134
SGazaouis23;Samir Gazaoui;;44;41;2;45;132
stephfiset75;Stephane Fiset;Chill;10;86;7;28;131
changeons_d;Changeons d'Avenir;Changeons d'Avenir est une association citoyenne qui défend l'écologie et la solidarité dans la ville d'Arles.;21;86;23;1;131
NAubourdy;Nicole Aubourdy;;128;0;1;1;130
enfants2022;Majorit'ère;Faisant suite à Enfants2022, Majorit'ere est une plateforme citoyenne, permettant aux moins de 18 ans de voter aux élections de façon consultative.;25;60;15;29;129
Manonemargerie;Manône;Una mujer francesa con alma y raíces mediteranas Instagram : @alatabledemanon 🍋🫒🍇;26;82;9;11;128
XmpEntrepreneur;XMP Entrepreneur;Nous  accompagnons depuis plus de 25 ans les anciens élèves de Grandes Ecoles dans leur démarche de création, de reprise ou de développement d'une entreprise.;102;8;13;5;128
QUINETTELaetit1;QUINETTE Laetitia;;17;27;2;82;128
BALDEMa87419526;BALDE Mamadou Saliou;Je suis BMS Ingénieur Agronome et je vis en Guinée Conakry.;18;93;16;1;128
logically_sarl;Logically SARL;Distribution du matériel informatique et bureautique;81;4;2;41;128
koffi_djagni;koffi gawonou Amegnona Djagni;"Ing. Génie mécanique
Spécialiste en énergie et développement durable. #Industrie, #Agroindustrie, #Agropoles, #tg";7;93;2;25;127
marcelinoooFr;Marcel, CAIA;trying to better understand alternative investments;46;60;2;18;126
bsc_greg;Greg BSC;;62;39;1;24;126
alaincomte;Alain COMTE;Passionné de politique et bientôt à la retraite 😊. Futur candidat à la présidence de la république 2027 😳 et auteur des vidéos politique d’Alain Bibi.;48;12;3;63;126
Da553_Seb;Da-553_74;;39;41;2;43;125
BValzrezoximo;Bernard VALZ;;117;7;1;0;125
PaulGhisla51862;Paul Ghislain Biyaga;chaudronnier chalumiste tuyauteurs soudeur;6;113;4;1;124
IsteMatadi;ISTE/ MATADI;;80;35;7;1;123
brouhaha224;Brouhaha;#brouhaha est un état d'esprit, une porte d'entrée qui nous permet de réaliser nos rêves et d'atteindre nos objectifs par la force et l'aide commune.;45;11;6;60;122
IMDEREDAL;Redal Institut des Métiers;;40;13;46;23;122
KemitFoundation;Kemit Foundation;"We holistically create active emulation around the legacy of Pan-Africanism with a view to producing sustainable solutions for Africa.

|Mindsets|Values|Action";85;0;35;2;122
DLecadet_IAD;David LECADET;"Conseiller immobilier indépendant
IAD France";116;1;0;4;121
CrowdFund_Token;Crowdfund token;Le véritable frein au développement des entrepreneurs des pays en développement c'est la quasi-impossibilité d'accès au financement.;32;23;34;31;120
ro2consult;RODES;;53;44;7;15;119
DorelBoucher;Précieux Dorel MAMBEKE BOUCHER;BOPESA NGAÏ TEMPS !;19;76;17;7;119
LTAdrc;Life Through Arts - LTA DRC;Empowering lives and Creating an impact through Sustainable Arts,Technology,Tourism, Education, & environment.;13;40;19;46;118
IssamTebaa;issam tebaa;environmental project manager/young environmental activist/carbon footprint researcher;7;79;21;11;118
CEGConseil;Nicolas Frey;Société d'expertise comptable;115;2;0;0;117
AssoMasterAP;AMAP;Association du Master d'Affaires publiques de l'Institut catholique de Paris - amapicp.contact@gmail.com -;39;32;40;5;116
AlbertoNsadisa;Alberto Nsadisa;Ma personnalité;13;95;1;6;115
mbayehadj1;MBAYE HADJ;Auteur;74;18;4;18;114
acayed61;Anne-Christine Ayed;Experienced international leader with solid acumen in Strategic Innovation and Sustainability. Circular economy advocate and practitioner.;37;31;32;14;114
EqlFormations;EQL Ecole de la Qualité Logicielle;Formations professionnelles, reconversion et spécialisation vers les métiers du numérique et de l'informatique.;63;20;26;4;113
Agence_flamel;Agence Flamel;Les Alchimistes de l'Immobilier;110;1;2;0;113
ConquerisCsl;Conqueris;Cabinet de conseils multiservices en gestion. Nous vous accompagnons assurément vers le succès ! Contact : conquerisconseil@gmail.com;31;14;17;50;112
Empruntis_;Empruntis Rueil-Malmaison;Empruntis l'agence (Rueil-Malmaison);109;2;1;0;112
Belko_Africracy;Belko Abdoul Aziz Diallo;;20;80;6;6;112
tout_google;Tout Sur Google;;105;1;5;0;111
Univ_Assur;Univ'Assur;Nous recherchons constamment sur le marché les meilleurs garanties au prix le plus avantageux !;111;0;0;0;111
amdp_douai;Masters de Droit Public Douai;Association des Masters de Droit Public de Douai ⚖️ - pour nous rejoindre ⬇️;57;25;19;9;110
jeunessedugabon;Abessolo Remy Johann;I am a Statesman.;61;2;1;45;109
Frank16Richard;FRANK Richard;;105;4;0;0;109
etincellealigre;L'étincelle dans la ville;Une ballade dans la ville, chaque semaine sur Aligre Fm 93.1, le DAB et sur internet, le lundi à 9h,le jeudi a 20h. letincelledanslaville@gmail.com;35;27;7;39;108
viandecomutc;Communication Autour de l’Industrie de la Viande;Un projet réalisé à l'UTC par Prouvez Juliette, Khalqi Myriam, Jochim Louis et Ndjiki Nya Cydérine dans le cadre de l'UV SI22 dirigée par Delphine Chedaleux;93;6;3;6;108
ClairGrandLoin;Plus clair, plus grand, plus loin;;30;69;7;1;107
leroutier26100;Dina l’amie du pain;Gérant de la boulangerie Dina l'amie du pain;96;3;2;6;107
NaP_ONG;Nature Plurielle;;20;66;19;2;107
CJEG_Burundi;CJEG Burundi;La Coopérative des Jeunes Entrepreneurs de Gatumba, CJEG en sigle fait la promotion de la sécurité alimentaire via la Myciculture           Tél+25768218014;16;6;51;33;106
cp4474;cp44;;75;5;0;26;106
plateforme_rain;RAIN innovation;"Réseau pour l'Agriculture et l'Innovation de Nouvelle-Aquitaine
#agriculture #innovation #transitionagroécologique #numerique";25;70;9;1;105
AgroChimie;Bayer BASF Corteva Syngenta;"Regroupement des acteurs internationaux du secteur agrochimique.
L'humanité vaincra la nature par la technologie !
Une fiction souvent dépassée par la réalité.";24;59;16;6;105
LexClimatNON;LoiClimatNon;Citoyens suisses contre la loi sur le climat (LCI). Le 18 juin, le Peuple doit dire NON au désastre énergétique programmé!;87;15;2;1;105
Tour_Insee_IN_C;TOUR INSEE - Association IN-C Malakoff;L'association IN C' #Malakoff est contre la démolition de la #TourINSEE en faveur de sa restructuration. linkedin.com/company/tour-in…;8;70;10;16;104
jadorecemonde;Cerveaux en berne;# Ne prenez jamais les gens pour des cons, mais n'oubliez pas qu'ils le sont# entendu en école de communication. Et si on leur montrait qu'on a un cerveau ?;40;26;1;37;104
MwindwaJeremie;MWINDWA JEREMIE;;11;83;4;5;103
Vitopirate;Doc;;43;12;10;38;103
Ropers58024627;Ropers;Créons une communauté;86;16;0;0;102
_carlorama;Charles;đ¶;59;18;5;20;102
apccongo;Alliance Progressiste pour le Changement (A.P.C).;Alliance Progressiste pour le Changement - Réformiste (A.P.C-R) - Mouvement politique du centre au Congo.;25;50;4;23;102
ONGEDENSENEGAL;ONG EDEN SÉNÉGAL;Organisation Éducation et Développement de l’Enfant à but non lucratif;16;17;7;62;102
margot_afneus;Aubry Margot;Chargé de mission Transition Écologique à AFNEUS 2022-2023;8;53;17;23;101
SPISSENEGAL;SPIS;Le Syndicat Profession des Industries du Sénégal est un regroupement d’industriels sénégalais mettant en exergue la qualité du « Made in Sénégal »;54;13;28;6;101
IMMOMAD55210;Isabelle DUMOUTIER;;100;1;0;0;101
maria_ouat;MARIAM OUATTARA;#Blogueuse #ActivisteSocial  engagée dans la lutte contre les #VBG #TisseuseDePaix #Artisanat #Arts #Nature;8;44;19;29;100
bentelamira;Bent Amira;;30;7;1;61;99
Amelie__Robert;ROBERT Amélie;PhD in Geography, Professor (Associate) at Université de Picardie Jules Verne, UMR EDYSAN;31;21;5;42;99
SolalGroup;Solal;Solal allie Agences spécialisées dans la #communication, l’#événementiel et les #médias et un Startup Studio qui développe from scratch des projets innovants;67;11;18;2;98
AgenceMerignac;Agence Principale Mérignac;;95;1;1;0;97
InitiativP;Initiativ'PGC;Initiative Citoyenne pour la Prévention et la Gestion des Crises et Conflits. Contribuer aux efforts de Paix, de Réconciliation et de Cohésion Nationale.;18;63;2;13;96
arnaud53;Arnaud Bodin;"Journaliste / Conseiller en gestion de patrimoine engagé en faveur de la transition écologique / Auteur du livre ""Les meilleurs placements verts et solidaires """;38;22;24;12;96
Ignaszewski_O;odile Ignaszewski;Prof des écoles - Saint Quentin;29;38;13;16;96
SeyeMaya;Maya seye;;15;47;11;21;94
ppeppd2023;PPEPPD 2023;16th International Conference on Properties and Phase Equlibria for Product Process Design 📍La Pineda, Tarragona, Spain #ppeppd2023;57;13;22;2;94
soyakadi;Yabel;;91;2;0;1;94
m_luvua;manzanza luvua;;21;54;7;11;93
Eliswann4;Eli swann;A chaque jour son scandal, même plus le temps d'être complotiste le monde nage dans l'indifférence;72;4;0;15;91
KhedhirMabrouka;Mabrouka Khedhir;;79;10;1;1;91
cimedhi;CIMEDHI EME;;84;6;0;0;90
Pascal15106;Pascal;;12;28;14;36;90
YasmineAxe26;Yasmine Axelle;"juriste en droit international et européen
 Présidente de l 'ONG Benedicta  Cantal
qui  aide les personnes les plus vulnérables et défend les droits humains.";25;41;2;22;90
AurePotard;Potard Aurélien;Gérant / Chef de cuisine à Perpignan, Brasserie La Rotonde instagram.com/aurelien_potar…;37;42;2;9;90
O_Reboul;Olivier Reboul;;41;11;4;33;89
CogeTiffen;TIFFEN COGE;;88;1;0;0;89
environnementtv;Sante-Environnement TV;;36;29;8;15;88
BaSidyElHadji1;Ba Sidy El Hadji;Respectueux Sociable Disponible...;19;19;4;44;86
NAKENTOH;Nakentoh Kenneth;Communications & Knowledge Management;70;9;5;1;85
CabinetJFT;Cabinet Jean-Francois Tisler;đ6 Rue Georges Ditsch;83;1;1;0;85
Regisroumegaire;regis Roumiguier;;56;10;0;18;84
alex1my;Alexis;;37;35;2;9;83
kevCi3;kevCi;;12;61;2;8;83
Horizons_Sedan;Horizons - Sedan;Le Twitter du Comité Municipal Horizons de Sedan. Rejoignez-nous ! @HorizonsLeParti;29;17;33;3;82
Liongrou;Lion Group;Lion Group est un groupe d'entreprises dont Lion #academy, Lion #space et Lion #communication. Laissez-vous inspirer par les Lions đ;30;16;23;12;81
Dieutelalciney;Price;;46;28;1;5;80
OrsonDidier;Didier;Theoretical chemist and physicist in nuclear fuel recycling;69;1;0;9;79
JosephPika1;Joseph Pika;;16;51;1;11;79
invest_faq;investissementfaq;"planifiez votre avenir en investissant sur des stratégies long terme.
Nous définissons ensemble la stratégie la plus efficiente adaptée à votre situation";79;0;0;0;79
LemaClement;Mwanangombe Lema Clément Justin;;7;39;7;26;79
ClgGalileeEvry;CollègeGaliléeEvry;;15;43;16;5;79
KitiMbala1;KITI MBALA john;;57;12;2;7;78
Appolinair90477;Appolinaire NIMUBONA;;12;28;3;34;77
lau2ca;Lau2ca;;26;31;2;17;76
MartineYameogo4;Martine Yameogo;;47;18;4;7;76
Amlanord1D;Amlanord 1D;Zone très dynamique étendue à 14 pays. En constante évolution, l’année 22-23 compte 24 établissements et des équipes dévouées à l’excellence éducative !;12;30;16;18;76
nwalakayanm;Nwalakayanm;Nwalakayanm est une entreprise de transformation de produits agroalimentaires(Noix de cajou en Noix grillée).;28;7;4;36;75
Mur2022;MUR ( MOUVEMENT UNI POUR LE RENOUVEAU );"@MUR đź‘‡
Favoriser l'information, la Sensibilisation et la formation. 
Promouvoir la conscience civique et le leadership des jeunes.";62;2;8;2;74
Carol_Langloy;Carol Langloy;;17;39;17;1;74
Depuce;Depuce;Aime bien piquer de temps en temps.;36;24;5;8;73
FerreiraDimit13;moi;;26;2;1;43;72
was12Diak;was12;;37;24;2;9;72
CedrickMunenwa;Cédrick MUNENWA;;4;34;2;32;72
s_m_earth;Save MyEarth;Militants Pour la planète;9;8;3;51;71
dulcinamour;nakie;"Journaliste, News producer and presenter à SABC News Channel Africa
Producer and presenter #mixvibration";17;47;5;1;70
MscNTIZONYANKA;MSc Ntizonyanka Eric;Master  en Service Social  et Développement Communautaire ,et Titulaire des cours aux xn--universits-j7a.Coach et Consultant.;10;44;2;14;70
Veronique_immo;Veronique Simon;Conseillère en immobilier - Agence Bien(s) Immobilier;67;1;0;0;68
LyceeAppert;Lycée Nicolas Appert;"Lycée des métiers de l'hôtellerie-restauration
Lycée des métiers de l'industrie
Compte officiel";45;5;12;4;66
Fvit94;Fvit;;19;13;4;29;65
Samuel68772804;Samuel;;24;31;5;4;64
LaitPaix;ONG Paix & Lait;L'ONG Paix & Lait oeuvre depuis une vintgtaine d'années pour l'amelioration des conditions de vie des plus vulnerables;20;17;17;10;64
HowenheimS;Howenheim Stenford;;56;2;0;6;64
LaVarloppe2023;JO;Professionnel du domaine de la santé et père de famille soucieux de l’environnement et du cadre social dans lequel nous évoluons.;38;5;0;20;63
cnpslimitedfr;CNPS Fr Limited;Des solutions énergétiques et électroniques innovantes pour développer votre entreprise pétrolière | Pétrole et Gaz;28;9;2;24;63
SupermarchePneu;Supermarché du pneu;Le Supermarché du pneu c’est un garage mais en mieux 🚘 📍Ales 04 66 56 52 54 ou📍Nîmes 04 66 21 77 80, pneus neufs/occasions et prestations mécaniques;43;13;5;1;62
Ing_durable;Institut de l'ingénierie durable;Basé à Polytechnique Montréal, l'Institut de l'ingénierie durable est actif en formation, en recherche et en innovation.;6;31;10;15;62
khon26328;Samuel Khonde;né à Kinshasa le 26 avril;7;45;2;7;61
EmmaRancourt22;Emmanuelle Rancourt;"Chargée de projet experte Énergie et Biomasse chez @NatureQuebec
Coordonnatrice et co-porte-parole de Vision Biomasse Québec";6;44;5;5;60
actu_IA_Monde;Actu_IA_Monde;2 infos par semaine sur l'intelligence artificielle appliquée à l'industrie par 3 étudiants du BUT GMP Lyon 1;34;18;6;2;60
president_ong;Mustapha president ong Aicha Oumifiss Maroc;;23;31;1;3;58
LMoussas;Leon Moussas;"Prêtre Sdb Humanitaire, Spécialiste en Droit et protection de l’enfant 
Coordonnateur du Parlement Junior Africain  pour les  UN Représentation Centrafrique.";9;47;1;1;58
Pascali38892067;Pascaline;Je suis une femme  courageuse et déterminée pour le développement économique de mon pays aider les femmes et les jeunes c'est mon objectif;12;23;1;21;57
GABRIELURENA141;GABRIEL URENA;;48;8;0;0;56
GMPcolos;GMPcolos;La session Veille GMP 2023 est lancée !;27;21;5;3;56
ElisabethFagnan;Elisabeth Fagnan;Passion spaghetti;22;16;1;16;55
AloysKobes;Ecole Aloys Kobes;L'école Aloys Kobès est un établissement scolaire à programme français, partenaire de l'AEFE, de la maternelle (2 ans) jusqu'au collège.;5;39;9;2;55
wearefestivalfr;We Are Festival;"ð Samedi 15 Avril 2023
ðLa CLEF, Saint-Germain-en-Laye
#WAF23 Le festival par les jeunes pour les jeunes";26;10;12;7;55
FlorenceJanin;Florence janin;;6;38;3;7;54
CabinetAfriglob;Afriglob Conseil;Afriglob Conseil est un cabinet de conseil en stratégie basé au #Mali.;38;3;10;2;53
Nicolapeigne;nicolas Peigné;;51;1;0;0;52
jhonjfrtdc;vhbkjbkvfc;;35;0;0;17;52
YvesKabenegele;Yves Kabenegele;;33;4;0;14;51
FeronSabrina;FERON SABRINA;#coachimmobilier #meilleuragent #influenceusedelimmobilier;46;4;1;0;51
FranceMidow;Midow;"Midow est une page d'information et de sensibilisation sur les enjeux environnementaux.

Un THREAD par jour pour sensibiliser aux bonnes pratiques.";35;6;7;1;49
effymatthew;Effy;;19;28;0;2;49
NanoOne_Fr;Matériaux Nano One;Nano One Materials est une entreprise de #TechnoPropres qui change la façon dont le monde fabrique les #MatériauxdeBatteries pour #VE #batteries #StockageRéseau;26;6;12;5;49
MariamBagayogo1;Mariam Bagayogo;Engagée pour la promotion des droits des femmes;6;33;2;8;49
LioSerra_InapaF;Lionel Serra;Commerce de gros de produits en papier;42;6;1;0;49
lamymyk;Marie Lavoie;;3;36;0;8;47
4upNews;4UP NEWS•;•VOUS POUVEZ ÊTRE TOUT CE QUE VOUS VOULEZ ÊTRE , TANT QUE VOUS TRAVAILLEZ DUR POUR Y ARRIVER•💦;14;25;6;1;46
RSE_Souverain;Souveraineté RSE;Exchange and reflection group for a CSR policy extended to the issues of industrial and economic sovereignty. #csr;27;8;10;0;45
edoh_isral1;Edoh Israël;;9;30;1;4;44
emcsenegal;Energy Management Center;Energy Management Center accompagne les entreprises et les ménages pour améliorer leurs performances énergétiques.;15;10;11;7;43
ministere_js_cg;Ministère de la jeunesse et des sports de ECFQE;Ministère de la jeunesse et des sports de l'éducation civique de la formation qualifiante et de l'emploi du Congo Brazzaville 🇨🇬;19;13;3;7;42
LandzeEdgard;Edgard Landze;;34;3;3;2;42
Trillio_off;Trillio le T;Les avis et les faits 📸 instagram.com/trillio_1/?hl=…;7;19;0;15;41
DangerZoneInv;Danger Zone Investments;Gestionnaire d'actifs dans le secteur des paris-sportifs.;19;0;22;0;41
jean_tsonga;Jean Tsonga;;26;10;1;3;40
Wildream34;Wilfrid Reve;;22;4;2;12;40
Oikos_Logos_var;oïkos Logos;structure spécialisée dans le conseil en stratégie d'économie circulaire;6;32;2;0;40
FournierMario5;Fournier Mario;facebook.com/fournier.mario;21;0;18;0;39
IngredientDepot;Ingredient Depot;Shipping chemicals, ingredients and raw materials to the United States and Canada since 2011. With industry-leading customer service and price guarantee.;34;0;5;0;39
pilarskidelphi1;pilarski delphine;;5;5;0;29;39
lalla_sankhare;Lalla Sankhare;;9;14;3;13;39
greenovation_fr;Greenovation;"Passionné d'écologie, je partage les dernières actualités environnementales. 🌍🌱
Je tiens aussi à partager la beauté de notre monde.";14;15;5;4;38
aurore_ir;Aurore Mugisha;I produce ecological bricks for sustainable construction | I am a Structural Engineer and Professor | l am Passionate about Science, Education and Engineering.;13;10;7;7;37
Sylv1joulchaman;Sylvain Rousselot - artiste auteur;;14;3;0;20;37
AmedOue85142653;Amed Ouedraogo;La paix rien que la paix;12;18;0;7;37
MarcanoZinsou;Marcano Zinsou;;3;14;9;11;37
AmadouKerfalla;Amadou kerfalla Camara;;6;11;2;16;35
BonnevayRemy;Remy Bonnevay;;8;16;10;0;34
millesabords88;TassoneAndrea;;32;1;0;1;34
RecapParlement;Recap' Parlementaire;"L'actualité parlementaire résumée dans ta boite mail chaque semaine !
Pour t'abonner à notre newsletter ⤵️";20;9;4;0;33
SocieteTp;RTP;;25;2;0;6;33
quintal_anais;Anaïs Quintal;;23;10;0;0;33
GroupCongo;Congo Investment Group;We provide thriving strategies and help our clients invest in The DR #Congo. Follow us for updates on our projects and investments opportunities #cigroup;13;2;4;13;32
FondationZZZ;Fondation Sommeil;Fondation sommeil dédie ses actions aux personnes qui souffrent de troubles du sommeil, leur entourage et les professionnels intéressés par la santé du sommeil.;19;12;1;0;32
silinergy;Silinergy ☀️;☀️⚡️ Société au service des particuliers et entreprises pour leur projets d'énergie renouvelable ♻️;8;13;3;8;32
VictorS37113446;Victorniño;;26;5;0;1;32
TPMC_Off;TPMC;"Ceci est un projet scolaire :

touchepasamonclimat.fr";1;24;1;5;31
UCAEPC_Comores;Union des Chambres de l'Agriculture, de l'Élevage;Promouvoir l'agriculture, l'élevage et la pêche durables aux Comores. Suivez-nous pour les dernières actualités, les bonnes pratiques et les initiatives visant;8;8;6;9;31
FitiaGHC;Fitia Annya;Talent Acquisition Specialist;15;14;1;1;31
Illana_pstc;Hatteville Illana;"Bachelor chargé de projet événementiel
SUP EVT ALT V";13;10;3;5;31
ADTroisMondes;ATELIER DES TROIS MONDES;;22;5;1;2;30
lemon_will_;William Lemon;wassup twitter;22;7;0;0;29
atifsalem18;@ALGO COSMETICO;Alor Notre société porte sur la spécialisation de la commercialisation des matières premières plus précisément les matières bio et chimiques certifiées qui so;9;2;0;17;28
cojfac;Cojfac;Organisation pour la prévention de l’environnement;13;13;2;0;28
m4thieu_m;Mathieu Martin;adepte de la sociale robotique;24;3;0;0;27
ACE06290;Amanda;;20;2;1;4;27
FlorenceCt9;Florence Côté;;24;1;0;1;26
tasi_tizih;CIVASS.org;;9;11;3;3;26
Ewooks31770;Laurent Foxonet;;7;15;1;3;26
InnocentKambal4;Innocent Kambale;;14;12;0;0;26
OphelieStArnau2;Ophelie St-Arnaud;;22;2;0;1;25
JudithMassuti;Judith Massuti;;24;1;0;0;25
MfochiveAmadou;Mfochive amadou;Suis quelqu’un de patient.;12;10;0;1;23
GreenBois_fr;Green Bois;GreenBois se consacre à la promotion des granulés et bûches de bois comme énergies renouvelables.;21;1;0;0;22
joelcairat;joel cairat;;9;13;0;0;22
awlnguinee;AWLN Guinéé;Compte officiel du réseau des femmes leaders africaines (AWLN) - chapitre Guinée.;13;3;4;2;22
psc_csp;Climate Solutions Prize/Prix Solutions Climatiques;;4;10;7;0;21
FriedliJea47177;Friedli Jean;;12;4;0;5;21
LLS40_A;SacréPersonnage;Ingé ??? 👨‍🎓, Le Climat ☢️, Jeune et Ambitieux, Détermination Discipline Travail;4;7;0;8;19
soutenabilite;Soutenabilité;Galerie d’inspiration et d’accélération de la transition écologique;15;0;4;0;19
kouakou80679409;kouakou kouadio romeo;secrétaire général adjoint chargé de l'Afrique de l'Ouest de l'Union des Ingénieurs Agronomes Africains.;15;2;1;0;18
Cakhanif1;Coulibaly Abdoulaye;Formateur en changement de mentalité;5;12;0;1;18
ThorpeFauteux;Béatrice Thorpe-Fauteux;;17;1;0;0;18
Mamad60106Bailo;Kante Mamadou Bailo;;5;9;1;3;18
lyceeGutenberg;Lycée Gutenberg Créteil;;12;3;2;0;17
Needlearts_fr;Needle arts;Bonjour, je m'appelle Ingrid, je fabrique des accessoires pour bébés et enfants 🧸👶;12;5;0;0;17
G2Ecoles;Grandes Ecoles Entrepreneurs;L'association G2E fédère les Clubs créés par les diplômés de Grandes Ecoles regroupant les créateurs, développeurs, repreneurs et cédants d’entreprises.;15;0;2;0;17
AntoineMaresc15;Antoine Mareschal;;12;1;0;3;16
GardiensNature;Les Anges Gardiens de la Nature BF;;8;6;1;0;15
DrecourtD;Drecourt Delphine;;11;0;1;2;14
Sondagebrulant;SondageBrûlant;🔥 Sondage Brûlant 🔥 Le compte officiel des sondages sur l'actualité brûlante ! #sondages #actualité #brûlant;12;1;1;0;14
korkabah69;Korka Bah;;3;10;0;1;14
ecoeasierFrance;ecoeasier;;5;7;2;0;14
fra40007428;Jean-François Bélanger;;7;5;0;1;13
HenriVuillermoz;henri vuillermoz;dynamique entreprenant créateur de nouveau concept de logement urgence loisir construction....;7;6;0;0;13
Paul_Nguedjo;P A Nguedjo;;3;2;6;0;11
neocularo;neo-cularo;CELLE prod est une boite de production grenobloise composé de 5 membres. Notre premier projet, neo-cularo est une fiction post-apo prometteuse.;9;1;1;0;11
lea120434;UZAMUGURA Léa;;2;8;0;0;10
EtsWEI;Weiforyourquality;;4;5;0;0;9
GoreDjadji;GORE DJADJI Mahamadou;;1;6;0;1;8
roudolphedesign;Roudolphedesign@gmail.com Design;;1;7;0;0;8
WellmoonsC81565;WELLMOONS CONSULTING;Institut international de formation pour le développement des compétences;6;0;0;0;6
EspereCom;Espere Sénégal;;2;4;0;0;6
ThomasL18174027;Citylights;;1;3;0;0;4
NormanWhea45693;₿ A R I N E K A ✪🅧;Randall M. Barabas III;3;0;0;0;3
AssociationADE5;Association ADECC;;1;0;0;0;1
Carolin40194741;TraderXY;Jimin's pinkyfinger;1;0;0;0;1
